Datum;Waren_ID;Warenbezeichnung;Export;Import;Handelsbilanz
01.01.08;WA01;Lebende Tiere;82261;102369;-20108
01.01.08;WA02;Fleisch;509400;439740;69660
01.01.08;WA03;Fische, Krebs- und Weichtiere;84366;230235;-145869
01.01.08;WA04;Milch, Milcherzeugnisse, Eier, Honig;585999;466415;119584
01.01.08;WA05;Andere Waren tierischen Ursprungs;43833;50862;-7029
01.01.08;WA06;Pflanzen, Waren des Blumenhandels;35128;163048;-127920
01.01.08;WA07;Gemüse, Pflanzen für Ernährung;76811;395633;-318822
01.01.08;WA08;Geniessbare Früchte und Nüsse;122384;493178;-370794
01.01.08;WA09;Kaffee, Tee, Mate, Gewürze;103905;221312;-117407
01.01.08;WA10;Getreide;136815;191882;-55067
01.01.08;WA11;Müllereierzeugnisse, Malz usw.;84706;36766;47940
01.01.08;WA12;Ölsamen usw., Heilpflanzen usw.;120032;262936;-142904
01.01.08;WA13;Schellack, Gummen, Harz, Pflanzensaft;40769;23540;17229
01.01.08;WA14;Flechtstoffe usw. pflanzlichen Ursprungs;651;2216;-1565
01.01.08;WA15;Tierische und pflanzliche Fette, Öle, Wachs;166381;242547;-76166
01.01.08;WA16;Zubereitungen von Fleisch, Fisch usw.;188207;150768;37439
01.01.08;WA17;Zucker und Zuckerwaren;115262;106552;8710
01.01.08;WA18;Kakao und Zubereitungen aus Kakao;195301;179464;15837
01.01.08;WA19;Zubereitungen aus Getreide usw., Backwaren;302527;205951;96576
01.01.08;WA20;Zubereitungen von Gemüse, Früchten usw.;175321;348932;-173611
01.01.08;WA21;Verschiedene Lebensmittelzubereitungen;265083;215471;49612
01.01.08;WA22;Getränke, alkoholhaltige Flüssigkeiten, Essig;282184;397073;-114889
01.01.08;WA23;Rückstände der Lebensmittelindustrie, Futter;223131;246366;-23235
01.01.08;WA24;Tabak;295464;119984;175480
01.01.08;WA25;Salz, Schwefel, Steine, Erden usw.;167817;140803;27014
01.01.08;WA26;Erze, Schlacken, Aschen;29252;543399;-514147
01.01.08;WA27;Mineralische Brennstoffe usw.;2361628;9125174;-6763546
01.01.08;WA28;Anorganische chemische Erzeugnisse;649348;408577;240771
01.01.08;WA29;Organische chemische Erzeugnisse;2426311;1913137;513174
01.01.08;WA30;Pharmazeutische Erzeugnisse;3656516;2336168;1320348
01.01.08;WA31;Düngemittel;183403;113056;70347
01.01.08;WA32;Gerb- und Farbstoffe, Farben, Lacke usw.;683571;317470;366101
01.01.08;WA33;Etherische Öle, Riech-, Schönheitsmittel;582530;329733;252797
01.01.08;WA34;Seifen, Waschmittel usw.;435089;208765;226324
01.01.08;WA35;Eiweissstoffe, Klebstoffe, Enzyme;161892;123825;38067
01.01.08;WA36;Sprengstoffe, pyrotechnische Artikel usw.;15243;16322;-1079
01.01.08;WA37;Photochemische Erzeugnisse;130966;81250;49716
01.01.08;WA38;Verschiedene Erzeugnisse der Chemischen Industrie;1535639;743734;791905
01.01.08;WA39;Kunststoffe und Waren daraus;3931420;2237151;1694269
01.01.08;WA40;Kautschuk und Waren daraus;867245;840211;27034
01.01.08;WA41;Häute, Felle, Leder;98904;73683;25221
01.01.08;WA42;Lederwaren, Sattlerwaren;107584;205160;-97576
01.01.08;WA43;Pelzfelle, künstliches Pelzwerk;11748;10244;1504
01.01.08;WA44;Holz, Holzwaren, Holzkohle;686135;464249;221886
01.01.08;WA45;Kork, Korkwaren;3003;10600;-7597
01.01.08;WA46;Flechtwaren, Korbmacherwaren;4391;14112;-9721
01.01.08;WA47;Halbstoffe aus Holz usw., Papierabfall;76531;298254;-221723
01.01.08;WA48;Papier, Pappe und Waren daraus;1616180;1025044;591136
01.01.08;WA49;Bücher, Zeitungen, Bilddrucke usw.;437654;179438;258216
01.01.08;WA50;Seide;7276;7824;-548
01.01.08;WA51;Wolle, feine und grobe Tierhaare;57681;75537;-17856
01.01.08;WA52;Baumwolle;106323;91854;14469
01.01.08;WA53;Andere pflanzliche Spinnstoffe, Papiergarn;11700;11455;245
01.01.08;WA54;Synthetisches oder künstliches Filament;224160;133591;90569
01.01.08;WA55;Synthetische oder künstliche Spinnfaser;187740;126221;61519
01.01.08;WA56;Watte, Filz, Vliesstoff usw., Tauwerk;167752;91640;76112
01.01.08;WA57;Teppiche, Fussbodenbelag aus Spinnstoff;46871;96951;-50080
01.01.08;WA58;Spezialgewebe, Spitzen, Tapisserien;39367;29327;10040
01.01.08;WA59;Getränkte, bestrichene usw. Gewebe;149653;101785;47868
01.01.08;WA60;Gewirke und Gestricke;78102;36588;41514
01.01.08;WA61;Bekleidung usw. aus Gewirken, Gestricken;410075;883383;-473308
01.01.08;WA62;Andere Bekleidung, Bekleidungszubehör;652015;1073158;-421143
01.01.08;WA63;Andere Konfektion, Spinnstoffwaren usw.;138494;224951;-86457
01.01.08;WA64;Schuhe, Gamaschen, ähnliche Waren;253890;489038;-235148
01.01.08;WA65;Kopfbedeckungen und Teile davon;16668;30945;-14277
01.01.08;WA66;Schirme, Gehstöcke usw., Peitschen;4403;16429;-12026
01.01.08;WA67;Zugerichtete Federn, Daunen, künstliche Blumen;7667;13965;-6298
01.01.08;WA68;Waren aus Steinen, Gips, Zement usw.;272658;167346;105312
01.01.08;WA69;Keramische Waren;249050;167543;81507
01.01.08;WA70;Glas und Glaswaren;423748;309506;114242
01.01.08;WA71;Perlen, Edelsteine, Edelmetalle;751105;887013;-135908
01.01.08;WA72;Eisen und Stahl;2179288;2282040;-102752
01.01.08;WA73;Waren aus Eisen oder Stahl;2156350;1340435;815915
01.01.08;WA74;Kupfer und Waren daraus;939284;726520;212764
01.01.08;WA75;Nickel und Waren daraus;119475;169855;-50380
01.01.08;WA76;Aluminium und Waren daraus;1049212;1014093;35119
01.01.08;WA78;Blei und Waren daraus;39859;23614;16245
01.01.08;WA79;Zink und Waren daraus;48412;77509;-29097
01.01.08;WA80;Zinn und Waren daraus;10297;28325;-18028
01.01.08;WA81;Andere unedle Metalle, Cermets usw.;94748;135918;-41170
01.01.08;WA82;Werkzeuge, Schneidwaren, Essbestecke;538235;314395;223840
01.01.08;WA83;Verschiedene Waren aus unedlen Metallen;552935;314926;238009
01.01.08;WA84;Maschinen, Apparate, mechanische Geräte;15791426;8890881;6900545
01.01.08;WA85;Elektrotechnische Erzeugnisse;8562549;7182762;1379787
01.01.08;WA86;Schienenfahrzeuge;266938;123093;143845
01.01.08;WA87;Kraftfahrzeuge, Landfahrzeuge;13653496;5200398;8453098
01.01.08;WA88;Luftfahrzeuge, Raumfahrzeuge;1394177;1354022;40155
01.01.08;WA89;Wasserfahrzeuge;80431;447972;-367541
01.01.08;WA90;Optische, photografische usw. Erzeugnisse;3296657;1802420;1494237
01.01.08;WA91;Uhrmacherwaren;78943;100377;-21434
01.01.08;WA92;Musikinstrumente;35665;29415;6250
01.01.08;WA93;Waffen und Munition;26230;11015;15215
01.01.08;WA94;Möbel, Beleuchtungskörper usw.;1001751;1060909;-59158
01.01.08;WA95;Spielzeug, Spiele usw., Sportgeräte;362957;440487;-77530
01.01.08;WA96;Verschiedene Waren;152037;99495;52542
01.01.08;WA97;Kunstgegenstände, Sammlungsstücke;39142;26524;12618
01.01.08;WA98;Vollständige Fabrikationsanlagen;307075;5149;301926
01.01.08;WA99;Zusammenstellungen verschiedener Waren;1194266;939918;254348
01.01.09;WA01;Lebende Tiere;86144;142376;-56232
01.01.09;WA02;Fleisch;542081;411361;130720
01.01.09;WA03;Fische, Krebs- und Weichtiere;78612;233903;-155291
01.01.09;WA04;Milch, Milcherzeugnisse, Eier, Honig;510205;426284;83921
01.01.09;WA05;Andere Waren tierischen Ursprungs;49307;54053;-4746
01.01.09;WA06;Pflanzen, Waren des Blumenhandels;36414;166346;-129932
01.01.09;WA07;Gemüse, Pflanzen für Ernährung;70262;403400;-333138
01.01.09;WA08;Geniessbare Früchte und Nüsse;99310;488414;-389104
01.01.09;WA09;Kaffee, Tee, Mate, Gewürze;123400;215044;-91644
01.01.09;WA10;Getreide;156636;145420;11216
01.01.09;WA11;Müllereierzeugnisse, Malz usw.;86809;34062;52747
01.01.09;WA12;Ölsamen usw., Heilpflanzen usw.;87911;293117;-205206
01.01.09;WA13;Schellack, Gummen, Harz, Pflanzensaft;35698;30613;5085
01.01.09;WA14;Flechtstoffe usw. pflanzlichen Ursprungs;697;2071;-1374
01.01.09;WA15;Tierische und pflanzliche Fette, Öle, Wachs;133054;248317;-115263
01.01.09;WA16;Zubereitungen von Fleisch, Fisch usw.;192626;181442;11184
01.01.09;WA17;Zucker und Zuckerwaren;92781;97167;-4386
01.01.09;WA18;Kakao und Zubereitungen aus Kakao;195296;197498;-2202
01.01.09;WA19;Zubereitungen aus Getreide usw., Backwaren;308755;186362;122393
01.01.09;WA20;Zubereitungen von Gemüse, Früchten usw.;164899;312960;-148061
01.01.09;WA21;Verschiedene Lebensmittelzubereitungen;275301;199600;75701
01.01.09;WA22;Getränke, alkoholhaltige Flüssigkeiten, Essig;263356;413775;-150419
01.01.09;WA23;Rückstände der Lebensmittelindustrie, Futter;200922;230270;-29348
01.01.09;WA24;Tabak;346712;138399;208313
01.01.09;WA25;Salz, Schwefel, Steine, Erden usw.;130572;111709;18863
01.01.09;WA26;Erze, Schlacken, Aschen;31514;504982;-473468
01.01.09;WA27;Mineralische Brennstoffe usw.;1731038;7396247;-5665209
01.01.09;WA28;Anorganische chemische Erzeugnisse;466214;404956;61258
01.01.09;WA29;Organische chemische Erzeugnisse;1343198;1601981;-258783
01.01.09;WA30;Pharmazeutische Erzeugnisse;3796474;2702188;1094286
01.01.09;WA31;Düngemittel;103433;89946;13487
01.01.09;WA32;Gerb- und Farbstoffe, Farben, Lacke usw.;496289;254738;241551
01.01.09;WA33;Etherische Öle, Riech-, Schönheitsmittel;495697;299589;196108
01.01.09;WA34;Seifen, Waschmittel usw.;348292;181969;166323
01.01.09;WA35;Eiweissstoffe, Klebstoffe, Enzyme;146356;122303;24053
01.01.09;WA36;Sprengstoffe, pyrotechnische Artikel usw.;12542;18565;-6023
01.01.09;WA37;Photochemische Erzeugnisse;79036;56277;22759
01.01.09;WA38;Verschiedene Erzeugnisse der Chemischen Industrie;1129771;737224;392547
01.01.09;WA39;Kunststoffe und Waren daraus;2734673;1747964;986709
01.01.09;WA40;Kautschuk und Waren daraus;673707;596434;77273
01.01.09;WA41;Häute, Felle, Leder;52759;47812;4947
01.01.09;WA42;Lederwaren, Sattlerwaren;108226;216460;-108234
01.01.09;WA43;Pelzfelle, künstliches Pelzwerk;7283;6253;1030
01.01.09;WA44;Holz, Holzwaren, Holzkohle;441077;379478;61599
01.01.09;WA45;Kork, Korkwaren;2588;6159;-3571
01.01.09;WA46;Flechtwaren, Korbmacherwaren;3748;12830;-9082
01.01.09;WA47;Halbstoffe aus Holz usw., Papierabfall;58932;216467;-157535
01.01.09;WA48;Papier, Pappe und Waren daraus;1299531;870919;428612
01.01.09;WA49;Bücher, Zeitungen, Bilddrucke usw.;408254;180187;228067
01.01.09;WA50;Seide;5337;6794;-1457
01.01.09;WA51;Wolle, feine und grobe Tierhaare;42603;42989;-386
01.01.09;WA52;Baumwolle;77831;69100;8731
01.01.09;WA53;Andere pflanzliche Spinnstoffe, Papiergarn;7548;7093;455
01.01.09;WA54;Synthetisches oder künstliches Filament;133500;94953;38547
01.01.09;WA55;Synthetische oder künstliche Spinnfaser;112697;101607;11090
01.01.09;WA56;Watte, Filz, Vliesstoff usw., Tauwerk;118653;75683;42970
01.01.09;WA57;Teppiche, Fussbodenbelag aus Spinnstoff;40526;98351;-57825
01.01.09;WA58;Spezialgewebe, Spitzen, Tapisserien;34089;25149;8940
01.01.09;WA59;Getränkte, bestrichene usw. Gewebe;113609;90368;23241
01.01.09;WA60;Gewirke und Gestricke;52696;28071;24625
01.01.09;WA61;Bekleidung usw. aus Gewirken, Gestricken;455942;958662;-502720
01.01.09;WA62;Andere Bekleidung, Bekleidungszubehör;667612;1155415;-487803
01.01.09;WA63;Andere Konfektion, Spinnstoffwaren usw.;121745;216903;-95158
01.01.09;WA64;Schuhe, Gamaschen, ähnliche Waren;273087;509624;-236537
01.01.09;WA65;Kopfbedeckungen und Teile davon;15260;30913;-15653
01.01.09;WA66;Schirme, Gehstöcke usw., Peitschen;9316;17487;-8171
01.01.09;WA67;Zugerichtete Federn, Daunen, künstliche Blumen;6518;12948;-6430
01.01.09;WA68;Waren aus Steinen, Gips, Zement usw.;203009;141531;61478
01.01.09;WA69;Keramische Waren;206689;158479;48210
01.01.09;WA70;Glas und Glaswaren;349170;250426;98744
01.01.09;WA71;Perlen, Edelsteine, Edelmetalle;464502;683090;-218588
01.01.09;WA72;Eisen und Stahl;1393690;1478394;-84704
01.01.09;WA73;Waren aus Eisen oder Stahl;1711220;1149720;561500
01.01.09;WA74;Kupfer und Waren daraus;462195;360391;101804
01.01.09;WA75;Nickel und Waren daraus;74975;73254;1721
01.01.09;WA76;Aluminium und Waren daraus;716269;670866;45403
01.01.09;WA78;Blei und Waren daraus;23045;8272;14773
01.01.09;WA79;Zink und Waren daraus;26503;38288;-11785
01.01.09;WA80;Zinn und Waren daraus;7088;15590;-8502
01.01.09;WA81;Andere unedle Metalle, Cermets usw.;57378;83571;-26193
01.01.09;WA82;Werkzeuge, Schneidwaren, Essbestecke;432169;273327;158842
01.01.09;WA83;Verschiedene Waren aus unedlen Metallen;390037;239489;150548
01.01.09;WA84;Maschinen, Apparate, mechanische Geräte;12224983;7375882;4849101
01.01.09;WA85;Elektrotechnische Erzeugnisse;6433948;5853116;580832
01.01.09;WA86;Schienenfahrzeuge;279228;174039;105189
01.01.09;WA87;Kraftfahrzeuge, Landfahrzeuge;8028192;3691420;4336772
01.01.09;WA88;Luftfahrzeuge, Raumfahrzeuge;1715454;1549721;165733
01.01.09;WA89;Wasserfahrzeuge;237012;53107;183905
01.01.09;WA90;Optische, photografische usw. Erzeugnisse;2630368;1627006;1003362
01.01.09;WA91;Uhrmacherwaren;66586;96196;-29610
01.01.09;WA92;Musikinstrumente;25124;31727;-6603
01.01.09;WA93;Waffen und Munition;26317;8046;18271
01.01.09;WA94;Möbel, Beleuchtungskörper usw.;811628;929540;-117912
01.01.09;WA95;Spielzeug, Spiele usw., Sportgeräte;416142;566296;-150154
01.01.09;WA96;Verschiedene Waren;132528;100355;32173
01.01.09;WA97;Kunstgegenstände, Sammlungsstücke;46777;24114;22663
01.01.09;WA98;Vollständige Fabrikationsanlagen;464662;1838;462824
01.01.09;WA99;Zusammenstellungen verschiedener Waren;974944;889222;85722
01.01.10;WA01;Lebende Tiere;86734;118776;-32042
01.01.10;WA02;Fleisch;468415;393869;74546
01.01.10;WA03;Fische, Krebs- und Weichtiere;80292;230291;-149999
01.01.10;WA04;Milch, Milcherzeugnisse, Eier, Honig;504717;388968;115749
01.01.10;WA05;Andere Waren tierischen Ursprungs;43620;48886;-5266
01.01.10;WA06;Pflanzen, Waren des Blumenhandels;33005;152858;-119853
01.01.10;WA07;Gemüse, Pflanzen für Ernährung;65454;375483;-310029
01.01.10;WA08;Geniessbare Früchte und Nüsse;92470;476180;-383710
01.01.10;WA09;Kaffee, Tee, Mate, Gewürze;121514;211189;-89675
01.01.10;WA10;Getreide;121209;122543;-1334
01.01.10;WA11;Müllereierzeugnisse, Malz usw.;70138;28953;41185
01.01.10;WA12;Ölsamen usw., Heilpflanzen usw.;91898;247953;-156055
01.01.10;WA13;Schellack, Gummen, Harz, Pflanzensaft;31261;25034;6227
01.01.10;WA14;Flechtstoffe usw. pflanzlichen Ursprungs;858;1866;-1008
01.01.10;WA15;Tierische und pflanzliche Fette, Öle, Wachs;134790;186535;-51745
01.01.10;WA16;Zubereitungen von Fleisch, Fisch usw.;170172;163080;7092
01.01.10;WA17;Zucker und Zuckerwaren;107455;89451;18004
01.01.10;WA18;Kakao und Zubereitungen aus Kakao;219979;244158;-24179
01.01.10;WA19;Zubereitungen aus Getreide usw., Backwaren;288214;179352;108862
01.01.10;WA20;Zubereitungen von Gemüse, Früchten usw.;138119;255977;-117858
01.01.10;WA21;Verschiedene Lebensmittelzubereitungen;253610;172441;81169
01.01.10;WA22;Getränke, alkoholhaltige Flüssigkeiten, Essig;259510;397962;-138452
01.01.10;WA23;Rückstände der Lebensmittelindustrie, Futter;222907;243087;-20180
01.01.10;WA24;Tabak;254383;130988;123395
01.01.10;WA25;Salz, Schwefel, Steine, Erden usw.;113356;108197;5159
01.01.10;WA26;Erze, Schlacken, Aschen;16048;500942;-484894
01.01.10;WA27;Mineralische Brennstoffe usw.;1517018;6766559;-5249541
01.01.10;WA28;Anorganische chemische Erzeugnisse;550427;339954;210473
01.01.10;WA29;Organische chemische Erzeugnisse;1742637;1580413;162224
01.01.10;WA30;Pharmazeutische Erzeugnisse;3629620;3184108;445512
01.01.10;WA31;Düngemittel;153608;68513;85095
01.01.10;WA32;Gerb- und Farbstoffe, Farben, Lacke usw.;597920;303249;294671
01.01.10;WA33;Etherische Öle, Riech-, Schönheitsmittel;532073;325683;206390
01.01.10;WA34;Seifen, Waschmittel usw.;383934;197543;186391
01.01.10;WA35;Eiweissstoffe, Klebstoffe, Enzyme;160487;114402;46085
01.01.10;WA36;Sprengstoffe, pyrotechnische Artikel usw.;11415;18052;-6637
01.01.10;WA37;Photochemische Erzeugnisse;83085;57476;25609
01.01.10;WA38;Verschiedene Erzeugnisse der Chemischen Industrie;1201537;671883;529654
01.01.10;WA39;Kunststoffe und Waren daraus;3166453;1866354;1300099
01.01.10;WA40;Kautschuk und Waren daraus;758481;681594;76887
01.01.10;WA41;Häute, Felle, Leder;55738;53314;2424
01.01.10;WA42;Lederwaren, Sattlerwaren;99967;185279;-85312
01.01.10;WA43;Pelzfelle, künstliches Pelzwerk;6357;6904;-547
01.01.10;WA44;Holz, Holzwaren, Holzkohle;422806;403999;18807
01.01.10;WA45;Kork, Korkwaren;2141;13254;-11113
01.01.10;WA46;Flechtwaren, Korbmacherwaren;3184;10732;-7548
01.01.10;WA47;Halbstoffe aus Holz usw., Papierabfall;78328;236560;-158232
01.01.10;WA48;Papier, Pappe und Waren daraus;1319980;813957;506023
01.01.10;WA49;Bücher, Zeitungen, Bilddrucke usw.;337474;143713;193761
01.01.10;WA50;Seide;4593;5387;-794
01.01.10;WA51;Wolle, feine und grobe Tierhaare;41378;41580;-202
01.01.10;WA52;Baumwolle;69835;64308;5527
01.01.10;WA53;Andere pflanzliche Spinnstoffe, Papiergarn;6215;6225;-10
01.01.10;WA54;Synthetisches oder künstliches Filament;145703;102604;43099
01.01.10;WA55;Synthetische oder künstliche Spinnfaser;135007;95789;39218
01.01.10;WA56;Watte, Filz, Vliesstoff usw., Tauwerk;135340;78648;56692
01.01.10;WA57;Teppiche, Fussbodenbelag aus Spinnstoff;36958;84676;-47718
01.01.10;WA58;Spezialgewebe, Spitzen, Tapisserien;35448;22673;12775
01.01.10;WA59;Getränkte, bestrichene usw. Gewebe;125561;68666;56895
01.01.10;WA60;Gewirke und Gestricke;56046;28724;27322
01.01.10;WA61;Bekleidung usw. aus Gewirken, Gestricken;441992;865086;-423094
01.01.10;WA62;Andere Bekleidung, Bekleidungszubehör;566811;990592;-423781
01.01.10;WA63;Andere Konfektion, Spinnstoffwaren usw.;121761;218739;-96978
01.01.10;WA64;Schuhe, Gamaschen, ähnliche Waren;250220;502725;-252505
01.01.10;WA65;Kopfbedeckungen und Teile davon;17010;29435;-12425
01.01.10;WA66;Schirme, Gehstöcke usw., Peitschen;10715;13487;-2772
01.01.10;WA67;Zugerichtete Federn, Daunen, künstliche Blumen;5604;10793;-5189
01.01.10;WA68;Waren aus Steinen, Gips, Zement usw.;197171;143941;53230
01.01.10;WA69;Keramische Waren;182775;147118;35657
01.01.10;WA70;Glas und Glaswaren;356868;273475;83393
01.01.10;WA71;Perlen, Edelsteine, Edelmetalle;622132;818734;-196602
01.01.10;WA72;Eisen und Stahl;1430616;1327802;102814
01.01.10;WA73;Waren aus Eisen oder Stahl;1429005;941453;487552
01.01.10;WA74;Kupfer und Waren daraus;686357;523437;162920
01.01.10;WA75;Nickel und Waren daraus;48182;72226;-24044
01.01.10;WA76;Aluminium und Waren daraus;681540;735912;-54372
01.01.10;WA78;Blei und Waren daraus;37787;19157;18630
01.01.10;WA79;Zink und Waren daraus;43132;65979;-22847
01.01.10;WA80;Zinn und Waren daraus;6394;19145;-12751
01.01.10;WA81;Andere unedle Metalle, Cermets usw.;63154;73187;-10033
01.01.10;WA82;Werkzeuge, Schneidwaren, Essbestecke;384981;242581;142400
01.01.10;WA83;Verschiedene Waren aus unedlen Metallen;428289;252285;176004
01.01.10;WA84;Maschinen, Apparate, mechanische Geräte;10458896;6696033;3762863
01.01.10;WA85;Elektrotechnische Erzeugnisse;6599278;6230201;369077
01.01.10;WA86;Schienenfahrzeuge;208858;102524;106334
01.01.10;WA87;Kraftfahrzeuge, Landfahrzeuge;9571787;3565917;6005870
01.01.10;WA88;Luftfahrzeuge, Raumfahrzeuge;1465770;1455455;10315
01.01.10;WA89;Wasserfahrzeuge;44773;562730;-517957
01.01.10;WA90;Optische, photografische usw. Erzeugnisse;2794125;1633010;1161115
01.01.10;WA91;Uhrmacherwaren;76829;85876;-9047
01.01.10;WA92;Musikinstrumente;23525;26366;-2841
01.01.10;WA93;Waffen und Munition;23410;8590;14820
01.01.10;WA94;Möbel, Beleuchtungskörper usw.;797310;953769;-156459
01.01.10;WA95;Spielzeug, Spiele usw., Sportgeräte;282553;378357;-95804
01.01.10;WA96;Verschiedene Waren;122157;96061;26096
01.01.10;WA97;Kunstgegenstände, Sammlungsstücke;38754;29845;8909
01.01.10;WA98;Vollständige Fabrikationsanlagen;235280;1165;234115
01.01.10;WA99;Zusammenstellungen verschiedener Waren;1005259;829837;175422
01.01.11;WA01;Lebende Tiere;104931;108805;-3874
01.01.11;WA02;Fleisch;496267;404781;91486
01.01.11;WA03;Fische, Krebs- und Weichtiere;99452;279950;-180498
01.01.11;WA04;Milch, Milcherzeugnisse, Eier, Honig;607465;460788;146677
01.01.11;WA05;Andere Waren tierischen Ursprungs;54526;54286;240
01.01.11;WA06;Pflanzen, Waren des Blumenhandels;39601;182533;-142932
01.01.11;WA07;Gemüse, Pflanzen für Ernährung;85000;476242;-391242
01.01.11;WA08;Geniessbare Früchte und Nüsse;103772;554929;-451157
01.01.11;WA09;Kaffee, Tee, Mate, Gewürze;173448;370570;-197122
01.01.11;WA10;Getreide;242530;218159;24371
01.01.11;WA11;Müllereierzeugnisse, Malz usw.;79870;40276;39594
01.01.11;WA12;Ölsamen usw., Heilpflanzen usw.;111741;271278;-159537
01.01.11;WA13;Schellack, Gummen, Harz, Pflanzensaft;40031;36543;3488
01.01.11;WA14;Flechtstoffe usw. pflanzlichen Ursprungs;697;1993;-1296
01.01.11;WA15;Tierische und pflanzliche Fette, Öle, Wachs;190488;308953;-118465
01.01.11;WA16;Zubereitungen von Fleisch, Fisch usw.;186569;176177;10392
01.01.11;WA17;Zucker und Zuckerwaren;107366;96744;10622
01.01.11;WA18;Kakao und Zubereitungen aus Kakao;259835;250985;8850
01.01.11;WA19;Zubereitungen aus Getreide usw., Backwaren;321179;182767;138412
01.01.11;WA20;Zubereitungen von Gemüse, Früchten usw.;155601;321350;-165749
01.01.11;WA21;Verschiedene Lebensmittelzubereitungen;301087;158131;142956
01.01.11;WA22;Getränke, alkoholhaltige Flüssigkeiten, Essig;318107;445203;-127096
01.01.11;WA23;Rückstände der Lebensmittelindustrie, Futter;221767;241361;-19594
01.01.11;WA24;Tabak;269829;148259;121570
01.01.11;WA25;Salz, Schwefel, Steine, Erden usw.;141595;144966;-3371
01.01.11;WA26;Erze, Schlacken, Aschen;24889;835923;-811034
01.01.11;WA27;Mineralische Brennstoffe usw.;2298695;9524494;-7225799
01.01.11;WA28;Anorganische chemische Erzeugnisse;863643;475719;387924
01.01.11;WA29;Organische chemische Erzeugnisse;2081200;1930522;150678
01.01.11;WA30;Pharmazeutische Erzeugnisse;3703645;2615088;1088557
01.01.11;WA31;Düngemittel;204965;114838;90127
01.01.11;WA32;Gerb- und Farbstoffe, Farben, Lacke usw.;703265;391660;311605
01.01.11;WA33;Etherische Öle, Riech-, Schönheitsmittel;609982;356152;253830
01.01.11;WA34;Seifen, Waschmittel usw.;464316;235251;229065
01.01.11;WA35;Eiweissstoffe, Klebstoffe, Enzyme;187853;142606;45247
01.01.11;WA36;Sprengstoffe, pyrotechnische Artikel usw.;15750;17595;-1845
01.01.11;WA37;Photochemische Erzeugnisse;83285;55689;27596
01.01.11;WA38;Verschiedene Erzeugnisse der Chemischen Industrie;1424592;961564;463028
01.01.11;WA39;Kunststoffe und Waren daraus;3929153;2391861;1537292
01.01.11;WA40;Kautschuk und Waren daraus;1053632;1063189;-9557
01.01.11;WA41;Häute, Felle, Leder;67328;63832;3496
01.01.11;WA42;Lederwaren, Sattlerwaren;123472;256421;-132949
01.01.11;WA43;Pelzfelle, künstliches Pelzwerk;7094;9482;-2388
01.01.11;WA44;Holz, Holzwaren, Holzkohle;476066;469310;6756
01.01.11;WA45;Kork, Korkwaren;2646;9553;-6907
01.01.11;WA46;Flechtwaren, Korbmacherwaren;2961;11539;-8578
01.01.11;WA47;Halbstoffe aus Holz usw., Papierabfall;97693;324808;-227115
01.01.11;WA48;Papier, Pappe und Waren daraus;1485468;968494;516974
01.01.11;WA49;Bücher, Zeitungen, Bilddrucke usw.;367691;149329;218362
01.01.11;WA50;Seide;5604;6636;-1032
01.01.11;WA51;Wolle, feine und grobe Tierhaare;62047;70665;-8618
01.01.11;WA52;Baumwolle;97385;104892;-7507
01.01.11;WA53;Andere pflanzliche Spinnstoffe, Papiergarn;5776;7532;-1756
01.01.11;WA54;Synthetisches oder künstliches Filament;164736;121343;43393
01.01.11;WA55;Synthetische oder künstliche Spinnfaser;171795;127278;44517
01.01.11;WA56;Watte, Filz, Vliesstoff usw., Tauwerk;164263;88905;75358
01.01.11;WA57;Teppiche, Fussbodenbelag aus Spinnstoff;39635;93274;-53639
01.01.11;WA58;Spezialgewebe, Spitzen, Tapisserien;35864;26583;9281
01.01.11;WA59;Getränkte, bestrichene usw. Gewebe;151544;85834;65710
01.01.11;WA60;Gewirke und Gestricke;69527;31350;38177
01.01.11;WA61;Bekleidung usw. aus Gewirken, Gestricken;537590;1089372;-551782
01.01.11;WA62;Andere Bekleidung, Bekleidungszubehör;654330;1225611;-571281
01.01.11;WA63;Andere Konfektion, Spinnstoffwaren usw.;139648;276233;-136585
01.01.11;WA64;Schuhe, Gamaschen, ähnliche Waren;310283;657025;-346742
01.01.11;WA65;Kopfbedeckungen und Teile davon;18813;29794;-10981
01.01.11;WA66;Schirme, Gehstöcke usw., Peitschen;6051;19007;-12956
01.01.11;WA67;Zugerichtete Federn, Daunen, künstliche Blumen;7602;16287;-8685
01.01.11;WA68;Waren aus Steinen, Gips, Zement usw.;250914;167333;83581
01.01.11;WA69;Keramische Waren;211989;188972;23017
01.01.11;WA70;Glas und Glaswaren;403862;314319;89543
01.01.11;WA71;Perlen, Edelsteine, Edelmetalle;988041;1196431;-208390
01.01.11;WA72;Eisen und Stahl;2022754;2056775;-34021
01.01.11;WA73;Waren aus Eisen oder Stahl;1749540;1251444;498096
01.01.11;WA74;Kupfer und Waren daraus;976014;930367;45647
01.01.11;WA75;Nickel und Waren daraus;71480;160645;-89165
01.01.11;WA76;Aluminium und Waren daraus;1005451;1035815;-30364
01.01.11;WA78;Blei und Waren daraus;49218;27988;21230
01.01.11;WA79;Zink und Waren daraus;49770;85953;-36183
01.01.11;WA80;Zinn und Waren daraus;10831;39935;-29104
01.01.11;WA81;Andere unedle Metalle, Cermets usw.;90835;129370;-38535
01.01.11;WA82;Werkzeuge, Schneidwaren, Essbestecke;499136;320591;178545
01.01.11;WA83;Verschiedene Waren aus unedlen Metallen;503144;296478;206666
01.01.11;WA84;Maschinen, Apparate, mechanische Geräte;13454530;8581595;4872935
01.01.11;WA85;Elektrotechnische Erzeugnisse;8153313;7749970;403343
01.01.11;WA86;Schienenfahrzeuge;236976;143215;93761
01.01.11;WA87;Kraftfahrzeuge, Landfahrzeuge;12554428;4967120;7587308
01.01.11;WA88;Luftfahrzeuge, Raumfahrzeuge;1878917;830354;1048563
01.01.11;WA89;Wasserfahrzeuge;177049;806451;-629402
01.01.11;WA90;Optische, photografische usw. Erzeugnisse;3481525;2073736;1407789
01.01.11;WA91;Uhrmacherwaren;96244;117137;-20893
01.01.11;WA92;Musikinstrumente;39084;39614;-530
01.01.11;WA93;Waffen und Munition;19167;9434;9733
01.01.11;WA94;Möbel, Beleuchtungskörper usw.;913971;1090577;-176606
01.01.11;WA95;Spielzeug, Spiele usw., Sportgeräte;251821;405573;-153752
01.01.11;WA96;Verschiedene Waren;143951;117694;26257
01.01.11;WA97;Kunstgegenstände, Sammlungsstücke;89899;19864;70035
01.01.11;WA98;Vollständige Fabrikationsanlagen;241775;853;240922
01.01.11;WA99;Zusammenstellungen verschiedener Waren;1064701;844693;220008
01.01.12;WA01;Lebende Tiere;116483;125089;-8606
01.01.12;WA02;Fleisch;615881;434183;181698
01.01.12;WA03;Fische, Krebs- und Weichtiere;90041;229989;-139948
01.01.12;WA04;Milch, Milcherzeugnisse, Eier, Honig;644240;483104;161136
01.01.12;WA05;Andere Waren tierischen Ursprungs;71713;77092;-5379
01.01.12;WA06;Pflanzen, Waren des Blumenhandels;41939;195001;-153062
01.01.12;WA07;Gemüse, Pflanzen für Ernährung;52625;412012;-359387
01.01.12;WA08;Geniessbare Früchte und Nüsse;91544;523947;-432403
01.01.12;WA09;Kaffee, Tee, Mate, Gewürze;199194;396598;-197404
01.01.12;WA10;Getreide;143846;206476;-62630
01.01.12;WA11;Müllereierzeugnisse, Malz usw.;91022;36645;54377
01.01.12;WA12;Ölsamen usw., Heilpflanzen usw.;105522;381262;-275740
01.01.12;WA13;Schellack, Gummen, Harz, Pflanzensaft;38757;42984;-4227
01.01.12;WA14;Flechtstoffe usw. pflanzlichen Ursprungs;973;2005;-1032
01.01.12;WA15;Tierische und pflanzliche Fette, Öle, Wachs;187056;322476;-135420
01.01.12;WA16;Zubereitungen von Fleisch, Fisch usw.;197513;185399;12114
01.01.12;WA17;Zucker und Zuckerwaren;146894;116406;30488
01.01.12;WA18;Kakao und Zubereitungen aus Kakao;290320;271796;18524
01.01.12;WA19;Zubereitungen aus Getreide usw., Backwaren;344769;202228;142541
01.01.12;WA20;Zubereitungen von Gemüse, Früchten usw.;165014;336279;-171265
01.01.12;WA21;Verschiedene Lebensmittelzubereitungen;327742;192335;135407
01.01.12;WA22;Getränke, alkoholhaltige Flüssigkeiten, Essig;328419;448800;-120381
01.01.12;WA23;Rückstände der Lebensmittelindustrie, Futter;220835;239704;-18869
01.01.12;WA24;Tabak;329265;128582;200683
01.01.12;WA25;Salz, Schwefel, Steine, Erden usw.;155729;141915;13814
01.01.12;WA26;Erze, Schlacken, Aschen;25726;721063;-695337
01.01.12;WA27;Mineralische Brennstoffe usw.;2439906;10504429;-8064523
01.01.12;WA28;Anorganische chemische Erzeugnisse;661838;529368;132470
01.01.12;WA29;Organische chemische Erzeugnisse;2237942;1790593;447349
01.01.12;WA30;Pharmazeutische Erzeugnisse;4600985;2584531;2016454
01.01.12;WA31;Düngemittel;238120;104833;133287
01.01.12;WA32;Gerb- und Farbstoffe, Farben, Lacke usw.;864120;448986;415134
01.01.12;WA33;Etherische Öle, Riech-, Schönheitsmittel;623613;358801;264812
01.01.12;WA34;Seifen, Waschmittel usw.;494242;254616;239626
01.01.12;WA35;Eiweissstoffe, Klebstoffe, Enzyme;223495;146947;76548
01.01.12;WA36;Sprengstoffe, pyrotechnische Artikel usw.;18644;22397;-3753
01.01.12;WA37;Photochemische Erzeugnisse;79736;57092;22644
01.01.12;WA38;Verschiedene Erzeugnisse der Chemischen Industrie;1536410;937061;599349
01.01.12;WA39;Kunststoffe und Waren daraus;4101678;2512033;1589645
01.01.12;WA40;Kautschuk und Waren daraus;1145337;1146069;-732
01.01.12;WA41;Häute, Felle, Leder;69327;71588;-2261
01.01.12;WA42;Lederwaren, Sattlerwaren;136958;274169;-137211
01.01.12;WA43;Pelzfelle, künstliches Pelzwerk;8573;13836;-5263
01.01.12;WA44;Holz, Holzwaren, Holzkohle;460786;506948;-46162
01.01.12;WA45;Kork, Korkwaren;2080;6993;-4913
01.01.12;WA46;Flechtwaren, Korbmacherwaren;2902;11898;-8996
01.01.12;WA47;Halbstoffe aus Holz usw., Papierabfall;106308;283263;-176955
01.01.12;WA48;Papier, Pappe und Waren daraus;1344090;902315;441775
01.01.12;WA49;Bücher, Zeitungen, Bilddrucke usw.;353321;159085;194236
01.01.12;WA50;Seide;6220;6538;-318
01.01.12;WA51;Wolle, feine und grobe Tierhaare;52103;64790;-12687
01.01.12;WA52;Baumwolle;85599;92247;-6648
01.01.12;WA53;Andere pflanzliche Spinnstoffe, Papiergarn;5509;7718;-2209
01.01.12;WA54;Synthetisches oder künstliches Filament;159435;117397;42038
01.01.12;WA55;Synthetische oder künstliche Spinnfaser;156415;124825;31590
01.01.12;WA56;Watte, Filz, Vliesstoff usw., Tauwerk;167797;88922;78875
01.01.12;WA57;Teppiche, Fussbodenbelag aus Spinnstoff;47103;89461;-42358
01.01.12;WA58;Spezialgewebe, Spitzen, Tapisserien;37536;26985;10551
01.01.12;WA59;Getränkte, bestrichene usw. Gewebe;154745;92845;61900
01.01.12;WA60;Gewirke und Gestricke;70960;36557;34403
01.01.12;WA61;Bekleidung usw. aus Gewirken, Gestricken;525470;1079181;-553711
01.01.12;WA62;Andere Bekleidung, Bekleidungszubehör;675300;1264877;-589577
01.01.12;WA63;Andere Konfektion, Spinnstoffwaren usw.;155682;280562;-124880
01.01.12;WA64;Schuhe, Gamaschen, ähnliche Waren;348807;682302;-333495
01.01.12;WA65;Kopfbedeckungen und Teile davon;21279;35613;-14334
01.01.12;WA66;Schirme, Gehstöcke usw., Peitschen;6736;21578;-14842
01.01.12;WA67;Zugerichtete Federn, Daunen, künstliche Blumen;9107;16788;-7681
01.01.12;WA68;Waren aus Steinen, Gips, Zement usw.;281277;192067;89210
01.01.12;WA69;Keramische Waren;222285;184156;38129
01.01.12;WA70;Glas und Glaswaren;397524;319285;78239
01.01.12;WA71;Perlen, Edelsteine, Edelmetalle;1245870;1396859;-150989
01.01.12;WA72;Eisen und Stahl;2058547;2100468;-41921
01.01.12;WA73;Waren aus Eisen oder Stahl;1964886;1374778;590108
01.01.12;WA74;Kupfer und Waren daraus;1086065;851412;234653
01.01.12;WA75;Nickel und Waren daraus;99045;142668;-43623
01.01.12;WA76;Aluminium und Waren daraus;933327;970723;-37396
01.01.12;WA78;Blei und Waren daraus;29823;16564;13259
01.01.12;WA79;Zink und Waren daraus;50543;64647;-14104
01.01.12;WA80;Zinn und Waren daraus;10133;28846;-18713
01.01.12;WA81;Andere unedle Metalle, Cermets usw.;113182;128079;-14897
01.01.12;WA82;Werkzeuge, Schneidwaren, Essbestecke;534845;351590;183255
01.01.12;WA83;Verschiedene Waren aus unedlen Metallen;527570;333864;193706
01.01.12;WA84;Maschinen, Apparate, mechanische Geräte;14671545;8819845;5851700
01.01.12;WA85;Elektrotechnische Erzeugnisse;8466427;7681670;784757
01.01.12;WA86;Schienenfahrzeuge;272038;111568;160470
01.01.12;WA87;Kraftfahrzeuge, Landfahrzeuge;13923759;5330046;8593713
01.01.12;WA88;Luftfahrzeuge, Raumfahrzeuge;1925159;1463654;461505
01.01.12;WA89;Wasserfahrzeuge;743214;559931;183283
01.01.12;WA90;Optische, photografische usw. Erzeugnisse;3639080;2135020;1504060
01.01.12;WA91;Uhrmacherwaren;101032;138044;-37012
01.01.12;WA92;Musikinstrumente;34564;37541;-2977
01.01.12;WA93;Waffen und Munition;24632;12274;12358
01.01.12;WA94;Möbel, Beleuchtungskörper usw.;1007245;1218871;-211626
01.01.12;WA95;Spielzeug, Spiele usw., Sportgeräte;266866;386583;-119717
01.01.12;WA96;Verschiedene Waren;259217;187710;71507
01.01.12;WA97;Kunstgegenstände, Sammlungsstücke;44467;23613;20854
01.01.12;WA98;Vollständige Fabrikationsanlagen;187074;1440;185634
01.01.12;WA99;Zusammenstellungen verschiedener Waren;1343443;910594;432849
01.01.13;WA01;Lebende Tiere;140537;186663;-46126
01.01.13;WA02;Fleisch;659864;508336;151528
01.01.13;WA03;Fische, Krebs- und Weichtiere;92017;275365;-183348
01.01.13;WA04;Milch, Milcherzeugnisse, Eier, Honig;761428;523940;237488
01.01.13;WA05;Andere Waren tierischen Ursprungs;80739;81884;-1145
01.01.13;WA06;Pflanzen, Waren des Blumenhandels;40348;175115;-134767
01.01.13;WA07;Gemüse, Pflanzen für Ernährung;104454;441064;-336610
01.01.13;WA08;Geniessbare Früchte und Nüsse;110856;550856;-440000
01.01.13;WA09;Kaffee, Tee, Mate, Gewürze;209978;368405;-158427
01.01.13;WA10;Getreide;292915;256191;36724
01.01.13;WA11;Müllereierzeugnisse, Malz usw.;104002;42900;61102
01.01.13;WA12;Ölsamen usw., Heilpflanzen usw.;106713;388524;-281811
01.01.13;WA13;Schellack, Gummen, Harz, Pflanzensaft;43840;43067;773
01.01.13;WA14;Flechtstoffe usw. pflanzlichen Ursprungs;766;1919;-1153
01.01.13;WA15;Tierische und pflanzliche Fette, Öle, Wachs;249779;274360;-24581
01.01.13;WA16;Zubereitungen von Fleisch, Fisch usw.;236040;201758;34282
01.01.13;WA17;Zucker und Zuckerwaren;160059;127460;32599
01.01.13;WA18;Kakao und Zubereitungen aus Kakao;303227;288216;15011
01.01.13;WA19;Zubereitungen aus Getreide usw., Backwaren;414642;243053;171589
01.01.13;WA20;Zubereitungen von Gemüse, Früchten usw.;188064;334239;-146175
01.01.13;WA21;Verschiedene Lebensmittelzubereitungen;378218;211488;166730
01.01.13;WA22;Getränke, alkoholhaltige Flüssigkeiten, Essig;361060;518073;-157013
01.01.13;WA23;Rückstände der Lebensmittelindustrie, Futter;316054;357411;-41357
01.01.13;WA24;Tabak;303055;137047;166008
01.01.13;WA25;Salz, Schwefel, Steine, Erden usw.;148301;130396;17905
01.01.13;WA26;Erze, Schlacken, Aschen;24526;696163;-671637
01.01.13;WA27;Mineralische Brennstoffe usw.;2392393;10842019;-8449626
01.01.13;WA28;Anorganische chemische Erzeugnisse;722573;488964;233609
01.01.13;WA29;Organische chemische Erzeugnisse;2684939;2151021;533918
01.01.13;WA30;Pharmazeutische Erzeugnisse;4631366;2562835;2068531
01.01.13;WA31;Düngemittel;238099;134747;103352
01.01.13;WA32;Gerb- und Farbstoffe, Farben, Lacke usw.;884400;462911;421489
01.01.13;WA33;Etherische Öle, Riech-, Schönheitsmittel;703654;434247;269407
01.01.13;WA34;Seifen, Waschmittel usw.;538249;284794;253455
01.01.13;WA35;Eiweissstoffe, Klebstoffe, Enzyme;226778;163125;63653
01.01.13;WA36;Sprengstoffe, pyrotechnische Artikel usw.;15618;11441;4177
01.01.13;WA37;Photochemische Erzeugnisse;96026;61027;34999
01.01.13;WA38;Verschiedene Erzeugnisse der Chemischen Industrie;1658050;913809;744241
01.01.13;WA39;Kunststoffe und Waren daraus;4274151;2692849;1581302
01.01.13;WA40;Kautschuk und Waren daraus;1111325;1069390;41935
01.01.13;WA41;Häute, Felle, Leder;83681;66753;16928
01.01.13;WA42;Lederwaren, Sattlerwaren;131391;279350;-147959
01.01.13;WA43;Pelzfelle, künstliches Pelzwerk;9419;9858;-439
01.01.13;WA44;Holz, Holzwaren, Holzkohle;498405;508472;-10067
01.01.13;WA45;Kork, Korkwaren;2471;8261;-5790
01.01.13;WA46;Flechtwaren, Korbmacherwaren;3250;9760;-6510
01.01.13;WA47;Halbstoffe aus Holz usw., Papierabfall;97063;280986;-183923
01.01.13;WA48;Papier, Pappe und Waren daraus;1447325;983845;463480
01.01.13;WA49;Bücher, Zeitungen, Bilddrucke usw.;340003;157605;182398
01.01.13;WA50;Seide;6991;6508;483
01.01.13;WA51;Wolle, feine und grobe Tierhaare;58659;96651;-37992
01.01.13;WA52;Baumwolle;89385;86746;2639
01.01.13;WA53;Andere pflanzliche Spinnstoffe, Papiergarn;5573;6951;-1378
01.01.13;WA54;Synthetisches oder künstliches Filament;155418;119920;35498
01.01.13;WA55;Synthetische oder künstliche Spinnfaser;161550;125010;36540
01.01.13;WA56;Watte, Filz, Vliesstoff usw., Tauwerk;178153;95665;82488
01.01.13;WA57;Teppiche, Fussbodenbelag aus Spinnstoff;41132;99431;-58299
01.01.13;WA58;Spezialgewebe, Spitzen, Tapisserien;36625;23956;12669
01.01.13;WA59;Getränkte, bestrichene usw. Gewebe;168811;95134;73677
01.01.13;WA60;Gewirke und Gestricke;61991;33126;28865
01.01.13;WA61;Bekleidung usw. aus Gewirken, Gestricken;547152;1176468;-629316
01.01.13;WA62;Andere Bekleidung, Bekleidungszubehör;689589;1306858;-617269
01.01.13;WA63;Andere Konfektion, Spinnstoffwaren usw.;163070;274654;-111584
01.01.13;WA64;Schuhe, Gamaschen, ähnliche Waren;373459;744121;-370662
01.01.13;WA65;Kopfbedeckungen und Teile davon;23898;34418;-10520
01.01.13;WA66;Schirme, Gehstöcke usw., Peitschen;6566;21402;-14836
01.01.13;WA67;Zugerichtete Federn, Daunen, künstliche Blumen;9561;15708;-6147
01.01.13;WA68;Waren aus Steinen, Gips, Zement usw.;266929;188566;78363
01.01.13;WA69;Keramische Waren;222305;169628;52677
01.01.13;WA70;Glas und Glaswaren;411976;320788;91188
01.01.13;WA71;Perlen, Edelsteine, Edelmetalle;1327279;1318964;8315
01.01.13;WA72;Eisen und Stahl;1966079;2044945;-78866
01.01.13;WA73;Waren aus Eisen oder Stahl;2000975;1338702;662273
01.01.13;WA74;Kupfer und Waren daraus;943814;942469;1345
01.01.13;WA75;Nickel und Waren daraus;96214;158095;-61881
01.01.13;WA76;Aluminium und Waren daraus;1025583;1054189;-28606
01.01.13;WA78;Blei und Waren daraus;43078;30393;12685
01.01.13;WA79;Zink und Waren daraus;47011;76150;-29139
01.01.13;WA80;Zinn und Waren daraus;10275;32056;-21781
01.01.13;WA81;Andere unedle Metalle, Cermets usw.;107034;113008;-5974
01.01.13;WA82;Werkzeuge, Schneidwaren, Essbestecke;566771;347564;219207
01.01.13;WA83;Verschiedene Waren aus unedlen Metallen;528443;320074;208369
01.01.13;WA84;Maschinen, Apparate, mechanische Geräte;14699790;9032257;5667533
01.01.13;WA85;Elektrotechnische Erzeugnisse;8759491;7891099;868392
01.01.13;WA86;Schienenfahrzeuge;250134;187747;62387
01.01.13;WA87;Kraftfahrzeuge, Landfahrzeuge;13819741;5268364;8551377
01.01.13;WA88;Luftfahrzeuge, Raumfahrzeuge;2116322;1527202;589120
01.01.13;WA89;Wasserfahrzeuge;152340;644615;-492275
01.01.13;WA90;Optische, photografische usw. Erzeugnisse;3839597;2205427;1634170
01.01.13;WA91;Uhrmacherwaren;119737;168426;-48689
01.01.13;WA92;Musikinstrumente;35930;33680;2250
01.01.13;WA93;Waffen und Munition;32474;13721;18753
01.01.13;WA94;Möbel, Beleuchtungskörper usw.;1005335;1218277;-212942
01.01.13;WA95;Spielzeug, Spiele usw., Sportgeräte;233831;416159;-182328
01.01.13;WA96;Verschiedene Waren;289413;208805;80608
01.01.13;WA97;Kunstgegenstände, Sammlungsstücke;36654;35060;1594
01.01.13;WA98;Vollständige Fabrikationsanlagen;444440;3560;440880
01.01.13;WA99;Zusammenstellungen verschiedener Waren;1321327;852047;469280
01.01.14;WA01;Lebende Tiere;130148;199488;-69340
01.01.14;WA02;Fleisch;626050;496033;130017
01.01.14;WA03;Fische, Krebs- und Weichtiere;109904;304103;-194199
01.01.14;WA04;Milch, Milcherzeugnisse, Eier, Honig;881402;592502;288900
01.01.14;WA05;Andere Waren tierischen Ursprungs;70886;73778;-2892
01.01.14;WA06;Pflanzen, Waren des Blumenhandels;48782;185178;-136396
01.01.14;WA07;Gemüse, Pflanzen für Ernährung;75544;487170;-411626
01.01.14;WA08;Geniessbare Früchte und Nüsse;115407;637729;-522322
01.01.14;WA09;Kaffee, Tee, Mate, Gewürze;186578;276368;-89790
01.01.14;WA10;Getreide;262493;259234;3259
01.01.14;WA11;Müllereierzeugnisse, Malz usw.;104069;42255;61814
01.01.14;WA12;Ölsamen usw., Heilpflanzen usw.;125923;379923;-254000
01.01.14;WA13;Schellack, Gummen, Harz, Pflanzensaft;41447;32736;8711
01.01.14;WA14;Flechtstoffe usw. pflanzlichen Ursprungs;793;2159;-1366
01.01.14;WA15;Tierische und pflanzliche Fette, Öle, Wachs;244020;305024;-61004
01.01.14;WA16;Zubereitungen von Fleisch, Fisch usw.;231976;200293;31683
01.01.14;WA17;Zucker und Zuckerwaren;150179;138770;11409
01.01.14;WA18;Kakao und Zubereitungen aus Kakao;359244;312925;46319
01.01.14;WA19;Zubereitungen aus Getreide usw., Backwaren;414496;267518;146978
01.01.14;WA20;Zubereitungen von Gemüse, Früchten usw.;205524;354859;-149335
01.01.14;WA21;Verschiedene Lebensmittelzubereitungen;368893;205588;163305
01.01.14;WA22;Getränke, alkoholhaltige Flüssigkeiten, Essig;369680;484642;-114962
01.01.14;WA23;Rückstände der Lebensmittelindustrie, Futter;325728;338360;-12632
01.01.14;WA24;Tabak;254048;121038;133010
01.01.14;WA25;Salz, Schwefel, Steine, Erden usw.;146987;136138;10849
01.01.14;WA26;Erze, Schlacken, Aschen;24973;794905;-769932
01.01.14;WA27;Mineralische Brennstoffe usw.;2408750;10104820;-7696070
01.01.14;WA28;Anorganische chemische Erzeugnisse;711751;524701;187050
01.01.14;WA29;Organische chemische Erzeugnisse;2362695;2198536;164159
01.01.14;WA30;Pharmazeutische Erzeugnisse;5260172;2898896;2361276
01.01.14;WA31;Düngemittel;185286;148610;36676
01.01.14;WA32;Gerb- und Farbstoffe, Farben, Lacke usw.;883777;487387;396390
01.01.14;WA33;Etherische Öle, Riech-, Schönheitsmittel;627753;396831;230922
01.01.14;WA34;Seifen, Waschmittel usw.;562084;240806;321278
01.01.14;WA35;Eiweissstoffe, Klebstoffe, Enzyme;240576;170788;69788
01.01.14;WA36;Sprengstoffe, pyrotechnische Artikel usw.;16648;18437;-1789
01.01.14;WA37;Photochemische Erzeugnisse;103899;52705;51194
01.01.14;WA38;Verschiedene Erzeugnisse der Chemischen Industrie;1701621;942787;758834
01.01.14;WA39;Kunststoffe und Waren daraus;4531656;2768324;1763332
01.01.14;WA40;Kautschuk und Waren daraus;1139289;1077898;61391
01.01.14;WA41;Häute, Felle, Leder;98434;74574;23860
01.01.14;WA42;Lederwaren, Sattlerwaren;143510;303812;-160302
01.01.14;WA43;Pelzfelle, künstliches Pelzwerk;14760;10626;4134
01.01.14;WA44;Holz, Holzwaren, Holzkohle;569176;579605;-10429
01.01.14;WA45;Kork, Korkwaren;2272;8374;-6102
01.01.14;WA46;Flechtwaren, Korbmacherwaren;3732;9794;-6062
01.01.14;WA47;Halbstoffe aus Holz usw., Papierabfall;101873;288964;-187091
01.01.14;WA48;Papier, Pappe und Waren daraus;1452917;1019728;433189
01.01.14;WA49;Bücher, Zeitungen, Bilddrucke usw.;333628;143778;189850
01.01.14;WA50;Seide;5855;6891;-1036
01.01.14;WA51;Wolle, feine und grobe Tierhaare;43740;48843;-5103
01.01.14;WA52;Baumwolle;86642;92560;-5918
01.01.14;WA53;Andere pflanzliche Spinnstoffe, Papiergarn;4202;6330;-2128
01.01.14;WA54;Synthetisches oder künstliches Filament;163313;118317;44996
01.01.14;WA55;Synthetische oder künstliche Spinnfaser;167797;138846;28951
01.01.14;WA56;Watte, Filz, Vliesstoff usw., Tauwerk;182648;99473;83175
01.01.14;WA57;Teppiche, Fussbodenbelag aus Spinnstoff;41330;98001;-56671
01.01.14;WA58;Spezialgewebe, Spitzen, Tapisserien;38846;24660;14186
01.01.14;WA59;Getränkte, bestrichene usw. Gewebe;173170;88132;85038
01.01.14;WA60;Gewirke und Gestricke;62603;34040;28563
01.01.14;WA61;Bekleidung usw. aus Gewirken, Gestricken;604383;1239850;-635467
01.01.14;WA62;Andere Bekleidung, Bekleidungszubehör;692365;1319009;-626644
01.01.14;WA63;Andere Konfektion, Spinnstoffwaren usw.;178717;293106;-114389
01.01.14;WA64;Schuhe, Gamaschen, ähnliche Waren;421378;822435;-401057
01.01.14;WA65;Kopfbedeckungen und Teile davon;27510;35150;-7640
01.01.14;WA66;Schirme, Gehstöcke usw., Peitschen;6205;17689;-11484
01.01.14;WA67;Zugerichtete Federn, Daunen, künstliche Blumen;9081;14949;-5868
01.01.14;WA68;Waren aus Steinen, Gips, Zement usw.;300358;195360;104998
01.01.14;WA69;Keramische Waren;229081;189296;39785
01.01.14;WA70;Glas und Glaswaren;453650;346932;106718
01.01.14;WA71;Perlen, Edelsteine, Edelmetalle;874239;1087278;-213039
01.01.14;WA72;Eisen und Stahl;1834316;1985345;-151029
01.01.14;WA73;Waren aus Eisen oder Stahl;2048205;1389433;658772
01.01.14;WA74;Kupfer und Waren daraus;950212;768705;181507
01.01.14;WA75;Nickel und Waren daraus;78532;88813;-10281
01.01.14;WA76;Aluminium und Waren daraus;994655;1082558;-87903
01.01.14;WA78;Blei und Waren daraus;40677;20223;20454
01.01.14;WA79;Zink und Waren daraus;50501;82987;-32486
01.01.14;WA80;Zinn und Waren daraus;11559;33740;-22181
01.01.14;WA81;Andere unedle Metalle, Cermets usw.;112547;109696;2851
01.01.14;WA82;Werkzeuge, Schneidwaren, Essbestecke;579409;352538;226871
01.01.14;WA83;Verschiedene Waren aus unedlen Metallen;552372;339203;213169
01.01.14;WA84;Maschinen, Apparate, mechanische Geräte;14804208;9463544;5340664
01.01.14;WA85;Elektrotechnische Erzeugnisse;8843034;8281104;561930
01.01.14;WA86;Schienenfahrzeuge;253514;160117;93397
01.01.14;WA87;Kraftfahrzeuge, Landfahrzeuge;15121326;5708283;9413043
01.01.14;WA88;Luftfahrzeuge, Raumfahrzeuge;1734452;1433520;300932
01.01.14;WA89;Wasserfahrzeuge;99535;73494;26041
01.01.14;WA90;Optische, photografische usw. Erzeugnisse;3946298;2258056;1688242
01.01.14;WA91;Uhrmacherwaren;133842;164097;-30255
01.01.14;WA92;Musikinstrumente;37030;37628;-598
01.01.14;WA93;Waffen und Munition;28967;13215;15752
01.01.14;WA94;Möbel, Beleuchtungskörper usw.;1027306;1276121;-248815
01.01.14;WA95;Spielzeug, Spiele usw., Sportgeräte;217522;341695;-124173
01.01.14;WA96;Verschiedene Waren;407683;280131;127552
01.01.14;WA97;Kunstgegenstände, Sammlungsstücke;61206;24378;36828
01.01.14;WA98;Vollständige Fabrikationsanlagen;217430;932;216498
01.01.14;WA99;Zusammenstellungen verschiedener Waren;1403830;812958;590872
01.01.15;WA01;Lebende Tiere;123536;139414;-15878
01.01.15;WA02;Fleisch;596091;453367;142724
01.01.15;WA03;Fische, Krebs- und Weichtiere;102284;283429;-181145
01.01.15;WA04;Milch, Milcherzeugnisse, Eier, Honig;700739;506042;194697
01.01.15;WA05;Andere Waren tierischen Ursprungs;65532;76881;-11349
01.01.15;WA06;Pflanzen, Waren des Blumenhandels;43096;194923;-151827
01.01.15;WA07;Gemüse, Pflanzen für Ernährung;68690;473466;-404776
01.01.15;WA08;Geniessbare Früchte und Nüsse;150848;699575;-548727
01.01.15;WA09;Kaffee, Tee, Mate, Gewürze;199359;362460;-163101
01.01.15;WA10;Getreide;276874;257370;19504
01.01.15;WA11;Müllereierzeugnisse, Malz usw.;106961;35275;71686
01.01.15;WA12;Ölsamen usw., Heilpflanzen usw.;124756;383951;-259195
01.01.15;WA13;Schellack, Gummen, Harz, Pflanzensaft;44806;45280;-474
01.01.15;WA14;Flechtstoffe usw. pflanzlichen Ursprungs;491;2953;-2462
01.01.15;WA15;Tierische und pflanzliche Fette, Öle, Wachs;202134;282376;-80242
01.01.15;WA16;Zubereitungen von Fleisch, Fisch usw.;212561;183581;28980
01.01.15;WA17;Zucker und Zuckerwaren;139468;123722;15746
01.01.15;WA18;Kakao und Zubereitungen aus Kakao;374240;328005;46235
01.01.15;WA19;Zubereitungen aus Getreide usw., Backwaren;418341;268779;149562
01.01.15;WA20;Zubereitungen von Gemüse, Früchten usw.;206867;362967;-156100
01.01.15;WA21;Verschiedene Lebensmittelzubereitungen;369057;218457;150600
01.01.15;WA22;Getränke, alkoholhaltige Flüssigkeiten, Essig;344549;456187;-111638
01.01.15;WA23;Rückstände der Lebensmittelindustrie, Futter;319190;275050;44140
01.01.15;WA24;Tabak;303341;148893;154448
01.01.15;WA25;Salz, Schwefel, Steine, Erden usw.;143862;137746;6116
01.01.15;WA26;Erze, Schlacken, Aschen;25168;480794;-455626
01.01.15;WA27;Mineralische Brennstoffe usw.;2079062;7702500;-5623438
01.01.15;WA28;Anorganische chemische Erzeugnisse;732893;517116;215777
01.01.15;WA29;Organische chemische Erzeugnisse;2214070;2192171;21899
01.01.15;WA30;Pharmazeutische Erzeugnisse;5131353;3000196;2131157
01.01.15;WA31;Düngemittel;231866;162103;69763
01.01.15;WA32;Gerb- und Farbstoffe, Farben, Lacke usw.;879816;461444;418372
01.01.15;WA33;Etherische Öle, Riech-, Schönheitsmittel;684157;491671;192486
01.01.15;WA34;Seifen, Waschmittel usw.;563135;282373;280762
01.01.15;WA35;Eiweissstoffe, Klebstoffe, Enzyme;248607;154477;94130
01.01.15;WA36;Sprengstoffe, pyrotechnische Artikel usw.;15964;15880;84
01.01.15;WA37;Photochemische Erzeugnisse;90403;59766;30637
01.01.15;WA38;Verschiedene Erzeugnisse der Chemischen Industrie;1803578;918755;884823
01.01.15;WA39;Kunststoffe und Waren daraus;4373234;2698863;1674371
01.01.15;WA40;Kautschuk und Waren daraus;1042379;975456;66923
01.01.15;WA41;Häute, Felle, Leder;96958;74080;22878
01.01.15;WA42;Lederwaren, Sattlerwaren;156218;322448;-166230
01.01.15;WA43;Pelzfelle, künstliches Pelzwerk;12147;7873;4274
01.01.15;WA44;Holz, Holzwaren, Holzkohle;524060;546074;-22014
01.01.15;WA45;Kork, Korkwaren;2109;10226;-8117
01.01.15;WA46;Flechtwaren, Korbmacherwaren;3754;13246;-9492
01.01.15;WA47;Halbstoffe aus Holz usw., Papierabfall;94243;265772;-171529
01.01.15;WA48;Papier, Pappe und Waren daraus;1385223;987390;397833
01.01.15;WA49;Bücher, Zeitungen, Bilddrucke usw.;325447;192182;133265
01.01.15;WA50;Seide;4524;4883;-359
01.01.15;WA51;Wolle, feine und grobe Tierhaare;49514;52715;-3201
01.01.15;WA52;Baumwolle;71368;80957;-9589
01.01.15;WA53;Andere pflanzliche Spinnstoffe, Papiergarn;3983;5550;-1567
01.01.15;WA54;Synthetisches oder künstliches Filament;151285;123861;27424
01.01.15;WA55;Synthetische oder künstliche Spinnfaser;158472;125408;33064
01.01.15;WA56;Watte, Filz, Vliesstoff usw., Tauwerk;189531;106433;83098
01.01.15;WA57;Teppiche, Fussbodenbelag aus Spinnstoff;38381;88994;-50613
01.01.15;WA58;Spezialgewebe, Spitzen, Tapisserien;36398;22519;13879
01.01.15;WA59;Getränkte, bestrichene usw. Gewebe;169772;85537;84235
01.01.15;WA60;Gewirke und Gestricke;58795;32785;26010
01.01.15;WA61;Bekleidung usw. aus Gewirken, Gestricken;591345;1304544;-713199
01.01.15;WA62;Andere Bekleidung, Bekleidungszubehör;660596;1402514;-741918
01.01.15;WA63;Andere Konfektion, Spinnstoffwaren usw.;186560;294761;-108201
01.01.15;WA64;Schuhe, Gamaschen, ähnliche Waren;413842;851412;-437570
01.01.15;WA65;Kopfbedeckungen und Teile davon;23897;42216;-18319
01.01.15;WA66;Schirme, Gehstöcke usw., Peitschen;7789;26387;-18598
01.01.15;WA67;Zugerichtete Federn, Daunen, künstliche Blumen;8940;16703;-7763
01.01.15;WA68;Waren aus Steinen, Gips, Zement usw.;300359;207471;92888
01.01.15;WA69;Keramische Waren;237618;204419;33199
01.01.15;WA70;Glas und Glaswaren;458512;353761;104751
01.01.15;WA71;Perlen, Edelsteine, Edelmetalle;841379;1184934;-343555
01.01.15;WA72;Eisen und Stahl;1852207;1854498;-2291
01.01.15;WA73;Waren aus Eisen oder Stahl;2016455;1432676;583779
01.01.15;WA74;Kupfer und Waren daraus;872795;645743;227052
01.01.15;WA75;Nickel und Waren daraus;98010;93077;4933
01.01.15;WA76;Aluminium und Waren daraus;1079480;1193728;-114248
01.01.15;WA78;Blei und Waren daraus;34984;24959;10025
01.01.15;WA79;Zink und Waren daraus;49086;90160;-41074
01.01.15;WA80;Zinn und Waren daraus;9283;33888;-24605
01.01.15;WA81;Andere unedle Metalle, Cermets usw.;112335;132207;-19872
01.01.15;WA82;Werkzeuge, Schneidwaren, Essbestecke;578083;369469;208614
01.01.15;WA83;Verschiedene Waren aus unedlen Metallen;549787;346219;203568
01.01.15;WA84;Maschinen, Apparate, mechanische Geräte;14685545;9351381;5334164
01.01.15;WA85;Elektrotechnische Erzeugnisse;9027660;8628566;399094
01.01.15;WA86;Schienenfahrzeuge;307751;246070;61681
01.01.15;WA87;Kraftfahrzeuge, Landfahrzeuge;15115425;6184796;8930629
01.01.15;WA88;Luftfahrzeuge, Raumfahrzeuge;2427611;1938834;488777
01.01.15;WA89;Wasserfahrzeuge;98922;55041;43881
01.01.15;WA90;Optische, photografische usw. Erzeugnisse;4084542;2410474;1674068
01.01.15;WA91;Uhrmacherwaren;134714;175869;-41155
01.01.15;WA92;Musikinstrumente;41268;43212;-1944
01.01.15;WA93;Waffen und Munition;23263;10954;12309
01.01.15;WA94;Möbel, Beleuchtungskörper usw.;1061540;1435093;-373553
01.01.15;WA95;Spielzeug, Spiele usw., Sportgeräte;254639;420816;-166177
01.01.15;WA96;Verschiedene Waren;291406;198832;92574
01.01.15;WA97;Kunstgegenstände, Sammlungsstücke;46769;31130;15639
01.01.15;WA98;Vollständige Fabrikationsanlagen;215501;4153;211348
01.01.15;WA99;Zusammenstellungen verschiedener Waren;1615240;795438;819802
01.01.16;WA01;Lebende Tiere;116961;144151;-27190
01.01.16;WA02;Fleisch;580286;488549;91737
01.01.16;WA03;Fische, Krebs- und Weichtiere;104343;312627;-208284
01.01.16;WA04;Milch, Milcherzeugnisse, Eier, Honig;627455;521902;105553
01.01.16;WA05;Andere Waren tierischen Ursprungs;59299;74210;-14911
01.01.16;WA06;Pflanzen, Waren des Blumenhandels;42591;176519;-133928
01.01.16;WA07;Gemüse, Pflanzen für Ernährung;85077;489344;-404267
01.01.16;WA08;Geniessbare Früchte und Nüsse;149478;752580;-603102
01.01.16;WA09;Kaffee, Tee, Mate, Gewürze;207800;318721;-110921
01.01.16;WA10;Getreide;207388;226604;-19216
01.01.16;WA11;Müllereierzeugnisse, Malz usw.;109532;44409;65123
01.01.16;WA12;Ölsamen usw., Heilpflanzen usw.;115955;398672;-282717
01.01.16;WA13;Schellack, Gummen, Harz, Pflanzensaft;47706;36187;11519
01.01.16;WA14;Flechtstoffe usw. pflanzlichen Ursprungs;559;3515;-2956
01.01.16;WA15;Tierische und pflanzliche Fette, Öle, Wachs;223185;313154;-89969
01.01.16;WA16;Zubereitungen von Fleisch, Fisch usw.;221403;208533;12870
01.01.16;WA17;Zucker und Zuckerwaren;132459;121235;11224
01.01.16;WA18;Kakao und Zubereitungen aus Kakao;445040;389060;55980
01.01.16;WA19;Zubereitungen aus Getreide usw., Backwaren;437985;317878;120107
01.01.16;WA20;Zubereitungen von Gemüse, Früchten usw.;193192;371987;-178795
01.01.16;WA21;Verschiedene Lebensmittelzubereitungen;374386;227527;146859
01.01.16;WA22;Getränke, alkoholhaltige Flüssigkeiten, Essig;369138;495045;-125907
01.01.16;WA23;Rückstände der Lebensmittelindustrie, Futter;313893;295777;18116
01.01.16;WA24;Tabak;373338;152269;221069
01.01.16;WA25;Salz, Schwefel, Steine, Erden usw.;147761;145576;2185
01.01.16;WA26;Erze, Schlacken, Aschen;20599;541852;-521253
01.01.16;WA27;Mineralische Brennstoffe usw.;1681119;5953783;-4272664
01.01.16;WA28;Anorganische chemische Erzeugnisse;675946;474999;200947
01.01.16;WA29;Organische chemische Erzeugnisse;2169011;2678976;-509965
01.01.16;WA30;Pharmazeutische Erzeugnisse;5354323;3400863;1953460
01.01.16;WA31;Düngemittel;193741;133702;60039
01.01.16;WA32;Gerb- und Farbstoffe, Farben, Lacke usw.;842992;464086;378906
01.01.16;WA33;Etherische Öle, Riech-, Schönheitsmittel;631949;495582;136367
01.01.16;WA34;Seifen, Waschmittel usw.;556036;283280;272756
01.01.16;WA35;Eiweissstoffe, Klebstoffe, Enzyme;229646;163352;66294
01.01.16;WA36;Sprengstoffe, pyrotechnische Artikel usw.;18539;14031;4508
01.01.16;WA37;Photochemische Erzeugnisse;95292;54602;40690
01.01.16;WA38;Verschiedene Erzeugnisse der Chemischen Industrie;1796284;1003180;793104
01.01.16;WA39;Kunststoffe und Waren daraus;4459479;2873999;1585480
01.01.16;WA40;Kautschuk und Waren daraus;1077297;1021797;55500
01.01.16;WA41;Häute, Felle, Leder;82317;66665;15652
01.01.16;WA42;Lederwaren, Sattlerwaren;159557;357027;-197470
01.01.16;WA43;Pelzfelle, künstliches Pelzwerk;11497;7541;3956
01.01.16;WA44;Holz, Holzwaren, Holzkohle;546855;596619;-49764
01.01.16;WA45;Kork, Korkwaren;2455;9280;-6825
01.01.16;WA46;Flechtwaren, Korbmacherwaren;5175;12021;-6846
01.01.16;WA47;Halbstoffe aus Holz usw., Papierabfall;98832;309357;-210525
01.01.16;WA48;Papier, Pappe und Waren daraus;1404817;1028719;376098
01.01.16;WA49;Bücher, Zeitungen, Bilddrucke usw.;330589;208746;121843
01.01.16;WA50;Seide;3567;4251;-684
01.01.16;WA51;Wolle, feine und grobe Tierhaare;55014;51753;3261
01.01.16;WA52;Baumwolle;67684;78943;-11259
01.01.16;WA53;Andere pflanzliche Spinnstoffe, Papiergarn;4251;6542;-2291
01.01.16;WA54;Synthetisches oder künstliches Filament;145232;132602;12630
01.01.16;WA55;Synthetische oder künstliche Spinnfaser;137885;127473;10412
01.01.16;WA56;Watte, Filz, Vliesstoff usw., Tauwerk;179712;105361;74351
01.01.16;WA57;Teppiche, Fussbodenbelag aus Spinnstoff;45752;101325;-55573
01.01.16;WA58;Spezialgewebe, Spitzen, Tapisserien;39623;24363;15260
01.01.16;WA59;Getränkte, bestrichene usw. Gewebe;180236;90436;89800
01.01.16;WA60;Gewirke und Gestricke;60462;33357;27105
01.01.16;WA61;Bekleidung usw. aus Gewirken, Gestricken;576554;1310790;-734236
01.01.16;WA62;Andere Bekleidung, Bekleidungszubehör;648939;1396084;-747145
01.01.16;WA63;Andere Konfektion, Spinnstoffwaren usw.;185158;318868;-133710
01.01.16;WA64;Schuhe, Gamaschen, ähnliche Waren;490459;970527;-480068
01.01.16;WA65;Kopfbedeckungen und Teile davon;30915;46020;-15105
01.01.16;WA66;Schirme, Gehstöcke usw., Peitschen;7113;27378;-20265
01.01.16;WA67;Zugerichtete Federn, Daunen, künstliche Blumen;9728;16057;-6329
01.01.16;WA68;Waren aus Steinen, Gips, Zement usw.;303450;225846;77604
01.01.16;WA69;Keramische Waren;228389;211563;16826
01.01.16;WA70;Glas und Glaswaren;486534;371438;115096
01.01.16;WA71;Perlen, Edelsteine, Edelmetalle;733498;1180195;-446697
01.01.16;WA72;Eisen und Stahl;1488211;1613635;-125424
01.01.16;WA73;Waren aus Eisen oder Stahl;1867763;1489017;378746
01.01.16;WA74;Kupfer und Waren daraus;778166;556140;222026
01.01.16;WA75;Nickel und Waren daraus;65896;77116;-11220
01.01.16;WA76;Aluminium und Waren daraus;1040259;1121585;-81326
01.01.16;WA78;Blei und Waren daraus;28648;27393;1255
01.01.16;WA79;Zink und Waren daraus;40327;80818;-40491
01.01.16;WA80;Zinn und Waren daraus;6827;19976;-13149
01.01.16;WA81;Andere unedle Metalle, Cermets usw.;103406;132279;-28873
01.01.16;WA82;Werkzeuge, Schneidwaren, Essbestecke;555564;381893;173671
01.01.16;WA83;Verschiedene Waren aus unedlen Metallen;560143;362407;197736
01.01.16;WA84;Maschinen, Apparate, mechanische Geräte;14240649;9763416;4477233
01.01.16;WA85;Elektrotechnische Erzeugnisse;9321762;9166491;155271
01.01.16;WA86;Schienenfahrzeuge;407871;162725;245146
01.01.16;WA87;Kraftfahrzeuge, Landfahrzeuge;15296296;6926027;8370269
01.01.16;WA88;Luftfahrzeuge, Raumfahrzeuge;2264994;1379312;885682
01.01.16;WA89;Wasserfahrzeuge;79546;63890;15656
01.01.16;WA90;Optische, photografische usw. Erzeugnisse;4183757;2629968;1553789
01.01.16;WA91;Uhrmacherwaren;123392;193695;-70303
01.01.16;WA92;Musikinstrumente;39220;45257;-6037
01.01.16;WA93;Waffen und Munition;26567;15166;11401
01.01.16;WA94;Möbel, Beleuchtungskörper usw.;1084882;1534107;-449225
01.01.16;WA95;Spielzeug, Spiele usw., Sportgeräte;257984;440496;-182512
01.01.16;WA96;Verschiedene Waren;321914;206624;115290
01.01.16;WA97;Kunstgegenstände, Sammlungsstücke;54156;31267;22889
01.01.16;WA98;Vollständige Fabrikationsanlagen;205218;245;204973
01.01.16;WA99;Zusammenstellungen verschiedener Waren;1549543;833448;716095
01.01.17;WA01;Lebende Tiere;128847;162909;-34062
01.01.17;WA02;Fleisch;615763;526383;89380
01.01.17;WA03;Fische, Krebs- und Weichtiere;117203;348022;-230819
01.01.17;WA04;Milch, Milcherzeugnisse, Eier, Honig;763231;601885;161346
01.01.17;WA05;Andere Waren tierischen Ursprungs;65414;75344;-9930
01.01.17;WA06;Pflanzen, Waren des Blumenhandels;45011;193836;-148825
01.01.17;WA07;Gemüse, Pflanzen für Ernährung;99337;642355;-543018
01.01.17;WA08;Geniessbare Früchte und Nüsse;142812;760994;-618182
01.01.17;WA09;Kaffee, Tee, Mate, Gewürze;242452;408018;-165566
01.01.17;WA10;Getreide;259486;236508;22978
01.01.17;WA11;Müllereierzeugnisse, Malz usw.;126888;44163;82725
01.01.17;WA12;Ölsamen usw., Heilpflanzen usw.;151392;410182;-258790
01.01.17;WA13;Schellack, Gummen, Harz, Pflanzensaft;56172;53786;2386
01.01.17;WA14;Flechtstoffe usw. pflanzlichen Ursprungs;584;3925;-3341
01.01.17;WA15;Tierische und pflanzliche Fette, Öle, Wachs;238597;322032;-83435
01.01.17;WA16;Zubereitungen von Fleisch, Fisch usw.;222724;223747;-1023
01.01.17;WA17;Zucker und Zuckerwaren;153458;129161;24297
01.01.17;WA18;Kakao und Zubereitungen aus Kakao;432645;431356;1289
01.01.17;WA19;Zubereitungen aus Getreide usw., Backwaren;457517;327826;129691
01.01.17;WA20;Zubereitungen von Gemüse, Früchten usw.;206374;413910;-207536
01.01.17;WA21;Verschiedene Lebensmittelzubereitungen;437549;272553;164996
01.01.17;WA22;Getränke, alkoholhaltige Flüssigkeiten, Essig;381047;488107;-107060
01.01.17;WA23;Rückstände der Lebensmittelindustrie, Futter;325622;328429;-2807
01.01.17;WA24;Tabak;351108;152740;198368
01.01.17;WA25;Salz, Schwefel, Steine, Erden usw.;134794;130076;4718
01.01.17;WA26;Erze, Schlacken, Aschen;30299;625622;-595323
01.01.17;WA27;Mineralische Brennstoffe usw.;2058876;6983032;-4924156
01.01.17;WA28;Anorganische chemische Erzeugnisse;689707;530137;159570
01.01.17;WA29;Organische chemische Erzeugnisse;2191296;2506755;-315459
01.01.17;WA30;Pharmazeutische Erzeugnisse;6245412;3800491;2444921
01.01.17;WA31;Düngemittel;180113;99607;80506
01.01.17;WA32;Gerb- und Farbstoffe, Farben, Lacke usw.;896176;487234;408942
01.01.17;WA33;Etherische Öle, Riech-, Schönheitsmittel;736447;518972;217475
01.01.17;WA34;Seifen, Waschmittel usw.;634662;307957;326705
01.01.17;WA35;Eiweissstoffe, Klebstoffe, Enzyme;281484;169052;112432
01.01.17;WA36;Sprengstoffe, pyrotechnische Artikel usw.;18748;13561;5187
01.01.17;WA37;Photochemische Erzeugnisse;100754;56906;43848
01.01.17;WA38;Verschiedene Erzeugnisse der Chemischen Industrie;2002990;1095827;907163
01.01.17;WA39;Kunststoffe und Waren daraus;4910849;3140736;1770113
01.01.17;WA40;Kautschuk und Waren daraus;1200945;1072894;128051
01.01.17;WA41;Häute, Felle, Leder;78140;63914;14226
01.01.17;WA42;Lederwaren, Sattlerwaren;184879;344341;-159462
01.01.17;WA43;Pelzfelle, künstliches Pelzwerk;8467;8996;-529
01.01.17;WA44;Holz, Holzwaren, Holzkohle;561823;601412;-39589
01.01.17;WA45;Kork, Korkwaren;2780;11925;-9145
01.01.17;WA46;Flechtwaren, Korbmacherwaren;3464;13260;-9796
01.01.17;WA47;Halbstoffe aus Holz usw., Papierabfall;113385;308725;-195340
01.01.17;WA48;Papier, Pappe und Waren daraus;1451558;1016406;435152
01.01.17;WA49;Bücher, Zeitungen, Bilddrucke usw.;312936;217517;95419
01.01.17;WA50;Seide;3280;4874;-1594
01.01.17;WA51;Wolle, feine und grobe Tierhaare;48510;59152;-10642
01.01.17;WA52;Baumwolle;70046;82548;-12502
01.01.17;WA53;Andere pflanzliche Spinnstoffe, Papiergarn;4301;6658;-2357
01.01.17;WA54;Synthetisches oder künstliches Filament;153098;132753;20345
01.01.17;WA55;Synthetische oder künstliche Spinnfaser;155300;135132;20168
01.01.17;WA56;Watte, Filz, Vliesstoff usw., Tauwerk;187284;113163;74121
01.01.17;WA57;Teppiche, Fussbodenbelag aus Spinnstoff;45804;102962;-57158
01.01.17;WA58;Spezialgewebe, Spitzen, Tapisserien;42196;21934;20262
01.01.17;WA59;Getränkte, bestrichene usw. Gewebe;198420;97089;101331
01.01.17;WA60;Gewirke und Gestricke;66024;35652;30372
01.01.17;WA61;Bekleidung usw. aus Gewirken, Gestricken;734541;1425630;-691089
01.01.17;WA62;Andere Bekleidung, Bekleidungszubehör;806055;1459452;-653397
01.01.17;WA63;Andere Konfektion, Spinnstoffwaren usw.;186756;316623;-129867
01.01.17;WA64;Schuhe, Gamaschen, ähnliche Waren;606058;974730;-368672
01.01.17;WA65;Kopfbedeckungen und Teile davon;29171;50601;-21430
01.01.17;WA66;Schirme, Gehstöcke usw., Peitschen;6527;25311;-18784
01.01.17;WA67;Zugerichtete Federn, Daunen, künstliche Blumen;11159;18456;-7297
01.01.17;WA68;Waren aus Steinen, Gips, Zement usw.;324468;239774;84694
01.01.17;WA69;Keramische Waren;237620;224392;13228
01.01.17;WA70;Glas und Glaswaren;504795;432120;72675
01.01.17;WA71;Perlen, Edelsteine, Edelmetalle;852532;1636088;-783556
01.01.17;WA72;Eisen und Stahl;1830091;1981753;-151662
01.01.17;WA73;Waren aus Eisen oder Stahl;2073028;1589285;483743
01.01.17;WA74;Kupfer und Waren daraus;890185;836098;54087
01.01.17;WA75;Nickel und Waren daraus;75600;102823;-27223
01.01.17;WA76;Aluminium und Waren daraus;1134865;1204432;-69567
01.01.17;WA78;Blei und Waren daraus;33394;35824;-2430
01.01.17;WA79;Zink und Waren daraus;56211;116995;-60784
01.01.17;WA80;Zinn und Waren daraus;9540;47309;-37769
01.01.17;WA81;Andere unedle Metalle, Cermets usw.;111479;154068;-42589
01.01.17;WA82;Werkzeuge, Schneidwaren, Essbestecke;638651;403046;235605
01.01.17;WA83;Verschiedene Waren aus unedlen Metallen;627401;385675;241726
01.01.17;WA84;Maschinen, Apparate, mechanische Geräte;15950727;10739023;5211704
01.01.17;WA85;Elektrotechnische Erzeugnisse;10483888;10597332;-113444
01.01.17;WA86;Schienenfahrzeuge;389379;300250;89129
01.01.17;WA87;Kraftfahrzeuge, Landfahrzeuge;16530345;7900151;8630194
01.01.17;WA88;Luftfahrzeuge, Raumfahrzeuge;2608439;1480362;1128077
01.01.17;WA89;Wasserfahrzeuge;668320;272211;396109
01.01.17;WA90;Optische, photografische usw. Erzeugnisse;4818021;2793226;2024795
01.01.17;WA91;Uhrmacherwaren;128152;169779;-41627
01.01.17;WA92;Musikinstrumente;44120;43340;780
01.01.17;WA93;Waffen und Munition;30627;15536;15091
01.01.17;WA94;Möbel, Beleuchtungskörper usw.;1159326;1555649;-396323
01.01.17;WA95;Spielzeug, Spiele usw., Sportgeräte;275423;457104;-181681
01.01.17;WA96;Verschiedene Waren;300563;227506;73057
01.01.17;WA97;Kunstgegenstände, Sammlungsstücke;71490;74735;-3245
01.01.17;WA98;Vollständige Fabrikationsanlagen;140048;NULL;#WERT!
01.01.17;WA99;Zusammenstellungen verschiedener Waren;1362526;924602;437924
01.01.18;WA01;Lebende Tiere;104906;143416;-38510
01.01.18;WA02;Fleisch;604898;552876;52022
01.01.18;WA03;Fische, Krebs- und Weichtiere;125753;347457;-221704
01.01.18;WA04;Milch, Milcherzeugnisse, Eier, Honig;765509;633496;132013
01.01.18;WA05;Andere Waren tierischen Ursprungs;74150;80255;-6105
01.01.18;WA06;Pflanzen, Waren des Blumenhandels;49516;198269;-148753
01.01.18;WA07;Gemüse, Pflanzen für Ernährung;77222;582775;-505553
01.01.18;WA08;Geniessbare Früchte und Nüsse;156837;833486;-676649
01.01.18;WA09;Kaffee, Tee, Mate, Gewürze;231897;365745;-133848
01.01.18;WA10;Getreide;183840;233356;-49516
01.01.18;WA11;Müllereierzeugnisse, Malz usw.;139838;47224;92614
01.01.18;WA12;Ölsamen usw., Heilpflanzen usw.;150227;464440;-314213
01.01.18;WA13;Schellack, Gummen, Harz, Pflanzensaft;56965;46501;10464
01.01.18;WA14;Flechtstoffe usw. pflanzlichen Ursprungs;513;4042;-3529
01.01.18;WA15;Tierische und pflanzliche Fette, Öle, Wachs;209919;315773;-105854
01.01.18;WA16;Zubereitungen von Fleisch, Fisch usw.;219085;248161;-29076
01.01.18;WA17;Zucker und Zuckerwaren;198600;126255;72345
01.01.18;WA18;Kakao und Zubereitungen aus Kakao;395709;333577;62132
01.01.18;WA19;Zubereitungen aus Getreide usw., Backwaren;509800;343139;166661
01.01.18;WA20;Zubereitungen von Gemüse, Früchten usw.;236634;421965;-185331
01.01.18;WA21;Verschiedene Lebensmittelzubereitungen;466889;260776;206113
01.01.18;WA22;Getränke, alkoholhaltige Flüssigkeiten, Essig;422742;529433;-106691
01.01.18;WA23;Rückstände der Lebensmittelindustrie, Futter;330874;324585;6289
01.01.18;WA24;Tabak;270636;179172;91464
01.01.18;WA25;Salz, Schwefel, Steine, Erden usw.;158261;139849;18412
01.01.18;WA26;Erze, Schlacken, Aschen;38524;487716;-449192
01.01.18;WA27;Mineralische Brennstoffe usw.;2532558;7968000;-5435442
01.01.18;WA28;Anorganische chemische Erzeugnisse;831206;540712;290494
01.01.18;WA29;Organische chemische Erzeugnisse;2433460;3371514;-938054
01.01.18;WA30;Pharmazeutische Erzeugnisse;6406906;3704187;2702719
01.01.18;WA31;Düngemittel;187771;90087;97684
01.01.18;WA32;Gerb- und Farbstoffe, Farben, Lacke usw.;1033006;510594;522412
01.01.18;WA33;Etherische Öle, Riech-, Schönheitsmittel;821368;599135;222233
01.01.18;WA34;Seifen, Waschmittel usw.;673593;330357;343236
01.01.18;WA35;Eiweissstoffe, Klebstoffe, Enzyme;298669;182342;116327
01.01.18;WA36;Sprengstoffe, pyrotechnische Artikel usw.;22411;11929;10482
01.01.18;WA37;Photochemische Erzeugnisse;103352;74671;28681
01.01.18;WA38;Verschiedene Erzeugnisse der Chemischen Industrie;2105017;1185983;919034
01.01.18;WA39;Kunststoffe und Waren daraus;5333148;3381704;1951444
01.01.18;WA40;Kautschuk und Waren daraus;1246276;1156234;90042
01.01.18;WA41;Häute, Felle, Leder;74943;59113;15830
01.01.18;WA42;Lederwaren, Sattlerwaren;198277;377200;-178923
01.01.18;WA43;Pelzfelle, künstliches Pelzwerk;8289;11208;-2919
01.01.18;WA44;Holz, Holzwaren, Holzkohle;671723;656555;15168
01.01.18;WA45;Kork, Korkwaren;2542;7624;-5082
01.01.18;WA46;Flechtwaren, Korbmacherwaren;3866;10672;-6806
01.01.18;WA47;Halbstoffe aus Holz usw., Papierabfall;102201;337126;-234925
01.01.18;WA48;Papier, Pappe und Waren daraus;1551111;1080237;470874
01.01.18;WA49;Bücher, Zeitungen, Bilddrucke usw.;343493;221679;121814
01.01.18;WA50;Seide;4536;4511;25
01.01.18;WA51;Wolle, feine und grobe Tierhaare;45704;59407;-13703
01.01.18;WA52;Baumwolle;70721;79051;-8330
01.01.18;WA53;Andere pflanzliche Spinnstoffe, Papiergarn;4116;6096;-1980
01.01.18;WA54;Synthetisches oder künstliches Filament;169063;146461;22602
01.01.18;WA55;Synthetische oder künstliche Spinnfaser;154815;123565;31250
01.01.18;WA56;Watte, Filz, Vliesstoff usw., Tauwerk;206143;130198;75945
01.01.18;WA57;Teppiche, Fussbodenbelag aus Spinnstoff;47541;109660;-62119
01.01.18;WA58;Spezialgewebe, Spitzen, Tapisserien;44137;23066;21071
01.01.18;WA59;Getränkte, bestrichene usw. Gewebe;222776;95193;127583
01.01.18;WA60;Gewirke und Gestricke;62776;36140;26636
01.01.18;WA61;Bekleidung usw. aus Gewirken, Gestricken;821057;1537306;-716249
01.01.18;WA62;Andere Bekleidung, Bekleidungszubehör;895722;1532570;-636848
01.01.18;WA63;Andere Konfektion, Spinnstoffwaren usw.;206212;347855;-141643
01.01.18;WA64;Schuhe, Gamaschen, ähnliche Waren;669191;1035671;-366480
01.01.18;WA65;Kopfbedeckungen und Teile davon;30774;53097;-22323
01.01.18;WA66;Schirme, Gehstöcke usw., Peitschen;6232;28080;-21848
01.01.18;WA67;Zugerichtete Federn, Daunen, künstliche Blumen;12999;19340;-6341
01.01.18;WA68;Waren aus Steinen, Gips, Zement usw.;395437;240398;155039
01.01.18;WA69;Keramische Waren;271610;241148;30462
01.01.18;WA70;Glas und Glaswaren;563565;445761;117804
01.01.18;WA71;Perlen, Edelsteine, Edelmetalle;1008863;1358284;-349421
01.01.18;WA72;Eisen und Stahl;2062665;2269642;-206977
01.01.18;WA73;Waren aus Eisen oder Stahl;2329919;1738941;590978
01.01.18;WA74;Kupfer und Waren daraus;1059143;963968;95175
01.01.18;WA75;Nickel und Waren daraus;107935;125204;-17269
01.01.18;WA76;Aluminium und Waren daraus;1188225;1361553;-173328
01.01.18;WA78;Blei und Waren daraus;36083;43672;-7589
01.01.18;WA79;Zink und Waren daraus;73651;129561;-55910
01.01.18;WA80;Zinn und Waren daraus;8888;30169;-21281
01.01.18;WA81;Andere unedle Metalle, Cermets usw.;130954;170315;-39361
01.01.18;WA82;Werkzeuge, Schneidwaren, Essbestecke;703947;446704;257243
01.01.18;WA83;Verschiedene Waren aus unedlen Metallen;660563;436010;224553
01.01.18;WA84;Maschinen, Apparate, mechanische Geräte;17822836;11768249;6054587
01.01.18;WA85;Elektrotechnische Erzeugnisse;11549618;11586778;-37160
01.01.18;WA86;Schienenfahrzeuge;354440;175983;178457
01.01.18;WA87;Kraftfahrzeuge, Landfahrzeuge;18508457;8588669;9919788
01.01.18;WA88;Luftfahrzeuge, Raumfahrzeuge;2267439;1050912;1216527
01.01.18;WA89;Wasserfahrzeuge;404358;115935;288423
01.01.18;WA90;Optische, photografische usw. Erzeugnisse;5291714;3059275;2232439
01.01.18;WA91;Uhrmacherwaren;118835;151052;-32217
01.01.18;WA92;Musikinstrumente;47796;53577;-5781
01.01.18;WA93;Waffen und Munition;24873;16909;7964
01.01.18;WA94;Möbel, Beleuchtungskörper usw.;1232728;1642258;-409530
01.01.18;WA95;Spielzeug, Spiele usw., Sportgeräte;357413;549293;-191880
01.01.18;WA96;Verschiedene Waren;328230;249266;78964
01.01.18;WA97;Kunstgegenstände, Sammlungsstücke;64447;57674;6773
01.01.18;WA98;Vollständige Fabrikationsanlagen;88954;3004;85950
01.01.18;WA99;Zusammenstellungen verschiedener Waren;1189419;992654;196765
01.01.19;WA01;Lebende Tiere;104420;128129;-23709
01.01.19;WA02;Fleisch;619854;535111;84743
01.01.19;WA03;Fische, Krebs- und Weichtiere;128377;370911;-242534
01.01.19;WA04;Milch, Milcherzeugnisse, Eier, Honig;794711;682078;112633
01.01.19;WA05;Andere Waren tierischen Ursprungs;83004;88537;-5533
01.01.19;WA06;Pflanzen, Waren des Blumenhandels;47766;204584;-156818
01.01.19;WA07;Gemüse, Pflanzen für Ernährung;92397;606977;-514580
01.01.19;WA08;Geniessbare Früchte und Nüsse;156896;773123;-616227
01.01.19;WA09;Kaffee, Tee, Mate, Gewürze;231992;352028;-120036
01.01.19;WA10;Getreide;155324;316220;-160896
01.01.19;WA11;Müllereierzeugnisse, Malz usw.;144471;55048;89423
01.01.19;WA12;Ölsamen usw., Heilpflanzen usw.;149905;449693;-299788
01.01.19;WA13;Schellack, Gummen, Harz, Pflanzensaft;65338;45912;19426
01.01.19;WA14;Flechtstoffe usw. pflanzlichen Ursprungs;637;3981;-3344
01.01.19;WA15;Tierische und pflanzliche Fette, Öle, Wachs;203294;284931;-81637
01.01.19;WA16;Zubereitungen von Fleisch, Fisch usw.;224583;266739;-42156
01.01.19;WA17;Zucker und Zuckerwaren;182366;133301;49065
01.01.19;WA18;Kakao und Zubereitungen aus Kakao;442370;363660;78710
01.01.19;WA19;Zubereitungen aus Getreide usw., Backwaren;524886;343113;181773
01.01.19;WA20;Zubereitungen von Gemüse, Früchten usw.;252379;427046;-174667
01.01.19;WA21;Verschiedene Lebensmittelzubereitungen;465617;268831;196786
01.01.19;WA22;Getränke, alkoholhaltige Flüssigkeiten, Essig;437568;543477;-105909
01.01.19;WA23;Rückstände der Lebensmittelindustrie, Futter;373458;342180;31278
01.01.19;WA24;Tabak;316055;184414;131641
01.01.19;WA25;Salz, Schwefel, Steine, Erden usw.;157400;164176;-6776
01.01.19;WA26;Erze, Schlacken, Aschen;47796;766771;-718975
01.01.19;WA27;Mineralische Brennstoffe usw.;2526864;8284955;-5758091
01.01.19;WA28;Anorganische chemische Erzeugnisse;832182;595774;236408
01.01.19;WA29;Organische chemische Erzeugnisse;2434695;3919243;-1484548
01.01.19;WA30;Pharmazeutische Erzeugnisse;6747062;3769886;2977176
01.01.19;WA31;Düngemittel;178182;106805;71377
01.01.19;WA32;Gerb- und Farbstoffe, Farben, Lacke usw.;1030323;537512;492811
01.01.19;WA33;Etherische Öle, Riech-, Schönheitsmittel;854095;575102;278993
01.01.19;WA34;Seifen, Waschmittel usw.;677807;342553;335254
01.01.19;WA35;Eiweissstoffe, Klebstoffe, Enzyme;306259;184132;122127
01.01.19;WA36;Sprengstoffe, pyrotechnische Artikel usw.;22239;13347;8892
01.01.19;WA37;Photochemische Erzeugnisse;108290;77704;30586
01.01.19;WA38;Verschiedene Erzeugnisse der Chemischen Industrie;2168148;1293462;874686
01.01.19;WA39;Kunststoffe und Waren daraus;5352666;3439132;1913534
01.01.19;WA40;Kautschuk und Waren daraus;1277838;1146756;131082
01.01.19;WA41;Häute, Felle, Leder;65654;48110;17544
01.01.19;WA42;Lederwaren, Sattlerwaren;208438;381111;-172673
01.01.19;WA43;Pelzfelle, künstliches Pelzwerk;6162;8993;-2831
01.01.19;WA44;Holz, Holzwaren, Holzkohle;668841;679110;-10269
01.01.19;WA45;Kork, Korkwaren;2639;9868;-7229
01.01.19;WA46;Flechtwaren, Korbmacherwaren;3604;12103;-8499
01.01.19;WA47;Halbstoffe aus Holz usw., Papierabfall;98760;412626;-313866
01.01.19;WA48;Papier, Pappe und Waren daraus;1627128;1092814;534314
01.01.19;WA49;Bücher, Zeitungen, Bilddrucke usw.;313709;217732;95977
01.01.19;WA50;Seide;2342;3201;-859
01.01.19;WA51;Wolle, feine und grobe Tierhaare;43113;57725;-14612
01.01.19;WA52;Baumwolle;63815;73811;-9996
01.01.19;WA53;Andere pflanzliche Spinnstoffe, Papiergarn;5000;7514;-2514
01.01.19;WA54;Synthetisches oder künstliches Filament;157076;134480;22596
01.01.19;WA55;Synthetische oder künstliche Spinnfaser;148896;128602;20294
01.01.19;WA56;Watte, Filz, Vliesstoff usw., Tauwerk;217090;129969;87121
01.01.19;WA57;Teppiche, Fussbodenbelag aus Spinnstoff;45001;96741;-51740
01.01.19;WA58;Spezialgewebe, Spitzen, Tapisserien;45800;22186;23614
01.01.19;WA59;Getränkte, bestrichene usw. Gewebe;222157;99429;122728
01.01.19;WA60;Gewirke und Gestricke;64120;35109;29011
01.01.19;WA61;Bekleidung usw. aus Gewirken, Gestricken;864904;1583014;-718110
01.01.19;WA62;Andere Bekleidung, Bekleidungszubehör;972662;1604540;-631878
01.01.19;WA63;Andere Konfektion, Spinnstoffwaren usw.;214830;367036;-152206
01.01.19;WA64;Schuhe, Gamaschen, ähnliche Waren;701162;1055066;-353904
01.01.19;WA65;Kopfbedeckungen und Teile davon;41195;66979;-25784
01.01.19;WA66;Schirme, Gehstöcke usw., Peitschen;7310;33089;-25779
01.01.19;WA67;Zugerichtete Federn, Daunen, künstliche Blumen;12692;23349;-10657
01.01.19;WA68;Waren aus Steinen, Gips, Zement usw.;398653;278101;120552
01.01.19;WA69;Keramische Waren;295854;243035;52819
01.01.19;WA70;Glas und Glaswaren;567463;424487;142976
01.01.19;WA71;Perlen, Edelsteine, Edelmetalle;1065186;1374646;-309460
01.01.19;WA72;Eisen und Stahl;2083873;2291897;-208024
01.01.19;WA73;Waren aus Eisen oder Stahl;2387563;1829317;558246
01.01.19;WA74;Kupfer und Waren daraus;874445;854998;19447
01.01.19;WA75;Nickel und Waren daraus;121677;127863;-6186
01.01.19;WA76;Aluminium und Waren daraus;1270153;1347432;-77279
01.01.19;WA78;Blei und Waren daraus;35037;30692;4345
01.01.19;WA79;Zink und Waren daraus;68092;112055;-43963
01.01.19;WA80;Zinn und Waren daraus;9263;32217;-22954
01.01.19;WA81;Andere unedle Metalle, Cermets usw.;150098;186831;-36733
01.01.19;WA82;Werkzeuge, Schneidwaren, Essbestecke;724867;487965;236902
01.01.19;WA83;Verschiedene Waren aus unedlen Metallen;663877;421748;242129
01.01.19;WA84;Maschinen, Apparate, mechanische Geräte;18718585;12532499;6186086
01.01.19;WA85;Elektrotechnische Erzeugnisse;11923845;11870760;53085
01.01.19;WA86;Schienenfahrzeuge;306756;241099;65657
01.01.19;WA87;Kraftfahrzeuge, Landfahrzeuge;17680221;9745062;7935159
01.01.19;WA88;Luftfahrzeuge, Raumfahrzeuge;2372534;1402397;970137
01.01.19;WA89;Wasserfahrzeuge;131972;61377;70595
01.01.19;WA90;Optische, photografische usw. Erzeugnisse;5641593;3220071;2421522
01.01.19;WA91;Uhrmacherwaren;131994;159245;-27251
01.01.19;WA92;Musikinstrumente;49791;54104;-4313
01.01.19;WA93;Waffen und Munition;33159;16541;16618
01.01.19;WA94;Möbel, Beleuchtungskörper usw.;1267268;1628996;-361728
01.01.19;WA95;Spielzeug, Spiele usw., Sportgeräte;316281;534309;-218028
01.01.19;WA96;Verschiedene Waren;332005;254214;77791
01.01.19;WA97;Kunstgegenstände, Sammlungsstücke;43544;38363;5181
01.01.19;WA98;Vollständige Fabrikationsanlagen;140170;213;139957
01.01.19;WA99;Zusammenstellungen verschiedener Waren;1350103;1031585;318518
01.01.20;WA01;Lebende Tiere;127841;169272;-41431
01.01.20;WA02;Fleisch;767976;584074;183902
01.01.20;WA03;Fische, Krebs- und Weichtiere;137793;400389;-262596
01.01.20;WA04;Milch, Milcherzeugnisse, Eier, Honig;858031;692148;165883
01.01.20;WA05;Andere Waren tierischen Ursprungs;76958;79959;-3001
01.01.20;WA06;Pflanzen, Waren des Blumenhandels;46471;206445;-159974
01.01.20;WA07;Gemüse, Pflanzen für Ernährung;96419;631657;-535238
01.01.20;WA08;Geniessbare Früchte und Nüsse;163608;895506;-731898
01.01.20;WA09;Kaffee, Tee, Mate, Gewürze;230394;315105;-84711
01.01.20;WA10;Getreide;217792;261105;-43313
01.01.20;WA11;Müllereierzeugnisse, Malz usw.;134943;59792;75151
01.01.20;WA12;Ölsamen usw., Heilpflanzen usw.;143576;484007;-340431
01.01.20;WA13;Schellack, Gummen, Harz, Pflanzensaft;64948;50548;14400
01.01.20;WA14;Flechtstoffe usw. pflanzlichen Ursprungs;656;4253;-3597
01.01.20;WA15;Tierische und pflanzliche Fette, Öle, Wachs;219205;284778;-65573
01.01.20;WA16;Zubereitungen von Fleisch, Fisch usw.;236608;257707;-21099
01.01.20;WA17;Zucker und Zuckerwaren;176910;138317;38593
01.01.20;WA18;Kakao und Zubereitungen aus Kakao;481502;388702;92800
01.01.20;WA19;Zubereitungen aus Getreide usw., Backwaren;562438;353274;209164
01.01.20;WA20;Zubereitungen von Gemüse, Früchten usw.;232546;408312;-175766
01.01.20;WA21;Verschiedene Lebensmittelzubereitungen;473983;291646;182337
01.01.20;WA22;Getränke, alkoholhaltige Flüssigkeiten, Essig;445295;549483;-104188
01.01.20;WA23;Rückstände der Lebensmittelindustrie, Futter;373371;347841;25530
01.01.20;WA24;Tabak;195687;189706;5981
01.01.20;WA25;Salz, Schwefel, Steine, Erden usw.;150716;143909;6807
01.01.20;WA26;Erze, Schlacken, Aschen;37915;776755;-738840
01.01.20;WA27;Mineralische Brennstoffe usw.;2470600;8114558;-5643958
01.01.20;WA28;Anorganische chemische Erzeugnisse;949482;498319;451163
01.01.20;WA29;Organische chemische Erzeugnisse;2306687;3285770;-979083
01.01.20;WA30;Pharmazeutische Erzeugnisse;6809370;4356454;2452916
01.01.20;WA31;Düngemittel;166044;87271;78773
01.01.20;WA32;Gerb- und Farbstoffe, Farben, Lacke usw.;977268;490800;486468
01.01.20;WA33;Etherische Öle, Riech-, Schönheitsmittel;852614;609470;243144
01.01.20;WA34;Seifen, Waschmittel usw.;677802;336577;341225
01.01.20;WA35;Eiweissstoffe, Klebstoffe, Enzyme;312136;182482;129654
01.01.20;WA36;Sprengstoffe, pyrotechnische Artikel usw.;27677;11457;16220
01.01.20;WA37;Photochemische Erzeugnisse;95415;74726;20689
01.01.20;WA38;Verschiedene Erzeugnisse der Chemischen Industrie;2135019;1270443;864576
01.01.20;WA39;Kunststoffe und Waren daraus;5215851;3227163;1988688
01.01.20;WA40;Kautschuk und Waren daraus;1182982;1087500;95482
01.01.20;WA41;Häute, Felle, Leder;56157;43467;12690
01.01.20;WA42;Lederwaren, Sattlerwaren;228516;399501;-170985
01.01.20;WA43;Pelzfelle, künstliches Pelzwerk;4093;6541;-2448
01.01.20;WA44;Holz, Holzwaren, Holzkohle;693019;603138;89881
01.01.20;WA45;Kork, Korkwaren;2546;8332;-5786
01.01.20;WA46;Flechtwaren, Korbmacherwaren;4631;13862;-9231
01.01.20;WA47;Halbstoffe aus Holz usw., Papierabfall;81805;235761;-153956
01.01.20;WA48;Papier, Pappe und Waren daraus;1521629;1009540;512089
01.01.20;WA49;Bücher, Zeitungen, Bilddrucke usw.;325797;213435;112362
01.01.20;WA50;Seide;2007;2717;-710
01.01.20;WA51;Wolle, feine und grobe Tierhaare;37521;44015;-6494
01.01.20;WA52;Baumwolle;60341;65497;-5156
01.01.20;WA53;Andere pflanzliche Spinnstoffe, Papiergarn;4975;7301;-2326
01.01.20;WA54;Synthetisches oder künstliches Filament;150229;125929;24300
01.01.20;WA55;Synthetische oder künstliche Spinnfaser;143205;114709;28496
01.01.20;WA56;Watte, Filz, Vliesstoff usw., Tauwerk;199052;127720;71332
01.01.20;WA57;Teppiche, Fussbodenbelag aus Spinnstoff;49393;96964;-47571
01.01.20;WA58;Spezialgewebe, Spitzen, Tapisserien;41918;20815;21103
01.01.20;WA59;Getränkte, bestrichene usw. Gewebe;203521;95630;107891
01.01.20;WA60;Gewirke und Gestricke;56390;37654;18736
01.01.20;WA61;Bekleidung usw. aus Gewirken, Gestricken;915474;1613483;-698009
01.01.20;WA62;Andere Bekleidung, Bekleidungszubehör;1021611;1625413;-603802
01.01.20;WA63;Andere Konfektion, Spinnstoffwaren usw.;237023;381042;-144019
01.01.20;WA64;Schuhe, Gamaschen, ähnliche Waren;740275;1141358;-401083
01.01.20;WA65;Kopfbedeckungen und Teile davon;42749;64735;-21986
01.01.20;WA66;Schirme, Gehstöcke usw., Peitschen;8179;32829;-24650
01.01.20;WA67;Zugerichtete Federn, Daunen, künstliche Blumen;19637;28511;-8874
01.01.20;WA68;Waren aus Steinen, Gips, Zement usw.;427862;275891;151971
01.01.20;WA69;Keramische Waren;294593;227951;66642
01.01.20;WA70;Glas und Glaswaren;539972;406771;133201
01.01.20;WA71;Perlen, Edelsteine, Edelmetalle;1604878;2192142;-587264
01.01.20;WA72;Eisen und Stahl;1824751;1812036;12715
01.01.20;WA73;Waren aus Eisen oder Stahl;2201729;1688277;513452
01.01.20;WA74;Kupfer und Waren daraus;988098;877264;110834
01.01.20;WA75;Nickel und Waren daraus;125059;123497;1562
01.01.20;WA76;Aluminium und Waren daraus;1179359;1224519;-45160
01.01.20;WA78;Blei und Waren daraus;32226;34214;-1988
01.01.20;WA79;Zink und Waren daraus;50553;85554;-35001
01.01.20;WA80;Zinn und Waren daraus;8610;30165;-21555
01.01.20;WA81;Andere unedle Metalle, Cermets usw.;127961;150912;-22951
01.01.20;WA82;Werkzeuge, Schneidwaren, Essbestecke;712164;443147;269017
01.01.20;WA83;Verschiedene Waren aus unedlen Metallen;639022;436117;202905
01.01.20;WA84;Maschinen, Apparate, mechanische Geräte;18033055;12286374;5746681
01.01.20;WA85;Elektrotechnische Erzeugnisse;11849055;11680512;168543
01.01.20;WA86;Schienenfahrzeuge;289848;276325;13523
01.01.20;WA87;Kraftfahrzeuge, Landfahrzeuge;16900185;9676523;7223662
01.01.20;WA88;Luftfahrzeuge, Raumfahrzeuge;1707057;1072349;634708
01.01.20;WA89;Wasserfahrzeuge;175368;60184;115184
01.01.20;WA90;Optische, photografische usw. Erzeugnisse;5641611;3369525;2272086
01.01.20;WA91;Uhrmacherwaren;148268;190247;-41979
01.01.20;WA92;Musikinstrumente;48852;60797;-11945
01.01.20;WA93;Waffen und Munition;36041;19714;16327
01.01.20;WA94;Möbel, Beleuchtungskörper usw.;1232041;1665866;-433825
01.01.20;WA95;Spielzeug, Spiele usw., Sportgeräte;308888;521281;-212393
01.01.20;WA96;Verschiedene Waren;316646;251643;65003
01.01.20;WA97;Kunstgegenstände, Sammlungsstücke;49255;36381;12874
01.01.20;WA98;Vollständige Fabrikationsanlagen;111445;32;111413
01.01.20;WA99;Zusammenstellungen verschiedener Waren;1322664;1066116;256548
01.01.21;WA01;Lebende Tiere;84013;93579;-9566
01.01.21;WA02;Fleisch;477044;410049;66995
01.01.21;WA03;Fische, Krebs- und Weichtiere;92441;275322;-182881
01.01.21;WA04;Milch, Milcherzeugnisse, Eier, Honig;728367;642571;85796
01.01.21;WA05;Andere Waren tierischen Ursprungs;67588;68725;-1137
01.01.21;WA06;Pflanzen, Waren des Blumenhandels;36716;181230;-144514
01.01.21;WA07;Gemüse, Pflanzen für Ernährung;74766;636986;-562220
01.01.21;WA08;Geniessbare Früchte und Nüsse;151013;831957;-680944
01.01.21;WA09;Kaffee, Tee, Mate, Gewürze;228221;351247;-123026
01.01.21;WA10;Getreide;221169;237998;-16829
01.01.21;WA11;Müllereierzeugnisse, Malz usw.;135851;53647;82204
01.01.21;WA12;Ölsamen usw., Heilpflanzen usw.;132685;488048;-355363
01.01.21;WA13;Schellack, Gummen, Harz, Pflanzensaft;49568;44733;4835
01.01.21;WA14;Flechtstoffe usw. pflanzlichen Ursprungs;778;2399;-1621
01.01.21;WA15;Tierische und pflanzliche Fette, Öle, Wachs;309275;294878;14397
01.01.21;WA16;Zubereitungen von Fleisch, Fisch usw.;220210;229700;-9490
01.01.21;WA17;Zucker und Zuckerwaren;184961;114111;70850
01.01.21;WA18;Kakao und Zubereitungen aus Kakao;436158;368363;67795
01.01.21;WA19;Zubereitungen aus Getreide usw., Backwaren;481745;336311;145434
01.01.21;WA20;Zubereitungen von Gemüse, Früchten usw.;199822;398123;-198301
01.01.21;WA21;Verschiedene Lebensmittelzubereitungen;476975;309937;167038
01.01.21;WA22;Getränke, alkoholhaltige Flüssigkeiten, Essig;361242;481526;-120284
01.01.21;WA23;Rückstände der Lebensmittelindustrie, Futter;511233;377350;133883
01.01.21;WA24;Tabak;192829;234125;-41296
01.01.21;WA25;Salz, Schwefel, Steine, Erden usw.;162071;117147;44924
01.01.21;WA26;Erze, Schlacken, Aschen;49564;995308;-945744
01.01.21;WA27;Mineralische Brennstoffe usw.;1664965;5511872;-3846907
01.01.21;WA28;Anorganische chemische Erzeugnisse;1021775;454858;566917
01.01.21;WA29;Organische chemische Erzeugnisse;2237032;2150253;86779
01.01.21;WA30;Pharmazeutische Erzeugnisse;7312051;4071332;3240719
01.01.21;WA31;Düngemittel;180249;80779;99470
01.01.21;WA32;Gerb- und Farbstoffe, Farben, Lacke usw.;884944;452727;432217
01.01.21;WA33;Etherische Öle, Riech-, Schönheitsmittel;721528;466397;255131
01.01.21;WA34;Seifen, Waschmittel usw.;639719;333251;306468
01.01.21;WA35;Eiweissstoffe, Klebstoffe, Enzyme;313565;166952;146613
01.01.21;WA36;Sprengstoffe, pyrotechnische Artikel usw.;23641;11959;11682
01.01.21;WA37;Photochemische Erzeugnisse;87366;50702;36664
01.01.21;WA38;Verschiedene Erzeugnisse der Chemischen Industrie;2333126;1452299;880827
01.01.21;WA39;Kunststoffe und Waren daraus;5137626;3085081;2052545
01.01.21;WA40;Kautschuk und Waren daraus;1149405;1098076;51329
01.01.21;WA41;Häute, Felle, Leder;43504;34779;8725
01.01.21;WA42;Lederwaren, Sattlerwaren;180170;289798;-109628
01.01.21;WA43;Pelzfelle, künstliches Pelzwerk;4159;5763;-1604
01.01.21;WA44;Holz, Holzwaren, Holzkohle;706069;659830;46239
01.01.21;WA45;Kork, Korkwaren;2047;8959;-6912
01.01.21;WA46;Flechtwaren, Korbmacherwaren;4574;11781;-7207
01.01.21;WA47;Halbstoffe aus Holz usw., Papierabfall;76119;247799;-171680
01.01.21;WA48;Papier, Pappe und Waren daraus;1389352;888691;500661
01.01.21;WA49;Bücher, Zeitungen, Bilddrucke usw.;289682;221302;68380
01.01.21;WA50;Seide;2608;1591;1017
01.01.21;WA51;Wolle, feine und grobe Tierhaare;32031;34488;-2457
01.01.21;WA52;Baumwolle;49456;49520;-64
01.01.21;WA53;Andere pflanzliche Spinnstoffe, Papiergarn;3989;5423;-1434
01.01.21;WA54;Synthetisches oder künstliches Filament;118356;99736;18620
01.01.21;WA55;Synthetische oder künstliche Spinnfaser;123622;100263;23359
01.01.21;WA56;Watte, Filz, Vliesstoff usw., Tauwerk;194236;129725;64511
01.01.21;WA57;Teppiche, Fussbodenbelag aus Spinnstoff;41580;92844;-51264
01.01.21;WA58;Spezialgewebe, Spitzen, Tapisserien;37280;17686;19594
01.01.21;WA59;Getränkte, bestrichene usw. Gewebe;184829;86188;98641
01.01.21;WA60;Gewirke und Gestricke;47591;33361;14230
01.01.21;WA61;Bekleidung usw. aus Gewirken, Gestricken;789063;1394757;-605694
01.01.21;WA62;Andere Bekleidung, Bekleidungszubehör;763048;1194779;-431731
01.01.21;WA63;Andere Konfektion, Spinnstoffwaren usw.;280461;625374;-344913
01.01.21;WA64;Schuhe, Gamaschen, ähnliche Waren;627808;869899;-242091
01.01.21;WA65;Kopfbedeckungen und Teile davon;37385;58986;-21601
01.01.21;WA66;Schirme, Gehstöcke usw., Peitschen;5497;24247;-18750
01.01.21;WA67;Zugerichtete Federn, Daunen, künstliche Blumen;10480;18613;-8133
01.01.21;WA68;Waren aus Steinen, Gips, Zement usw.;347385;254280;93105
01.01.21;WA69;Keramische Waren;268267;241090;27177
01.01.21;WA70;Glas und Glaswaren;526832;372812;154020
01.01.21;WA71;Perlen, Edelsteine, Edelmetalle;1755508;2485091;-729583
01.01.21;WA72;Eisen und Stahl;1925267;1718220;207047
01.01.21;WA73;Waren aus Eisen oder Stahl;2004914;1631214;373700
01.01.21;WA74;Kupfer und Waren daraus;984735;816674;168061
01.01.21;WA75;Nickel und Waren daraus;96375;109558;-13183
01.01.21;WA76;Aluminium und Waren daraus;1075972;1134473;-58501
01.01.21;WA78;Blei und Waren daraus;50530;28808;21722
01.01.21;WA79;Zink und Waren daraus;55206;104890;-49684
01.01.21;WA80;Zinn und Waren daraus;7797;26446;-18649
01.01.21;WA81;Andere unedle Metalle, Cermets usw.;84776;86978;-2202
01.01.21;WA82;Werkzeuge, Schneidwaren, Essbestecke;633193;454241;178952
01.01.21;WA83;Verschiedene Waren aus unedlen Metallen;609145;402441;206704
01.01.21;WA84;Maschinen, Apparate, mechanische Geräte;16243344;11267462;4975882
01.01.21;WA85;Elektrotechnische Erzeugnisse;11193245;11759275;-566030
01.01.21;WA86;Schienenfahrzeuge;264338;185354;78984
01.01.21;WA87;Kraftfahrzeuge, Landfahrzeuge;15000440;8178196;6822244
01.01.21;WA88;Luftfahrzeuge, Raumfahrzeuge;995258;561692;433566
01.01.21;WA89;Wasserfahrzeuge;113515;70226;43289
01.01.21;WA90;Optische, photografische usw. Erzeugnisse;4935628;2907209;2028419
01.01.21;WA91;Uhrmacherwaren;102273;159713;-57440
01.01.21;WA92;Musikinstrumente;46527;61596;-15069
01.01.21;WA93;Waffen und Munition;28873;14597;14276
01.01.21;WA94;Möbel, Beleuchtungskörper usw.;1164054;1629727;-465673
01.01.21;WA95;Spielzeug, Spiele usw., Sportgeräte;409553;630015;-220462
01.01.21;WA96;Verschiedene Waren;288138;240189;47949
01.01.21;WA97;Kunstgegenstände, Sammlungsstücke;50835;33368;17467
01.01.21;WA98;Vollständige Fabrikationsanlagen;60726;NULL;#WERT!
01.01.21;WA99;Zusammenstellungen verschiedener Waren;1033561;870285;163276
01.01.22;WA01;Lebende Tiere;98487;90404;8083
01.01.22;WA02;Fleisch;492557;488082;4475
01.01.22;WA03;Fische, Krebs- und Weichtiere;103874;337909;-234035
01.01.22;WA04;Milch, Milcherzeugnisse, Eier, Honig;911029;709205;201824
01.01.22;WA05;Andere Waren tierischen Ursprungs;77240;88428;-11188
01.01.22;WA06;Pflanzen, Waren des Blumenhandels;58934;252534;-193600
01.01.22;WA07;Gemüse, Pflanzen für Ernährung;96930;671385;-574455
01.01.22;WA08;Geniessbare Früchte und Nüsse;159405;879081;-719676
01.01.22;WA09;Kaffee, Tee, Mate, Gewürze;306000;490608;-184608
01.01.22;WA10;Getreide;243170;256506;-13336
01.01.22;WA11;Müllereierzeugnisse, Malz usw.;165128;66641;98487
01.01.22;WA12;Ölsamen usw., Heilpflanzen usw.;165554;682818;-517264
01.01.22;WA13;Schellack, Gummen, Harz, Pflanzensaft;62465;64952;-2487
01.01.22;WA14;Flechtstoffe usw. pflanzlichen Ursprungs;1053;4419;-3366
01.01.22;WA15;Tierische und pflanzliche Fette, Öle, Wachs;344199;470323;-126124
01.01.22;WA16;Zubereitungen von Fleisch, Fisch usw.;250235;249570;665
01.01.22;WA17;Zucker und Zuckerwaren;240224;137188;103036
01.01.22;WA18;Kakao und Zubereitungen aus Kakao;473968;377604;96364
01.01.22;WA19;Zubereitungen aus Getreide usw., Backwaren;559618;382178;177440
01.01.22;WA20;Zubereitungen von Gemüse, Früchten usw.;232702;410272;-177570
01.01.22;WA21;Verschiedene Lebensmittelzubereitungen;554404;334425;219979
01.01.22;WA22;Getränke, alkoholhaltige Flüssigkeiten, Essig;488714;616430;-127716
01.01.22;WA23;Rückstände der Lebensmittelindustrie, Futter;512695;410159;102536
01.01.22;WA24;Tabak;227954;194426;33528
01.01.22;WA25;Salz, Schwefel, Steine, Erden usw.;173507;144422;29085
01.01.22;WA26;Erze, Schlacken, Aschen;78848;1176327;-1097479
01.01.22;WA27;Mineralische Brennstoffe usw.;3923727;13954979;-10031252
01.01.22;WA28;Anorganische chemische Erzeugnisse;1363460;632912;730548
01.01.22;WA29;Organische chemische Erzeugnisse;2885012;2955720;-70708
01.01.22;WA30;Pharmazeutische Erzeugnisse;8024968;5940713;2084255
01.01.22;WA31;Düngemittel;373850;176716;197134
01.01.22;WA32;Gerb- und Farbstoffe, Farben, Lacke usw.;1060758;528944;531814
01.01.22;WA33;Etherische Öle, Riech-, Schönheitsmittel;870883;576760;294123
01.01.22;WA34;Seifen, Waschmittel usw.;741254;397744;343510
01.01.22;WA35;Eiweissstoffe, Klebstoffe, Enzyme;392926;246308;146618
01.01.22;WA36;Sprengstoffe, pyrotechnische Artikel usw.;22533;15219;7314
01.01.22;WA37;Photochemische Erzeugnisse;95113;50575;44538
01.01.22;WA38;Verschiedene Erzeugnisse der Chemischen Industrie;3133468;2223360;910108
01.01.22;WA39;Kunststoffe und Waren daraus;6529841;4195841;2334000
01.01.22;WA40;Kautschuk und Waren daraus;1255728;1187140;68588
01.01.22;WA41;Häute, Felle, Leder;56466;42095;14371
01.01.22;WA42;Lederwaren, Sattlerwaren;210277;382732;-172455
01.01.22;WA43;Pelzfelle, künstliches Pelzwerk;6492;7500;-1008
01.01.22;WA44;Holz, Holzwaren, Holzkohle;960259;897844;62415
01.01.22;WA45;Kork, Korkwaren;2470;9411;-6941
01.01.22;WA46;Flechtwaren, Korbmacherwaren;5905;24009;-18104
01.01.22;WA47;Halbstoffe aus Holz usw., Papierabfall;134489;370878;-236389
01.01.22;WA48;Papier, Pappe und Waren daraus;1899543;1112738;786805
01.01.22;WA49;Bücher, Zeitungen, Bilddrucke usw.;291447;235331;56116
01.01.22;WA50;Seide;2053;3407;-1354
01.01.22;WA51;Wolle, feine und grobe Tierhaare;44018;48265;-4247
01.01.22;WA52;Baumwolle;61818;70074;-8256
01.01.22;WA53;Andere pflanzliche Spinnstoffe, Papiergarn;4695;7672;-2977
01.01.22;WA54;Synthetisches oder künstliches Filament;141891;126617;15274
01.01.22;WA55;Synthetische oder künstliche Spinnfaser;132512;123842;8670
01.01.22;WA56;Watte, Filz, Vliesstoff usw., Tauwerk;219355;141084;78271
01.01.22;WA57;Teppiche, Fussbodenbelag aus Spinnstoff;48930;100566;-51636
01.01.22;WA58;Spezialgewebe, Spitzen, Tapisserien;45642;23954;21688
01.01.22;WA59;Getränkte, bestrichene usw. Gewebe;203158;97772;105386
01.01.22;WA60;Gewirke und Gestricke;58951;39606;19345
01.01.22;WA61;Bekleidung usw. aus Gewirken, Gestricken;1009039;1886234;-877195
01.01.22;WA62;Andere Bekleidung, Bekleidungszubehör;866207;1449728;-583521
01.01.22;WA63;Andere Konfektion, Spinnstoffwaren usw.;283740;494542;-210802
01.01.22;WA64;Schuhe, Gamaschen, ähnliche Waren;663296;978405;-315109
01.01.22;WA65;Kopfbedeckungen und Teile davon;50772;73944;-23172
01.01.22;WA66;Schirme, Gehstöcke usw., Peitschen;5929;39844;-33915
01.01.22;WA67;Zugerichtete Federn, Daunen, künstliche Blumen;14755;31263;-16508
01.01.22;WA68;Waren aus Steinen, Gips, Zement usw.;416519;297319;119200
01.01.22;WA69;Keramische Waren;307687;276256;31431
01.01.22;WA70;Glas und Glaswaren;602783;433421;169362
01.01.22;WA71;Perlen, Edelsteine, Edelmetalle;1839755;2806567;-966812
01.01.22;WA72;Eisen und Stahl;2965158;3083228;-118070
01.01.22;WA73;Waren aus Eisen oder Stahl;2578838;2273484;305354
01.01.22;WA74;Kupfer und Waren daraus;1224439;1135345;89094
01.01.22;WA75;Nickel und Waren daraus;147397;191763;-44366
01.01.22;WA76;Aluminium und Waren daraus;1503011;1856848;-353837
01.01.22;WA78;Blei und Waren daraus;35222;50993;-15771
01.01.22;WA79;Zink und Waren daraus;74477;128381;-53904
01.01.22;WA80;Zinn und Waren daraus;15658;66291;-50633
01.01.22;WA81;Andere unedle Metalle, Cermets usw.;126669;185754;-59085
01.01.22;WA82;Werkzeuge, Schneidwaren, Essbestecke;738473;515290;223183
01.01.22;WA83;Verschiedene Waren aus unedlen Metallen;694132;489972;204160
01.01.22;WA84;Maschinen, Apparate, mechanische Geräte;17647239;13285394;4361845
01.01.22;WA85;Elektrotechnische Erzeugnisse;12628395;13879050;-1250655
01.01.22;WA86;Schienenfahrzeuge;294353;218385;75968
01.01.22;WA87;Kraftfahrzeuge, Landfahrzeuge;17305308;9157856;8147452
01.01.22;WA88;Luftfahrzeuge, Raumfahrzeuge;1118726;738211;380515
01.01.22;WA89;Wasserfahrzeuge;229699;172550;57149
01.01.22;WA90;Optische, photografische usw. Erzeugnisse;5352599;3403248;1949351
01.01.22;WA91;Uhrmacherwaren;129378;193389;-64011
01.01.22;WA92;Musikinstrumente;75488;74193;1295
01.01.22;WA93;Waffen und Munition;42481;19674;22807
01.01.22;WA94;Möbel, Beleuchtungskörper usw.;1369503;1971951;-602448
01.01.22;WA95;Spielzeug, Spiele usw., Sportgeräte;410238;701203;-290965
01.01.22;WA96;Verschiedene Waren;326548;313344;13204
01.01.22;WA97;Kunstgegenstände, Sammlungsstücke;130284;36231;94053
01.01.22;WA98;Vollständige Fabrikationsanlagen;58761;NULL;#WERT!
01.01.22;WA99;Zusammenstellungen verschiedener Waren;972683;869519;103164
01.01.23;WA01;Lebende Tiere;130300;131948;-1648
01.01.23;WA02;Fleisch;604204;577404;26800
01.01.23;WA03;Fische, Krebs- und Weichtiere;125473;370513;-245040
01.01.23;WA04;Milch, Milcherzeugnisse, Eier, Honig;1100615;945082;155533
01.01.23;WA05;Andere Waren tierischen Ursprungs;83607;107256;-23649
01.01.23;WA06;Pflanzen, Waren des Blumenhandels;51829;235117;-183288
01.01.23;WA07;Gemüse, Pflanzen für Ernährung;107485;702166;-594681
01.01.23;WA08;Geniessbare Früchte und Nüsse;168427;891542;-723115
01.01.23;WA09;Kaffee, Tee, Mate, Gewürze;315530;466720;-151190
01.01.23;WA10;Getreide;256733;386204;-129471
01.01.23;WA11;Müllereierzeugnisse, Malz usw.;218010;89965;128045
01.01.23;WA12;Ölsamen usw., Heilpflanzen usw.;192444;679951;-487507
01.01.23;WA13;Schellack, Gummen, Harz, Pflanzensaft;60438;55728;4710
01.01.23;WA14;Flechtstoffe usw. pflanzlichen Ursprungs;1586;3809;-2223
01.01.23;WA15;Tierische und pflanzliche Fette, Öle, Wachs;397273;445280;-48007
01.01.23;WA16;Zubereitungen von Fleisch, Fisch usw.;302588;288867;13721
01.01.23;WA17;Zucker und Zuckerwaren;306103;204168;101935
01.01.23;WA18;Kakao und Zubereitungen aus Kakao;583880;428259;155621
01.01.23;WA19;Zubereitungen aus Getreide usw., Backwaren;732879;506584;226295
01.01.23;WA20;Zubereitungen von Gemüse, Früchten usw.;268508;512237;-243729
01.01.23;WA21;Verschiedene Lebensmittelzubereitungen;677901;414997;262904
01.01.23;WA22;Getränke, alkoholhaltige Flüssigkeiten, Essig;538568;659428;-120860
01.01.23;WA23;Rückstände der Lebensmittelindustrie, Futter;644635;505344;139291
01.01.23;WA24;Tabak;260719;379986;-119267
01.01.23;WA25;Salz, Schwefel, Steine, Erden usw.;190455;180346;10109
01.01.23;WA26;Erze, Schlacken, Aschen;84968;938320;-853352
01.01.23;WA27;Mineralische Brennstoffe usw.;3614858;13490573;-9875715
01.01.23;WA28;Anorganische chemische Erzeugnisse;1321686;748444;573242
01.01.23;WA29;Organische chemische Erzeugnisse;2516412;4489567;-1973155
01.01.23;WA30;Pharmazeutische Erzeugnisse;10091380;5414656;4676724
01.01.23;WA31;Düngemittel;381438;191984;189454
01.01.23;WA32;Gerb- und Farbstoffe, Farben, Lacke usw.;998026;517361;480665
01.01.23;WA33;Etherische Öle, Riech-, Schönheitsmittel;998331;712175;286156
01.01.23;WA34;Seifen, Waschmittel usw.;773623;445758;327865
01.01.23;WA35;Eiweissstoffe, Klebstoffe, Enzyme;400294;251256;149038
01.01.23;WA36;Sprengstoffe, pyrotechnische Artikel usw.;27979;15317;12662
01.01.23;WA37;Photochemische Erzeugnisse;87344;49507;37837
01.01.23;WA38;Verschiedene Erzeugnisse der Chemischen Industrie;3147751;1793933;1353818
01.01.23;WA39;Kunststoffe und Waren daraus;6109041;3989470;2119571
01.01.23;WA40;Kautschuk und Waren daraus;1395800;1250561;145239
01.01.23;WA41;Häute, Felle, Leder;49550;38087;11463
01.01.23;WA42;Lederwaren, Sattlerwaren;242372;406279;-163907
01.01.23;WA43;Pelzfelle, künstliches Pelzwerk;4883;5875;-992
01.01.23;WA44;Holz, Holzwaren, Holzkohle;907871;742491;165380
01.01.23;WA45;Kork, Korkwaren;1921;5218;-3297
01.01.23;WA46;Flechtwaren, Korbmacherwaren;6543;13567;-7024
01.01.23;WA47;Halbstoffe aus Holz usw., Papierabfall;120536;322599;-202063
01.01.23;WA48;Papier, Pappe und Waren daraus;1867607;1220867;646740
01.01.23;WA49;Bücher, Zeitungen, Bilddrucke usw.;281478;238358;43120
01.01.23;WA50;Seide;2204;2338;-134
01.01.23;WA51;Wolle, feine und grobe Tierhaare;49034;52104;-3070
01.01.23;WA52;Baumwolle;65622;64308;1314
01.01.23;WA53;Andere pflanzliche Spinnstoffe, Papiergarn;6758;7681;-923
01.01.23;WA54;Synthetisches oder künstliches Filament;144368;124155;20213
01.01.23;WA55;Synthetische oder künstliche Spinnfaser;141201;126388;14813
01.01.23;WA56;Watte, Filz, Vliesstoff usw., Tauwerk;228859;154310;74549
01.01.23;WA57;Teppiche, Fussbodenbelag aus Spinnstoff;50952;101278;-50326
01.01.23;WA58;Spezialgewebe, Spitzen, Tapisserien;46790;22866;23924
01.01.23;WA59;Getränkte, bestrichene usw. Gewebe;227530;117635;109895
01.01.23;WA60;Gewirke und Gestricke;60826;39273;21553
01.01.23;WA61;Bekleidung usw. aus Gewirken, Gestricken;1157602;1934635;-777033
01.01.23;WA62;Andere Bekleidung, Bekleidungszubehör;1106607;1761332;-654725
01.01.23;WA63;Andere Konfektion, Spinnstoffwaren usw.;262667;414960;-152293
01.01.23;WA64;Schuhe, Gamaschen, ähnliche Waren;928524;1271130;-342606
01.01.23;WA65;Kopfbedeckungen und Teile davon;62886;83982;-21096
01.01.23;WA66;Schirme, Gehstöcke usw., Peitschen;7066;26584;-19518
01.01.23;WA67;Zugerichtete Federn, Daunen, künstliche Blumen;15791;23639;-7848
01.01.23;WA68;Waren aus Steinen, Gips, Zement usw.;446249;300199;146050
01.01.23;WA69;Keramische Waren;333081;259236;73845
01.01.23;WA70;Glas und Glaswaren;699214;486695;212519
01.01.23;WA71;Perlen, Edelsteine, Edelmetalle;1733610;2197412;-463802
01.01.23;WA72;Eisen und Stahl;2797150;2703909;93241
01.01.23;WA73;Waren aus Eisen oder Stahl;2836466;2342884;493582
01.01.23;WA74;Kupfer und Waren daraus;1215943;969874;246069
01.01.23;WA75;Nickel und Waren daraus;136184;233122;-96938
01.01.23;WA76;Aluminium und Waren daraus;1574756;1774398;-199642
01.01.23;WA78;Blei und Waren daraus;27576;51382;-23806
01.01.23;WA79;Zink und Waren daraus;69031;147636;-78605
01.01.23;WA80;Zinn und Waren daraus;18607;35178;-16571
01.01.23;WA81;Andere unedle Metalle, Cermets usw.;155921;186160;-30239
01.01.23;WA82;Werkzeuge, Schneidwaren, Essbestecke;796947;506284;290663
01.01.23;WA83;Verschiedene Waren aus unedlen Metallen;742752;469752;273000
01.01.23;WA84;Maschinen, Apparate, mechanische Geräte;20035380;13649381;6385999
01.01.23;WA85;Elektrotechnische Erzeugnisse;14996085;17310183;-2314098
01.01.23;WA86;Schienenfahrzeuge;232297;275719;-43422
01.01.23;WA87;Kraftfahrzeuge, Landfahrzeuge;20443007;10982088;9460919
01.01.23;WA88;Luftfahrzeuge, Raumfahrzeuge;1523996;1430571;93425
01.01.23;WA89;Wasserfahrzeuge;240301;290439;-50138
01.01.23;WA90;Optische, photografische usw. Erzeugnisse;5831270;3723885;2107385
01.01.23;WA91;Uhrmacherwaren;142435;195250;-52815
01.01.23;WA92;Musikinstrumente;80339;61978;18361
01.01.23;WA93;Waffen und Munition;50251;27712;22539
01.01.23;WA94;Möbel, Beleuchtungskörper usw.;1417869;1837082;-419213
01.01.23;WA95;Spielzeug, Spiele usw., Sportgeräte;358469;615641;-257172
01.01.23;WA96;Verschiedene Waren;354364;292039;62325
01.01.23;WA97;Kunstgegenstände, Sammlungsstücke;74607;62770;11837
01.01.23;WA98;Vollständige Fabrikationsanlagen;72268;NULL;#WERT!
01.01.23;WA99;Zusammenstellungen verschiedener Waren;1193618;1035551;158067
01.01.24;WA01;Lebende Tiere;130724;144180;-13456
01.01.24;WA02;Fleisch;638540;614233;24307
01.01.24;WA03;Fische, Krebs- und Weichtiere;105771;316090;-210319
01.01.24;WA04;Milch, Milcherzeugnisse, Eier, Honig;1057193;890429;166764
01.01.24;WA05;Andere Waren tierischen Ursprungs;69496;78548;-9052
01.01.24;WA06;Pflanzen, Waren des Blumenhandels;50699;217781;-167082
01.01.24;WA07;Gemüse, Pflanzen für Ernährung;118391;785132;-666741
01.01.24;WA08;Geniessbare Früchte und Nüsse;186041;978084;-792043
01.01.24;WA09;Kaffee, Tee, Mate, Gewürze;325143;441371;-116228
01.01.24;WA10;Getreide;225515;386867;-161352
01.01.24;WA11;Müllereierzeugnisse, Malz usw.;216168;77213;138955
01.01.24;WA12;Ölsamen usw., Heilpflanzen usw.;222004;613602;-391598
01.01.24;WA13;Schellack, Gummen, Harz, Pflanzensaft;64348;47452;16896
01.01.24;WA14;Flechtstoffe usw. pflanzlichen Ursprungs;1129;2984;-1855
01.01.24;WA15;Tierische und pflanzliche Fette, Öle, Wachs;313501;418382;-104881
01.01.24;WA16;Zubereitungen von Fleisch, Fisch usw.;312747;316155;-3408
01.01.24;WA17;Zucker und Zuckerwaren;325347;199624;125723
01.01.24;WA18;Kakao und Zubereitungen aus Kakao;689234;560696;128538
01.01.24;WA19;Zubereitungen aus Getreide usw., Backwaren;767931;547114;220817
01.01.24;WA20;Zubereitungen von Gemüse, Früchten usw.;293331;559830;-266499
01.01.24;WA21;Verschiedene Lebensmittelzubereitungen;739671;441162;298509
01.01.24;WA22;Getränke, alkoholhaltige Flüssigkeiten, Essig;554709;602580;-47871
01.01.24;WA23;Rückstände der Lebensmittelindustrie, Futter;624975;493319;131656
01.01.24;WA24;Tabak;226453;439958;-213505
01.01.24;WA25;Salz, Schwefel, Steine, Erden usw.;187382;149898;37484
01.01.24;WA26;Erze, Schlacken, Aschen;69449;683038;-613589
01.01.24;WA27;Mineralische Brennstoffe usw.;2883517;8854853;-5971336
01.01.24;WA28;Anorganische chemische Erzeugnisse;1050689;675831;374858
01.01.24;WA29;Organische chemische Erzeugnisse;2432273;3280290;-848017
01.01.24;WA30;Pharmazeutische Erzeugnisse;9686262;6286677;3399585
01.01.24;WA31;Düngemittel;231247;108649;122598
01.01.24;WA32;Gerb- und Farbstoffe, Farben, Lacke usw.;1024813;445879;578934
01.01.24;WA33;Etherische Öle, Riech-, Schönheitsmittel;1057415;743149;314266
01.01.24;WA34;Seifen, Waschmittel usw.;802264;424914;377350
01.01.24;WA35;Eiweissstoffe, Klebstoffe, Enzyme;410942;232039;178903
01.01.24;WA36;Sprengstoffe, pyrotechnische Artikel usw.;35430;18664;16766
01.01.24;WA37;Photochemische Erzeugnisse;87603;49902;37701
01.01.24;WA38;Verschiedene Erzeugnisse der Chemischen Industrie;3009823;1640867;1368956
01.01.24;WA39;Kunststoffe und Waren daraus;5981414;3557712;2423702
01.01.24;WA40;Kautschuk und Waren daraus;1385760;1195089;190671
01.01.24;WA41;Häute, Felle, Leder;46119;26251;19868
01.01.24;WA42;Lederwaren, Sattlerwaren;260421;344331;-83910
01.01.24;WA43;Pelzfelle, künstliches Pelzwerk;4583;3695;888
01.01.24;WA44;Holz, Holzwaren, Holzkohle;764059;614944;149115
01.01.24;WA45;Kork, Korkwaren;1910;7260;-5350
01.01.24;WA46;Flechtwaren, Korbmacherwaren;5622;11265;-5643
01.01.24;WA47;Halbstoffe aus Holz usw., Papierabfall;114130;290297;-176167
01.01.24;WA48;Papier, Pappe und Waren daraus;1717020;1098043;618977
01.01.24;WA49;Bücher, Zeitungen, Bilddrucke usw.;276103;224494;51609
01.01.24;WA50;Seide;2283;3066;-783
01.01.24;WA51;Wolle, feine und grobe Tierhaare;37251;39540;-2289
01.01.24;WA52;Baumwolle;52628;50469;2159
01.01.24;WA53;Andere pflanzliche Spinnstoffe, Papiergarn;4640;5175;-535
01.01.24;WA54;Synthetisches oder künstliches Filament;139136;106949;32187
01.01.24;WA55;Synthetische oder künstliche Spinnfaser;126651;106153;20498
01.01.24;WA56;Watte, Filz, Vliesstoff usw., Tauwerk;221445;132897;88548
01.01.24;WA57;Teppiche, Fussbodenbelag aus Spinnstoff;53420;88597;-35177
01.01.24;WA58;Spezialgewebe, Spitzen, Tapisserien;48046;21452;26594
01.01.24;WA59;Getränkte, bestrichene usw. Gewebe;238641;104242;134399
01.01.24;WA60;Gewirke und Gestricke;50290;29443;20847
01.01.24;WA61;Bekleidung usw. aus Gewirken, Gestricken;1135062;1598084;-463022
01.01.24;WA62;Andere Bekleidung, Bekleidungszubehör;1172961;1487679;-314718
01.01.24;WA63;Andere Konfektion, Spinnstoffwaren usw.;258506;311465;-52959
01.01.24;WA64;Schuhe, Gamaschen, ähnliche Waren;967634;1032670;-65036
01.01.24;WA65;Kopfbedeckungen und Teile davon;62559;68939;-6380
01.01.24;WA66;Schirme, Gehstöcke usw., Peitschen;5829;17465;-11636
01.01.24;WA67;Zugerichtete Federn, Daunen, künstliche Blumen;14376;22074;-7698
01.01.24;WA68;Waren aus Steinen, Gips, Zement usw.;434657;270311;164346
01.01.24;WA69;Keramische Waren;322355;223846;98509
01.01.24;WA70;Glas und Glaswaren;635882;449656;186226
01.01.24;WA71;Perlen, Edelsteine, Edelmetalle;2340444;1614682;725762
01.01.24;WA72;Eisen und Stahl;2490939;2188192;302747
01.01.24;WA73;Waren aus Eisen oder Stahl;2803502;1932057;871445
01.01.24;WA74;Kupfer und Waren daraus;1180698;838876;341822
01.01.24;WA75;Nickel und Waren daraus;189868;185309;4559
01.01.24;WA76;Aluminium und Waren daraus;1406021;1507880;-101859
01.01.24;WA78;Blei und Waren daraus;45080;49183;-4103
01.01.24;WA79;Zink und Waren daraus;59558;119473;-59915
01.01.24;WA80;Zinn und Waren daraus;10306;34368;-24062
01.01.24;WA81;Andere unedle Metalle, Cermets usw.;150196;153245;-3049
01.01.24;WA82;Werkzeuge, Schneidwaren, Essbestecke;832462;458519;373943
01.01.24;WA83;Verschiedene Waren aus unedlen Metallen;739817;438497;301320
01.01.24;WA84;Maschinen, Apparate, mechanische Geräte;20291118;12895708;7395410
01.01.24;WA85;Elektrotechnische Erzeugnisse;14263065;15389759;-1126694
01.01.24;WA86;Schienenfahrzeuge;322212;248441;73771
01.01.24;WA87;Kraftfahrzeuge, Landfahrzeuge;19986897;10656147;9330750
01.01.24;WA88;Luftfahrzeuge, Raumfahrzeuge;1762515;751639;1010876
01.01.24;WA89;Wasserfahrzeuge;145881;299921;-154040
01.01.24;WA90;Optische, photografische usw. Erzeugnisse;6277168;3630994;2646174
01.01.24;WA91;Uhrmacherwaren;142014;191489;-49475
01.01.24;WA92;Musikinstrumente;81950;54995;26955
01.01.24;WA93;Waffen und Munition;51133;19413;31720
01.01.24;WA94;Möbel, Beleuchtungskörper usw.;1391818;1650304;-258486
01.01.24;WA95;Spielzeug, Spiele usw., Sportgeräte;335167;509970;-174803
01.01.24;WA96;Verschiedene Waren;353873;279625;74248
01.01.24;WA97;Kunstgegenstände, Sammlungsstücke;79656;36150;43506
01.01.24;WA98;Vollständige Fabrikationsanlagen;74630;NULL;#WERT!
01.01.24;WA99;Zusammenstellungen verschiedener Waren;1116604;1033154;83450
01.01.25;WA01;Lebende Tiere;141780;126120;15660
01.01.25;WA02;Fleisch;623853;676776;-52923
01.01.25;WA03;Fische, Krebs- und Weichtiere;119413;366470;-247057
01.01.25;WA04;Milch, Milcherzeugnisse, Eier, Honig;1107821;1009558;98263
01.01.25;WA05;Andere Waren tierischen Ursprungs;75719;104477;-28758
01.01.25;WA06;Pflanzen, Waren des Blumenhandels;53248;253627;-200379
01.01.25;WA07;Gemüse, Pflanzen für Ernährung;133634;845509;-711875
01.01.25;WA08;Geniessbare Früchte und Nüsse;189952;1196170;-1006218
01.01.25;WA09;Kaffee, Tee, Mate, Gewürze;411582;537624;-126042
01.01.25;WA10;Getreide;210680;296826;-86146
01.01.25;WA11;Müllereierzeugnisse, Malz usw.;201806;82669;119137
01.01.25;WA12;Ölsamen usw., Heilpflanzen usw.;231866;611928;-380062
01.01.25;WA13;Schellack, Gummen, Harz, Pflanzensaft;63675;50923;12752
01.01.25;WA14;Flechtstoffe usw. pflanzlichen Ursprungs;1028;3635;-2607
01.01.25;WA15;Tierische und pflanzliche Fette, Öle, Wachs;319396;421524;-102128
01.01.25;WA16;Zubereitungen von Fleisch, Fisch usw.;310040;359161;-49121
01.01.25;WA17;Zucker und Zuckerwaren;339444;199495;139949
01.01.25;WA18;Kakao und Zubereitungen aus Kakao;980004;934537;45467
01.01.25;WA19;Zubereitungen aus Getreide usw., Backwaren;835354;618844;216510
01.01.25;WA20;Zubereitungen von Gemüse, Früchten usw.;320490;594269;-273779
01.01.25;WA21;Verschiedene Lebensmittelzubereitungen;788822;518154;270668
01.01.25;WA22;Getränke, alkoholhaltige Flüssigkeiten, Essig;547694;654536;-106842
01.01.25;WA23;Rückstände der Lebensmittelindustrie, Futter;615476;515237;100239
01.01.25;WA24;Tabak;283325;437248;-153923
01.01.25;WA25;Salz, Schwefel, Steine, Erden usw.;195065;151786;43279
01.01.25;WA26;Erze, Schlacken, Aschen;59698;845456;-785758
01.01.25;WA27;Mineralische Brennstoffe usw.;3027140;10461327;-7434187
01.01.25;WA28;Anorganische chemische Erzeugnisse;1072013;617874;454139
01.01.25;WA29;Organische chemische Erzeugnisse;2570047;3132017;-561970
01.01.25;WA30;Pharmazeutische Erzeugnisse;8833127;6751861;2081266
01.01.25;WA31;Düngemittel;256932;165705;91227
01.01.25;WA32;Gerb- und Farbstoffe, Farben, Lacke usw.;1004544;485374;519170
01.01.25;WA33;Etherische Öle, Riech-, Schönheitsmittel;1049827;855286;194541
01.01.25;WA34;Seifen, Waschmittel usw.;817871;475095;342776
01.01.25;WA35;Eiweissstoffe, Klebstoffe, Enzyme;419084;251531;167553
01.01.25;WA36;Sprengstoffe, pyrotechnische Artikel usw.;31113;18079;13034
01.01.25;WA37;Photochemische Erzeugnisse;92534;53480;39054
01.01.25;WA38;Verschiedene Erzeugnisse der Chemischen Industrie;2858702;1712307;1146395
01.01.25;WA39;Kunststoffe und Waren daraus;6005782;3762416;2243366
01.01.25;WA40;Kautschuk und Waren daraus;1381002;1292092;88910
01.01.25;WA41;Häute, Felle, Leder;47210;39495;7715
01.01.25;WA42;Lederwaren, Sattlerwaren;263362;424384;-161022
01.01.25;WA43;Pelzfelle, künstliches Pelzwerk;4768;5862;-1094
01.01.25;WA44;Holz, Holzwaren, Holzkohle;799640;681199;118441
01.01.25;WA45;Kork, Korkwaren;2129;7090;-4961
01.01.25;WA46;Flechtwaren, Korbmacherwaren;5578;15627;-10049
01.01.25;WA47;Halbstoffe aus Holz usw., Papierabfall;132321;298921;-166600
01.01.25;WA48;Papier, Pappe und Waren daraus;1745651;1109646;636005
01.01.25;WA49;Bücher, Zeitungen, Bilddrucke usw.;264677;234566;30111
01.01.25;WA50;Seide;1401;3459;-2058
01.01.25;WA51;Wolle, feine und grobe Tierhaare;32440;31617;823
01.01.25;WA52;Baumwolle;45747;48987;-3240
01.01.25;WA53;Andere pflanzliche Spinnstoffe, Papiergarn;4470;8148;-3678
01.01.25;WA54;Synthetisches oder künstliches Filament;133482;106517;26965
01.01.25;WA55;Synthetische oder künstliche Spinnfaser;120523;112218;8305
01.01.25;WA56;Watte, Filz, Vliesstoff usw., Tauwerk;230350;154596;75754
01.01.25;WA57;Teppiche, Fussbodenbelag aus Spinnstoff;49590;108594;-59004
01.01.25;WA58;Spezialgewebe, Spitzen, Tapisserien;43895;21414;22481
01.01.25;WA59;Getränkte, bestrichene usw. Gewebe;223670;110087;113583
01.01.25;WA60;Gewirke und Gestricke;47245;31807;15438
01.01.25;WA61;Bekleidung usw. aus Gewirken, Gestricken;1107530;1958720;-851190
01.01.25;WA62;Andere Bekleidung, Bekleidungszubehör;1123759;1774020;-650261
01.01.25;WA63;Andere Konfektion, Spinnstoffwaren usw.;252328;422108;-169780
01.01.25;WA64;Schuhe, Gamaschen, ähnliche Waren;1036790;1233911;-197121
01.01.25;WA65;Kopfbedeckungen und Teile davon;60940;86568;-25628
01.01.25;WA66;Schirme, Gehstöcke usw., Peitschen;6881;26569;-19688
01.01.25;WA67;Zugerichtete Federn, Daunen, künstliche Blumen;14847;34205;-19358
01.01.25;WA68;Waren aus Steinen, Gips, Zement usw.;446583;295029;151554
01.01.25;WA69;Keramische Waren;306867;255943;50924
01.01.25;WA70;Glas und Glaswaren;630426;456081;174345
01.01.25;WA71;Perlen, Edelsteine, Edelmetalle;2077759;2491780;-414021
01.01.25;WA72;Eisen und Stahl;2360365;2067533;292832
01.01.25;WA73;Waren aus Eisen oder Stahl;2674466;2097020;577446
01.01.25;WA74;Kupfer und Waren daraus;1281493;963929;317564
01.01.25;WA75;Nickel und Waren daraus;175248;165518;9730
01.01.25;WA76;Aluminium und Waren daraus;1573568;1667304;-93736
01.01.25;WA78;Blei und Waren daraus;42793;42943;-150
01.01.25;WA79;Zink und Waren daraus;79540;110306;-30766
01.01.25;WA80;Zinn und Waren daraus;13680;42216;-28536
01.01.25;WA81;Andere unedle Metalle, Cermets usw.;157618;175857;-18239
01.01.25;WA82;Werkzeuge, Schneidwaren, Essbestecke;778090;516900;261190
01.01.25;WA83;Verschiedene Waren aus unedlen Metallen;713875;494498;219377
01.01.25;WA84;Maschinen, Apparate, mechanische Geräte;19824174;13984182;5839992
01.01.25;WA85;Elektrotechnische Erzeugnisse;13806516;15260283;-1453767
01.01.25;WA86;Schienenfahrzeuge;303080;272072;31008
01.01.25;WA87;Kraftfahrzeuge, Landfahrzeuge;19513170;10133921;9379249
01.01.25;WA88;Luftfahrzeuge, Raumfahrzeuge;1721362;743384;977978
01.01.25;WA89;Wasserfahrzeuge;105257;120624;-15367
01.01.25;WA90;Optische, photografische usw. Erzeugnisse;6391373;3903120;2488253
01.01.25;WA91;Uhrmacherwaren;157992;196071;-38079
01.01.25;WA92;Musikinstrumente;79124;71222;7902
01.01.25;WA93;Waffen und Munition;43819;28112;15707
01.01.25;WA94;Möbel, Beleuchtungskörper usw.;1349944;2004565;-654621
01.01.25;WA95;Spielzeug, Spiele usw., Sportgeräte;376301;643752;-267451
01.01.25;WA96;Verschiedene Waren;350841;330639;20202
01.01.25;WA97;Kunstgegenstände, Sammlungsstücke;67783;63317;4466
01.01.25;WA98;Vollständige Fabrikationsanlagen;50675;NULL;#WERT!
01.01.25;WA99;Zusammenstellungen verschiedener Waren;1244351;1148782;95569
01.02.08;WA01;Lebende Tiere;69436;95582;-26146
01.02.08;WA02;Fleisch;434725;415807;18918
01.02.08;WA03;Fische, Krebs- und Weichtiere;70344;191779;-121435
01.02.08;WA04;Milch, Milcherzeugnisse, Eier, Honig;595022;464153;130869
01.02.08;WA05;Andere Waren tierischen Ursprungs;39056;51685;-12629
01.02.08;WA06;Pflanzen, Waren des Blumenhandels;47724;219542;-171818
01.02.08;WA07;Gemüse, Pflanzen für Ernährung;56385;352505;-296120
01.02.08;WA08;Geniessbare Früchte und Nüsse;123056;482373;-359317
01.02.08;WA09;Kaffee, Tee, Mate, Gewürze;119387;204467;-85080
01.02.08;WA10;Getreide;134045;193512;-59467
01.02.08;WA11;Müllereierzeugnisse, Malz usw.;79406;36895;42511
01.02.08;WA12;Ölsamen usw., Heilpflanzen usw.;151192;212253;-61061
01.02.08;WA13;Schellack, Gummen, Harz, Pflanzensaft;44259;30331;13928
01.02.08;WA14;Flechtstoffe usw. pflanzlichen Ursprungs;924;2499;-1575
01.02.08;WA15;Tierische und pflanzliche Fette, Öle, Wachs;143991;250013;-106022
01.02.08;WA16;Zubereitungen von Fleisch, Fisch usw.;167288;158309;8979
01.02.08;WA17;Zucker und Zuckerwaren;96191;111466;-15275
01.02.08;WA18;Kakao und Zubereitungen aus Kakao;219368;194388;24980
01.02.08;WA19;Zubereitungen aus Getreide usw., Backwaren;327087;186614;140473
01.02.08;WA20;Zubereitungen von Gemüse, Früchten usw.;185102;300372;-115270
01.02.08;WA21;Verschiedene Lebensmittelzubereitungen;287921;187825;100096
01.02.08;WA22;Getränke, alkoholhaltige Flüssigkeiten, Essig;298155;369502;-71347
01.02.08;WA23;Rückstände der Lebensmittelindustrie, Futter;180410;236241;-55831
01.02.08;WA24;Tabak;248135;107078;141057
01.02.08;WA25;Salz, Schwefel, Steine, Erden usw.;157070;138044;19026
01.02.08;WA26;Erze, Schlacken, Aschen;25360;501112;-475752
01.02.08;WA27;Mineralische Brennstoffe usw.;2019721;8979102;-6959381
01.02.08;WA28;Anorganische chemische Erzeugnisse;591857;574653;17204
01.02.08;WA29;Organische chemische Erzeugnisse;2160162;2029764;130398
01.02.08;WA30;Pharmazeutische Erzeugnisse;3612905;2555745;1057160
01.02.08;WA31;Düngemittel;221190;126834;94356
01.02.08;WA32;Gerb- und Farbstoffe, Farben, Lacke usw.;707026;301438;405588
01.02.08;WA33;Etherische Öle, Riech-, Schönheitsmittel;547745;304486;243259
01.02.08;WA34;Seifen, Waschmittel usw.;410923;194042;216881
01.02.08;WA35;Eiweissstoffe, Klebstoffe, Enzyme;168046;134710;33336
01.02.08;WA36;Sprengstoffe, pyrotechnische Artikel usw.;18952;11353;7599
01.02.08;WA37;Photochemische Erzeugnisse;123572;68802;54770
01.02.08;WA38;Verschiedene Erzeugnisse der Chemischen Industrie;1382904;785138;597766
01.02.08;WA39;Kunststoffe und Waren daraus;3773061;2266380;1506681
01.02.08;WA40;Kautschuk und Waren daraus;849433;838120;11313
01.02.08;WA41;Häute, Felle, Leder;79145;67559;11586
01.02.08;WA42;Lederwaren, Sattlerwaren;114745;196840;-82095
01.02.08;WA43;Pelzfelle, künstliches Pelzwerk;12840;7997;4843
01.02.08;WA44;Holz, Holzwaren, Holzkohle;636499;451341;185158
01.02.08;WA45;Kork, Korkwaren;3651;10028;-6377
01.02.08;WA46;Flechtwaren, Korbmacherwaren;4300;11986;-7686
01.02.08;WA47;Halbstoffe aus Holz usw., Papierabfall;93753;294623;-200870
01.02.08;WA48;Papier, Pappe und Waren daraus;1513717;951299;562418
01.02.08;WA49;Bücher, Zeitungen, Bilddrucke usw.;410780;162946;247834
01.02.08;WA50;Seide;7047;6548;499
01.02.08;WA51;Wolle, feine und grobe Tierhaare;76158;64106;12052
01.02.08;WA52;Baumwolle;89797;81803;7994
01.02.08;WA53;Andere pflanzliche Spinnstoffe, Papiergarn;7477;8986;-1509
01.02.08;WA54;Synthetisches oder künstliches Filament;199588;133552;66036
01.02.08;WA55;Synthetische oder künstliche Spinnfaser;150536;109265;41271
01.02.08;WA56;Watte, Filz, Vliesstoff usw., Tauwerk;157583;91589;65994
01.02.08;WA57;Teppiche, Fussbodenbelag aus Spinnstoff;38757;87514;-48757
01.02.08;WA58;Spezialgewebe, Spitzen, Tapisserien;40965;25595;15370
01.02.08;WA59;Getränkte, bestrichene usw. Gewebe;147256;103048;44208
01.02.08;WA60;Gewirke und Gestricke;68999;33750;35249
01.02.08;WA61;Bekleidung usw. aus Gewirken, Gestricken;419879;879107;-459228
01.02.08;WA62;Andere Bekleidung, Bekleidungszubehör;710848;1151964;-441116
01.02.08;WA63;Andere Konfektion, Spinnstoffwaren usw.;119406;212595;-93189
01.02.08;WA64;Schuhe, Gamaschen, ähnliche Waren;260100;502650;-242550
01.02.08;WA65;Kopfbedeckungen und Teile davon;17929;29674;-11745
01.02.08;WA66;Schirme, Gehstöcke usw., Peitschen;4884;23528;-18644
01.02.08;WA67;Zugerichtete Federn, Daunen, künstliche Blumen;5935;11083;-5148
01.02.08;WA68;Waren aus Steinen, Gips, Zement usw.;273598;172991;100607
01.02.08;WA69;Keramische Waren;226840;172899;53941
01.02.08;WA70;Glas und Glaswaren;393438;286617;106821
01.02.08;WA71;Perlen, Edelsteine, Edelmetalle;805789;823388;-17599
01.02.08;WA72;Eisen und Stahl;2182151;2241948;-59797
01.02.08;WA73;Waren aus Eisen oder Stahl;2106815;1312804;794011
01.02.08;WA74;Kupfer und Waren daraus;903842;835562;68280
01.02.08;WA75;Nickel und Waren daraus;106777;195875;-89098
01.02.08;WA76;Aluminium und Waren daraus;1037133;1023945;13188
01.02.08;WA78;Blei und Waren daraus;52546;25877;26669
01.02.08;WA79;Zink und Waren daraus;54796;88977;-34181
01.02.08;WA80;Zinn und Waren daraus;12731;22027;-9296
01.02.08;WA81;Andere unedle Metalle, Cermets usw.;94893;129589;-34696
01.02.08;WA82;Werkzeuge, Schneidwaren, Essbestecke;507533;333360;174173
01.02.08;WA83;Verschiedene Waren aus unedlen Metallen;535811;296113;239698
01.02.08;WA84;Maschinen, Apparate, mechanische Geräte;15451174;8646836;6804338
01.02.08;WA85;Elektrotechnische Erzeugnisse;8424424;6987749;1436675
01.02.08;WA86;Schienenfahrzeuge;210644;104935;105709
01.02.08;WA87;Kraftfahrzeuge, Landfahrzeuge;14977082;5639788;9337294
01.02.08;WA88;Luftfahrzeuge, Raumfahrzeuge;1958036;1735350;222686
01.02.08;WA89;Wasserfahrzeuge;175374;191766;-16392
01.02.08;WA90;Optische, photografische usw. Erzeugnisse;3183249;1799572;1383677
01.02.08;WA91;Uhrmacherwaren;85676;92116;-6440
01.02.08;WA92;Musikinstrumente;33883;28712;5171
01.02.08;WA93;Waffen und Munition;29115;10916;18199
01.02.08;WA94;Möbel, Beleuchtungskörper usw.;1014755;1022545;-7790
01.02.08;WA95;Spielzeug, Spiele usw., Sportgeräte;425219;515175;-89956
01.02.08;WA96;Verschiedene Waren;160300;93213;67087
01.02.08;WA97;Kunstgegenstände, Sammlungsstücke;34089;24959;9130
01.02.08;WA98;Vollständige Fabrikationsanlagen;337597;2951;334646
01.02.08;WA99;Zusammenstellungen verschiedener Waren;1439745;978368;461377
01.02.09;WA01;Lebende Tiere;78167;130081;-51914
01.02.09;WA02;Fleisch;462251;369054;93197
01.02.09;WA03;Fische, Krebs- und Weichtiere;77717;220277;-142560
01.02.09;WA04;Milch, Milcherzeugnisse, Eier, Honig;465953;377190;88763
01.02.09;WA05;Andere Waren tierischen Ursprungs;39778;49391;-9613
01.02.09;WA06;Pflanzen, Waren des Blumenhandels;44920;214093;-169173
01.02.09;WA07;Gemüse, Pflanzen für Ernährung;64451;394087;-329636
01.02.09;WA08;Geniessbare Früchte und Nüsse;84104;429191;-345087
01.02.09;WA09;Kaffee, Tee, Mate, Gewürze;121484;214441;-92957
01.02.09;WA10;Getreide;181399;182960;-1561
01.02.09;WA11;Müllereierzeugnisse, Malz usw.;72597;34593;38004
01.02.09;WA12;Ölsamen usw., Heilpflanzen usw.;106843;222748;-115905
01.02.09;WA13;Schellack, Gummen, Harz, Pflanzensaft;41510;26807;14703
01.02.09;WA14;Flechtstoffe usw. pflanzlichen Ursprungs;653;1671;-1018
01.02.09;WA15;Tierische und pflanzliche Fette, Öle, Wachs;139127;192884;-53757
01.02.09;WA16;Zubereitungen von Fleisch, Fisch usw.;180984;146197;34787
01.02.09;WA17;Zucker und Zuckerwaren;111097;100069;11028
01.02.09;WA18;Kakao und Zubereitungen aus Kakao;217469;198712;18757
01.02.09;WA19;Zubereitungen aus Getreide usw., Backwaren;310283;196299;113984
01.02.09;WA20;Zubereitungen von Gemüse, Früchten usw.;154363;300776;-146413
01.02.09;WA21;Verschiedene Lebensmittelzubereitungen;284880;194941;89939
01.02.09;WA22;Getränke, alkoholhaltige Flüssigkeiten, Essig;282747;387687;-104940
01.02.09;WA23;Rückstände der Lebensmittelindustrie, Futter;190315;210155;-19840
01.02.09;WA24;Tabak;248288;140121;108167
01.02.09;WA25;Salz, Schwefel, Steine, Erden usw.;149564;105447;44117
01.02.09;WA26;Erze, Schlacken, Aschen;12376;337605;-325229
01.02.09;WA27;Mineralische Brennstoffe usw.;1523611;6749423;-5225812
01.02.09;WA28;Anorganische chemische Erzeugnisse;458668;442459;16209
01.02.09;WA29;Organische chemische Erzeugnisse;1549540;1433930;115610
01.02.09;WA30;Pharmazeutische Erzeugnisse;3931359;2839401;1091958
01.02.09;WA31;Düngemittel;178792;76490;102302
01.02.09;WA32;Gerb- und Farbstoffe, Farben, Lacke usw.;509356;237086;272270
01.02.09;WA33;Etherische Öle, Riech-, Schönheitsmittel;484183;284931;199252
01.02.09;WA34;Seifen, Waschmittel usw.;352104;190907;161197
01.02.09;WA35;Eiweissstoffe, Klebstoffe, Enzyme;161150;105027;56123
01.02.09;WA36;Sprengstoffe, pyrotechnische Artikel usw.;15807;8392;7415
01.02.09;WA37;Photochemische Erzeugnisse;86011;52426;33585
01.02.09;WA38;Verschiedene Erzeugnisse der Chemischen Industrie;1080822;774419;306403
01.02.09;WA39;Kunststoffe und Waren daraus;2670177;1652126;1018051
01.02.09;WA40;Kautschuk und Waren daraus;640138;629341;10797
01.02.09;WA41;Häute, Felle, Leder;50477;49055;1422
01.02.09;WA42;Lederwaren, Sattlerwaren;108886;215968;-107082
01.02.09;WA43;Pelzfelle, künstliches Pelzwerk;5814;6801;-987
01.02.09;WA44;Holz, Holzwaren, Holzkohle;443264;374716;68548
01.02.09;WA45;Kork, Korkwaren;2817;7169;-4352
01.02.09;WA46;Flechtwaren, Korbmacherwaren;4151;11132;-6981
01.02.09;WA47;Halbstoffe aus Holz usw., Papierabfall;58082;158009;-99927
01.02.09;WA48;Papier, Pappe und Waren daraus;1219938;830942;388996
01.02.09;WA49;Bücher, Zeitungen, Bilddrucke usw.;376893;171673;205220
01.02.09;WA50;Seide;5752;5003;749
01.02.09;WA51;Wolle, feine und grobe Tierhaare;35001;44418;-9417
01.02.09;WA52;Baumwolle;70349;63578;6771
01.02.09;WA53;Andere pflanzliche Spinnstoffe, Papiergarn;5151;5175;-24
01.02.09;WA54;Synthetisches oder künstliches Filament;123642;85165;38477
01.02.09;WA55;Synthetische oder künstliche Spinnfaser;111871;88935;22936
01.02.09;WA56;Watte, Filz, Vliesstoff usw., Tauwerk;120766;76572;44194
01.02.09;WA57;Teppiche, Fussbodenbelag aus Spinnstoff;36959;97510;-60551
01.02.09;WA58;Spezialgewebe, Spitzen, Tapisserien;30747;22926;7821
01.02.09;WA59;Getränkte, bestrichene usw. Gewebe;109661;74838;34823
01.02.09;WA60;Gewirke und Gestricke;56747;27274;29473
01.02.09;WA61;Bekleidung usw. aus Gewirken, Gestricken;487868;894492;-406624
01.02.09;WA62;Andere Bekleidung, Bekleidungszubehör;732654;1169738;-437084
01.02.09;WA63;Andere Konfektion, Spinnstoffwaren usw.;128465;195273;-66808
01.02.09;WA64;Schuhe, Gamaschen, ähnliche Waren;303238;549259;-246021
01.02.09;WA65;Kopfbedeckungen und Teile davon;19458;33722;-14264
01.02.09;WA66;Schirme, Gehstöcke usw., Peitschen;16121;18380;-2259
01.02.09;WA67;Zugerichtete Federn, Daunen, künstliche Blumen;6408;10648;-4240
01.02.09;WA68;Waren aus Steinen, Gips, Zement usw.;196389;137643;58746
01.02.09;WA69;Keramische Waren;193995;146759;47236
01.02.09;WA70;Glas und Glaswaren;334651;233391;101260
01.02.09;WA71;Perlen, Edelsteine, Edelmetalle;547353;904151;-356798
01.02.09;WA72;Eisen und Stahl;1397874;1335004;62870
01.02.09;WA73;Waren aus Eisen oder Stahl;1734021;1056469;677552
01.02.09;WA74;Kupfer und Waren daraus;421625;364267;57358
01.02.09;WA75;Nickel und Waren daraus;54481;95308;-40827
01.02.09;WA76;Aluminium und Waren daraus;742617;632679;109938
01.02.09;WA78;Blei und Waren daraus;21848;11041;10807
01.02.09;WA79;Zink und Waren daraus;28021;37291;-9270
01.02.09;WA80;Zinn und Waren daraus;4730;16235;-11505
01.02.09;WA81;Andere unedle Metalle, Cermets usw.;48340;72297;-23957
01.02.09;WA82;Werkzeuge, Schneidwaren, Essbestecke;397745;260999;136746
01.02.09;WA83;Verschiedene Waren aus unedlen Metallen;375230;218098;157132
01.02.09;WA84;Maschinen, Apparate, mechanische Geräte;11968571;6795886;5172685
01.02.09;WA85;Elektrotechnische Erzeugnisse;6413085;5428114;984971
01.02.09;WA86;Schienenfahrzeuge;296213;125731;170482
01.02.09;WA87;Kraftfahrzeuge, Landfahrzeuge;8348738;4239342;4109396
01.02.09;WA88;Luftfahrzeuge, Raumfahrzeuge;1696433;1868476;-172043
01.02.09;WA89;Wasserfahrzeuge;401520;785689;-384169
01.02.09;WA90;Optische, photografische usw. Erzeugnisse;2757742;1573419;1184323
01.02.09;WA91;Uhrmacherwaren;70573;76093;-5520
01.02.09;WA92;Musikinstrumente;31009;28932;2077
01.02.09;WA93;Waffen und Munition;25331;11322;14009
01.02.09;WA94;Möbel, Beleuchtungskörper usw.;852894;890508;-37614
01.02.09;WA95;Spielzeug, Spiele usw., Sportgeräte;389235;509588;-120353
01.02.09;WA96;Verschiedene Waren;130441;87916;42525
01.02.09;WA97;Kunstgegenstände, Sammlungsstücke;42991;16703;26288
01.02.09;WA98;Vollständige Fabrikationsanlagen;435237;4682;430555
01.02.09;WA99;Zusammenstellungen verschiedener Waren;993600;912022;81578
01.02.10;WA01;Lebende Tiere;72566;131324;-58758
01.02.10;WA02;Fleisch;423290;333969;89321
01.02.10;WA03;Fische, Krebs- und Weichtiere;91292;217246;-125954
01.02.10;WA04;Milch, Milcherzeugnisse, Eier, Honig;530797;452418;78379
01.02.10;WA05;Andere Waren tierischen Ursprungs;48823;50709;-1886
01.02.10;WA06;Pflanzen, Waren des Blumenhandels;45196;201859;-156663
01.02.10;WA07;Gemüse, Pflanzen für Ernährung;64050;410974;-346924
01.02.10;WA08;Geniessbare Früchte und Nüsse;84623;435330;-350707
01.02.10;WA09;Kaffee, Tee, Mate, Gewürze;123295;223329;-100034
01.02.10;WA10;Getreide;134729;141637;-6908
01.02.10;WA11;Müllereierzeugnisse, Malz usw.;72208;28713;43495
01.02.10;WA12;Ölsamen usw., Heilpflanzen usw.;123093;204583;-81490
01.02.10;WA13;Schellack, Gummen, Harz, Pflanzensaft;34518;30745;3773
01.02.10;WA14;Flechtstoffe usw. pflanzlichen Ursprungs;631;1498;-867
01.02.10;WA15;Tierische und pflanzliche Fette, Öle, Wachs;121562;202293;-80731
01.02.10;WA16;Zubereitungen von Fleisch, Fisch usw.;160175;134733;25442
01.02.10;WA17;Zucker und Zuckerwaren;128375;92034;36341
01.02.10;WA18;Kakao und Zubereitungen aus Kakao;255626;244183;11443
01.02.10;WA19;Zubereitungen aus Getreide usw., Backwaren;314381;180236;134145
01.02.10;WA20;Zubereitungen von Gemüse, Früchten usw.;145683;272128;-126445
01.02.10;WA21;Verschiedene Lebensmittelzubereitungen;281296;224634;56662
01.02.10;WA22;Getränke, alkoholhaltige Flüssigkeiten, Essig;299143;376096;-76953
01.02.10;WA23;Rückstände der Lebensmittelindustrie, Futter;212973;220820;-7847
01.02.10;WA24;Tabak;259314;121413;137901
01.02.10;WA25;Salz, Schwefel, Steine, Erden usw.;120959;134831;-13872
01.02.10;WA26;Erze, Schlacken, Aschen;26236;487696;-461460
01.02.10;WA27;Mineralische Brennstoffe usw.;1557471;6787091;-5229620
01.02.10;WA28;Anorganische chemische Erzeugnisse;563291;512097;51194
01.02.10;WA29;Organische chemische Erzeugnisse;1688622;1543356;145266
01.02.10;WA30;Pharmazeutische Erzeugnisse;3701572;2831359;870213
01.02.10;WA31;Düngemittel;161876;83145;78731
01.02.10;WA32;Gerb- und Farbstoffe, Farben, Lacke usw.;625928;300637;325291
01.02.10;WA33;Etherische Öle, Riech-, Schönheitsmittel;573526;325770;247756
01.02.10;WA34;Seifen, Waschmittel usw.;421050;213999;207051
01.02.10;WA35;Eiweissstoffe, Klebstoffe, Enzyme;177801;123604;54197
01.02.10;WA36;Sprengstoffe, pyrotechnische Artikel usw.;14622;12740;1882
01.02.10;WA37;Photochemische Erzeugnisse;83573;60583;22990
01.02.10;WA38;Verschiedene Erzeugnisse der Chemischen Industrie;1182631;777052;405579
01.02.10;WA39;Kunststoffe und Waren daraus;3370050;1983539;1386511
01.02.10;WA40;Kautschuk und Waren daraus;820245;777346;42899
01.02.10;WA41;Häute, Felle, Leder;51221;53482;-2261
01.02.10;WA42;Lederwaren, Sattlerwaren;107223;176781;-69558
01.02.10;WA43;Pelzfelle, künstliches Pelzwerk;5541;6460;-919
01.02.10;WA44;Holz, Holzwaren, Holzkohle;469694;412582;57112
01.02.10;WA45;Kork, Korkwaren;2304;5939;-3635
01.02.10;WA46;Flechtwaren, Korbmacherwaren;4059;9378;-5319
01.02.10;WA47;Halbstoffe aus Holz usw., Papierabfall;67447;237910;-170463
01.02.10;WA48;Papier, Pappe und Waren daraus;1340000;886224;453776
01.02.10;WA49;Bücher, Zeitungen, Bilddrucke usw.;345492;147266;198226
01.02.10;WA50;Seide;4510;4200;310
01.02.10;WA51;Wolle, feine und grobe Tierhaare;40410;50731;-10321
01.02.10;WA52;Baumwolle;71330;61521;9809
01.02.10;WA53;Andere pflanzliche Spinnstoffe, Papiergarn;4152;4963;-811
01.02.10;WA54;Synthetisches oder künstliches Filament;147540;103887;43653
01.02.10;WA55;Synthetische oder künstliche Spinnfaser;141878;97186;44692
01.02.10;WA56;Watte, Filz, Vliesstoff usw., Tauwerk;145815;80350;65465
01.02.10;WA57;Teppiche, Fussbodenbelag aus Spinnstoff;36325;89581;-53256
01.02.10;WA58;Spezialgewebe, Spitzen, Tapisserien;36699;23046;13653
01.02.10;WA59;Getränkte, bestrichene usw. Gewebe;134448;68198;66250
01.02.10;WA60;Gewirke und Gestricke;57709;26879;30830
01.02.10;WA61;Bekleidung usw. aus Gewirken, Gestricken;461425;812058;-350633
01.02.10;WA62;Andere Bekleidung, Bekleidungszubehör;642957;998703;-355746
01.02.10;WA63;Andere Konfektion, Spinnstoffwaren usw.;127145;202382;-75237
01.02.10;WA64;Schuhe, Gamaschen, ähnliche Waren;290407;509298;-218891
01.02.10;WA65;Kopfbedeckungen und Teile davon;18775;30576;-11801
01.02.10;WA66;Schirme, Gehstöcke usw., Peitschen;16286;17311;-1025
01.02.10;WA67;Zugerichtete Federn, Daunen, künstliche Blumen;6693;11486;-4793
01.02.10;WA68;Waren aus Steinen, Gips, Zement usw.;221178;147797;73381
01.02.10;WA69;Keramische Waren;193348;153968;39380
01.02.10;WA70;Glas und Glaswaren;356964;274165;82799
01.02.10;WA71;Perlen, Edelsteine, Edelmetalle;834429;767991;66438
01.02.10;WA72;Eisen und Stahl;1570597;1360811;209786
01.02.10;WA73;Waren aus Eisen oder Stahl;1620122;994652;625470
01.02.10;WA74;Kupfer und Waren daraus;676180;641829;34351
01.02.10;WA75;Nickel und Waren daraus;49990;105977;-55987
01.02.10;WA76;Aluminium und Waren daraus;767376;823158;-55782
01.02.10;WA78;Blei und Waren daraus;38029;30375;7654
01.02.10;WA79;Zink und Waren daraus;42301;75573;-33272
01.02.10;WA80;Zinn und Waren daraus;7594;23228;-15634
01.02.10;WA81;Andere unedle Metalle, Cermets usw.;74214;73466;748
01.02.10;WA82;Werkzeuge, Schneidwaren, Essbestecke;447239;250709;196530
01.02.10;WA83;Verschiedene Waren aus unedlen Metallen;437013;266898;170115
01.02.10;WA84;Maschinen, Apparate, mechanische Geräte;11570899;6929549;4641350
01.02.10;WA85;Elektrotechnische Erzeugnisse;7047010;6463321;583689
01.02.10;WA86;Schienenfahrzeuge;291261;147681;143580
01.02.10;WA87;Kraftfahrzeuge, Landfahrzeuge;11401676;3991353;7410323
01.02.10;WA88;Luftfahrzeuge, Raumfahrzeuge;1938148;1704914;233234
01.02.10;WA89;Wasserfahrzeuge;413056;411261;1795
01.02.10;WA90;Optische, photografische usw. Erzeugnisse;3102772;1677820;1424952
01.02.10;WA91;Uhrmacherwaren;87477;84073;3404
01.02.10;WA92;Musikinstrumente;31068;41812;-10744
01.02.10;WA93;Waffen und Munition;29022;10304;18718
01.02.10;WA94;Möbel, Beleuchtungskörper usw.;872671;933744;-61073
01.02.10;WA95;Spielzeug, Spiele usw., Sportgeräte;331521;410582;-79061
01.02.10;WA96;Verschiedene Waren;140939;86681;54258
01.02.10;WA97;Kunstgegenstände, Sammlungsstücke;29710;16780;12930
01.02.10;WA98;Vollständige Fabrikationsanlagen;373359;597;372762
01.02.10;WA99;Zusammenstellungen verschiedener Waren;1093727;852855;240872
01.02.11;WA01;Lebende Tiere;87162;121450;-34288
01.02.11;WA02;Fleisch;497794;408898;88896
01.02.11;WA03;Fische, Krebs- und Weichtiere;94633;274112;-179479
01.02.11;WA04;Milch, Milcherzeugnisse, Eier, Honig;630240;465268;164972
01.02.11;WA05;Andere Waren tierischen Ursprungs;49808;58592;-8784
01.02.11;WA06;Pflanzen, Waren des Blumenhandels;55795;231978;-176183
01.02.11;WA07;Gemüse, Pflanzen für Ernährung;87465;468872;-381407
01.02.11;WA08;Geniessbare Früchte und Nüsse;105354;488789;-383435
01.02.11;WA09;Kaffee, Tee, Mate, Gewürze;181807;354508;-172701
01.02.11;WA10;Getreide;242812;218491;24321
01.02.11;WA11;Müllereierzeugnisse, Malz usw.;80082;38392;41690
01.02.11;WA12;Ölsamen usw., Heilpflanzen usw.;134757;319914;-185157
01.02.11;WA13;Schellack, Gummen, Harz, Pflanzensaft;37408;30164;7244
01.02.11;WA14;Flechtstoffe usw. pflanzlichen Ursprungs;944;2126;-1182
01.02.11;WA15;Tierische und pflanzliche Fette, Öle, Wachs;213287;321603;-108316
01.02.11;WA16;Zubereitungen von Fleisch, Fisch usw.;181227;143445;37782
01.02.11;WA17;Zucker und Zuckerwaren;112357;103675;8682
01.02.11;WA18;Kakao und Zubereitungen aus Kakao;282272;295779;-13507
01.02.11;WA19;Zubereitungen aus Getreide usw., Backwaren;333135;192040;141095
01.02.11;WA20;Zubereitungen von Gemüse, Früchten usw.;160843;307851;-147008
01.02.11;WA21;Verschiedene Lebensmittelzubereitungen;302621;167679;134942
01.02.11;WA22;Getränke, alkoholhaltige Flüssigkeiten, Essig;311650;410559;-98909
01.02.11;WA23;Rückstände der Lebensmittelindustrie, Futter;244869;240597;4272
01.02.11;WA24;Tabak;287961;137510;150451
01.02.11;WA25;Salz, Schwefel, Steine, Erden usw.;155699;154218;1481
01.02.11;WA26;Erze, Schlacken, Aschen;37817;800112;-762295
01.02.11;WA27;Mineralische Brennstoffe usw.;2168090;10088259;-7920169
01.02.11;WA28;Anorganische chemische Erzeugnisse;662254;628211;34043
01.02.11;WA29;Organische chemische Erzeugnisse;2143341;1869257;274084
01.02.11;WA30;Pharmazeutische Erzeugnisse;3932930;2805670;1127260
01.02.11;WA31;Düngemittel;240322;133295;107027
01.02.11;WA32;Gerb- und Farbstoffe, Farben, Lacke usw.;755975;420944;335031
01.02.11;WA33;Etherische Öle, Riech-, Schönheitsmittel;622002;359584;262418
01.02.11;WA34;Seifen, Waschmittel usw.;470253;224451;245802
01.02.11;WA35;Eiweissstoffe, Klebstoffe, Enzyme;196489;137316;59173
01.02.11;WA36;Sprengstoffe, pyrotechnische Artikel usw.;19629;13628;6001
01.02.11;WA37;Photochemische Erzeugnisse;86949;61384;25565
01.02.11;WA38;Verschiedene Erzeugnisse der Chemischen Industrie;1551032;906210;644822
01.02.11;WA39;Kunststoffe und Waren daraus;4068257;2480397;1587860
01.02.11;WA40;Kautschuk und Waren daraus;1091753;1089992;1761
01.02.11;WA41;Häute, Felle, Leder;87723;74650;13073
01.02.11;WA42;Lederwaren, Sattlerwaren;127591;237564;-109973
01.02.11;WA43;Pelzfelle, künstliches Pelzwerk;6151;10912;-4761
01.02.11;WA44;Holz, Holzwaren, Holzkohle;541873;499792;42081
01.02.11;WA45;Kork, Korkwaren;2533;7163;-4630
01.02.11;WA46;Flechtwaren, Korbmacherwaren;2949;12242;-9293
01.02.11;WA47;Halbstoffe aus Holz usw., Papierabfall;103095;330808;-227713
01.02.11;WA48;Papier, Pappe und Waren daraus;1532697;965896;566801
01.02.11;WA49;Bücher, Zeitungen, Bilddrucke usw.;340209;151930;188279
01.02.11;WA50;Seide;6404;6794;-390
01.02.11;WA51;Wolle, feine und grobe Tierhaare;56951;60952;-4001
01.02.11;WA52;Baumwolle;92273;99823;-7550
01.02.11;WA53;Andere pflanzliche Spinnstoffe, Papiergarn;5308;6851;-1543
01.02.11;WA54;Synthetisches oder künstliches Filament;174629;123243;51386
01.02.11;WA55;Synthetische oder künstliche Spinnfaser;168546;147195;21351
01.02.11;WA56;Watte, Filz, Vliesstoff usw., Tauwerk;164430;101634;62796
01.02.11;WA57;Teppiche, Fussbodenbelag aus Spinnstoff;45011;101351;-56340
01.02.11;WA58;Spezialgewebe, Spitzen, Tapisserien;39720;27009;12711
01.02.11;WA59;Getränkte, bestrichene usw. Gewebe;156823;94311;62512
01.02.11;WA60;Gewirke und Gestricke;70628;33283;37345
01.02.11;WA61;Bekleidung usw. aus Gewirken, Gestricken;554434;1037393;-482959
01.02.11;WA62;Andere Bekleidung, Bekleidungszubehör;749885;1257076;-507191
01.02.11;WA63;Andere Konfektion, Spinnstoffwaren usw.;152041;268176;-116135
01.02.11;WA64;Schuhe, Gamaschen, ähnliche Waren;362501;656093;-293592
01.02.11;WA65;Kopfbedeckungen und Teile davon;29570;38060;-8490
01.02.11;WA66;Schirme, Gehstöcke usw., Peitschen;6504;18679;-12175
01.02.11;WA67;Zugerichtete Federn, Daunen, künstliche Blumen;7682;12786;-5104
01.02.11;WA68;Waren aus Steinen, Gips, Zement usw.;279855;184052;95803
01.02.11;WA69;Keramische Waren;228490;191769;36721
01.02.11;WA70;Glas und Glaswaren;405408;319920;85488
01.02.11;WA71;Perlen, Edelsteine, Edelmetalle;853810;1134262;-280452
01.02.11;WA72;Eisen und Stahl;2274563;2314444;-39881
01.02.11;WA73;Waren aus Eisen oder Stahl;1967054;1358388;608666
01.02.11;WA74;Kupfer und Waren daraus;1140579;1074770;65809
01.02.11;WA75;Nickel und Waren daraus;81738;191900;-110162
01.02.11;WA76;Aluminium und Waren daraus;1063397;1147366;-83969
01.02.11;WA78;Blei und Waren daraus;45179;33491;11688
01.02.11;WA79;Zink und Waren daraus;56059;94788;-38729
01.02.11;WA80;Zinn und Waren daraus;12226;40452;-28226
01.02.11;WA81;Andere unedle Metalle, Cermets usw.;95146;121933;-26787
01.02.11;WA82;Werkzeuge, Schneidwaren, Essbestecke;532336;329186;203150
01.02.11;WA83;Verschiedene Waren aus unedlen Metallen;522469;310926;211543
01.02.11;WA84;Maschinen, Apparate, mechanische Geräte;14479105;8462374;6016731
01.02.11;WA85;Elektrotechnische Erzeugnisse;8372742;7533459;839283
01.02.11;WA86;Schienenfahrzeuge;231014;138011;93003
01.02.11;WA87;Kraftfahrzeuge, Landfahrzeuge;14679085;5497685;9181400
01.02.11;WA88;Luftfahrzeuge, Raumfahrzeuge;1689926;1727718;-37792
01.02.11;WA89;Wasserfahrzeuge;108198;1015666;-907468
01.02.11;WA90;Optische, photografische usw. Erzeugnisse;3699201;2008424;1690777
01.02.11;WA91;Uhrmacherwaren;102421;116062;-13641
01.02.11;WA92;Musikinstrumente;36217;35638;579
01.02.11;WA93;Waffen und Munition;27481;11528;15953
01.02.11;WA94;Möbel, Beleuchtungskörper usw.;1070385;1191214;-120829
01.02.11;WA95;Spielzeug, Spiele usw., Sportgeräte;331515;436212;-104697
01.02.11;WA96;Verschiedene Waren;156171;113462;42709
01.02.11;WA97;Kunstgegenstände, Sammlungsstücke;123645;18507;105138
01.02.11;WA98;Vollständige Fabrikationsanlagen;227463;478;226985
01.02.11;WA99;Zusammenstellungen verschiedener Waren;1136787;935893;200894
01.02.12;WA01;Lebende Tiere;98240;161492;-63252
01.02.12;WA02;Fleisch;605447;475132;130315
01.02.12;WA03;Fische, Krebs- und Weichtiere;90816;285310;-194494
01.02.12;WA04;Milch, Milcherzeugnisse, Eier, Honig;667477;514783;152694
01.02.12;WA05;Andere Waren tierischen Ursprungs;70804;72971;-2167
01.02.12;WA06;Pflanzen, Waren des Blumenhandels;54779;227659;-172880
01.02.12;WA07;Gemüse, Pflanzen für Ernährung;60093;432032;-371939
01.02.12;WA08;Geniessbare Früchte und Nüsse;95146;491146;-396000
01.02.12;WA09;Kaffee, Tee, Mate, Gewürze;195382;372003;-176621
01.02.12;WA10;Getreide;199396;217191;-17795
01.02.12;WA11;Müllereierzeugnisse, Malz usw.;98928;36744;62184
01.02.12;WA12;Ölsamen usw., Heilpflanzen usw.;120764;371790;-251026
01.02.12;WA13;Schellack, Gummen, Harz, Pflanzensaft;38680;44476;-5796
01.02.12;WA14;Flechtstoffe usw. pflanzlichen Ursprungs;616;1968;-1352
01.02.12;WA15;Tierische und pflanzliche Fette, Öle, Wachs;233328;304802;-71474
01.02.12;WA16;Zubereitungen von Fleisch, Fisch usw.;199055;184581;14474
01.02.12;WA17;Zucker und Zuckerwaren;134998;110913;24085
01.02.12;WA18;Kakao und Zubereitungen aus Kakao;301261;265710;35551
01.02.12;WA19;Zubereitungen aus Getreide usw., Backwaren;398708;226103;172605
01.02.12;WA20;Zubereitungen von Gemüse, Früchten usw.;177461;353298;-175837
01.02.12;WA21;Verschiedene Lebensmittelzubereitungen;347727;203884;143843
01.02.12;WA22;Getränke, alkoholhaltige Flüssigkeiten, Essig;362822;473121;-110299
01.02.12;WA23;Rückstände der Lebensmittelindustrie, Futter;253410;273929;-20519
01.02.12;WA24;Tabak;353660;142572;211088
01.02.12;WA25;Salz, Schwefel, Steine, Erden usw.;141549;160837;-19288
01.02.12;WA26;Erze, Schlacken, Aschen;37684;761570;-723886
01.02.12;WA27;Mineralische Brennstoffe usw.;2527554;10983014;-8455460
01.02.12;WA28;Anorganische chemische Erzeugnisse;865503;636814;228689
01.02.12;WA29;Organische chemische Erzeugnisse;2027367;1861863;165504
01.02.12;WA30;Pharmazeutische Erzeugnisse;4108266;2704425;1403841
01.02.12;WA31;Düngemittel;259754;114320;145434
01.02.12;WA32;Gerb- und Farbstoffe, Farben, Lacke usw.;830082;427774;402308
01.02.12;WA33;Etherische Öle, Riech-, Schönheitsmittel;586967;315192;271775
01.02.12;WA34;Seifen, Waschmittel usw.;491384;241859;249525
01.02.12;WA35;Eiweissstoffe, Klebstoffe, Enzyme;226020;144552;81468
01.02.12;WA36;Sprengstoffe, pyrotechnische Artikel usw.;19755;13964;5791
01.02.12;WA37;Photochemische Erzeugnisse;84007;62391;21616
01.02.12;WA38;Verschiedene Erzeugnisse der Chemischen Industrie;1515858;970429;545429
01.02.12;WA39;Kunststoffe und Waren daraus;4124458;2605390;1519068
01.02.12;WA40;Kautschuk und Waren daraus;1217923;1218045;-122
01.02.12;WA41;Häute, Felle, Leder;91755;67173;24582
01.02.12;WA42;Lederwaren, Sattlerwaren;131752;251618;-119866
01.02.12;WA43;Pelzfelle, künstliches Pelzwerk;13030;8188;4842
01.02.12;WA44;Holz, Holzwaren, Holzkohle;551838;536123;15715
01.02.12;WA45;Kork, Korkwaren;3039;12072;-9033
01.02.12;WA46;Flechtwaren, Korbmacherwaren;2556;10423;-7867
01.02.12;WA47;Halbstoffe aus Holz usw., Papierabfall;100616;285431;-184815
01.02.12;WA48;Papier, Pappe und Waren daraus;1409870;934797;475073
01.02.12;WA49;Bücher, Zeitungen, Bilddrucke usw.;331103;158204;172899
01.02.12;WA50;Seide;6050;6846;-796
01.02.12;WA51;Wolle, feine und grobe Tierhaare;67000;71174;-4174
01.02.12;WA52;Baumwolle;84530;83327;1203
01.02.12;WA53;Andere pflanzliche Spinnstoffe, Papiergarn;4279;6157;-1878
01.02.12;WA54;Synthetisches oder künstliches Filament;161529;120167;41362
01.02.12;WA55;Synthetische oder künstliche Spinnfaser;166992;128227;38765
01.02.12;WA56;Watte, Filz, Vliesstoff usw., Tauwerk;171777;90847;80930
01.02.12;WA57;Teppiche, Fussbodenbelag aus Spinnstoff;43614;101300;-57686
01.02.12;WA58;Spezialgewebe, Spitzen, Tapisserien;39462;26321;13141
01.02.12;WA59;Getränkte, bestrichene usw. Gewebe;170057;99717;70340
01.02.12;WA60;Gewirke und Gestricke;67171;37582;29589
01.02.12;WA61;Bekleidung usw. aus Gewirken, Gestricken;551785;1015022;-463237
01.02.12;WA62;Andere Bekleidung, Bekleidungszubehör;745985;1301228;-555243
01.02.12;WA63;Andere Konfektion, Spinnstoffwaren usw.;137853;258605;-120752
01.02.12;WA64;Schuhe, Gamaschen, ähnliche Waren;349968;690172;-340204
01.02.12;WA65;Kopfbedeckungen und Teile davon;27524;41957;-14433
01.02.12;WA66;Schirme, Gehstöcke usw., Peitschen;5686;28122;-22436
01.02.12;WA67;Zugerichtete Federn, Daunen, künstliche Blumen;8615;11902;-3287
01.02.12;WA68;Waren aus Steinen, Gips, Zement usw.;278164;209312;68852
01.02.12;WA69;Keramische Waren;231966;177934;54032
01.02.12;WA70;Glas und Glaswaren;400593;322511;78082
01.02.12;WA71;Perlen, Edelsteine, Edelmetalle;1328584;1488716;-160132
01.02.12;WA72;Eisen und Stahl;2136047;2210620;-74573
01.02.12;WA73;Waren aus Eisen oder Stahl;2116653;1445555;671098
01.02.12;WA74;Kupfer und Waren daraus;1033336;1000343;32993
01.02.12;WA75;Nickel und Waren daraus;93893;170206;-76313
01.02.12;WA76;Aluminium und Waren daraus;1033466;1111718;-78252
01.02.12;WA78;Blei und Waren daraus;33685;38703;-5018
01.02.12;WA79;Zink und Waren daraus;55123;82080;-26957
01.02.12;WA80;Zinn und Waren daraus;9526;35115;-25589
01.02.12;WA81;Andere unedle Metalle, Cermets usw.;110404;133780;-23376
01.02.12;WA82;Werkzeuge, Schneidwaren, Essbestecke;552892;352869;200023
01.02.12;WA83;Verschiedene Waren aus unedlen Metallen;517866;317736;200130
01.02.12;WA84;Maschinen, Apparate, mechanische Geräte;15941342;9191976;6749366
01.02.12;WA85;Elektrotechnische Erzeugnisse;8693163;7938019;755144
01.02.12;WA86;Schienenfahrzeuge;347046;121389;225657
01.02.12;WA87;Kraftfahrzeuge, Landfahrzeuge;16258735;6187987;10070748
01.02.12;WA88;Luftfahrzeuge, Raumfahrzeuge;2723249;995870;1727379
01.02.12;WA89;Wasserfahrzeuge;80816;672560;-591744
01.02.12;WA90;Optische, photografische usw. Erzeugnisse;4069564;2222926;1846638
01.02.12;WA91;Uhrmacherwaren;108699;134735;-26036
01.02.12;WA92;Musikinstrumente;41776;44089;-2313
01.02.12;WA93;Waffen und Munition;33083;16899;16184
01.02.12;WA94;Möbel, Beleuchtungskörper usw.;1056951;1259165;-202214
01.02.12;WA95;Spielzeug, Spiele usw., Sportgeräte;288848;375883;-87035
01.02.12;WA96;Verschiedene Waren;226089;159594;66495
01.02.12;WA97;Kunstgegenstände, Sammlungsstücke;76897;27602;49295
01.02.12;WA98;Vollständige Fabrikationsanlagen;182477;3150;179327
01.02.12;WA99;Zusammenstellungen verschiedener Waren;1279279;923062;356217
01.02.13;WA01;Lebende Tiere;109256;151772;-42516
01.02.13;WA02;Fleisch;618621;459634;158987
01.02.13;WA03;Fische, Krebs- und Weichtiere;96034;237304;-141270
01.02.13;WA04;Milch, Milcherzeugnisse, Eier, Honig;660459;486443;174016
01.02.13;WA05;Andere Waren tierischen Ursprungs;68409;73273;-4864
01.02.13;WA06;Pflanzen, Waren des Blumenhandels;56393;226999;-170606
01.02.13;WA07;Gemüse, Pflanzen für Ernährung;79319;461221;-381902
01.02.13;WA08;Geniessbare Früchte und Nüsse;103356;563335;-459979
01.02.13;WA09;Kaffee, Tee, Mate, Gewürze;181962;313353;-131391
01.02.13;WA10;Getreide;244605;218332;26273
01.02.13;WA11;Müllereierzeugnisse, Malz usw.;106956;37233;69723
01.02.13;WA12;Ölsamen usw., Heilpflanzen usw.;134271;418455;-284184
01.02.13;WA13;Schellack, Gummen, Harz, Pflanzensaft;40594;39515;1079
01.02.13;WA14;Flechtstoffe usw. pflanzlichen Ursprungs;984;2028;-1044
01.02.13;WA15;Tierische und pflanzliche Fette, Öle, Wachs;200166;258888;-58722
01.02.13;WA16;Zubereitungen von Fleisch, Fisch usw.;207925;170234;37691
01.02.13;WA17;Zucker und Zuckerwaren;151629;113176;38453
01.02.13;WA18;Kakao und Zubereitungen aus Kakao;315285;231249;84036
01.02.13;WA19;Zubereitungen aus Getreide usw., Backwaren;385196;245620;139576
01.02.13;WA20;Zubereitungen von Gemüse, Früchten usw.;175059;325581;-150522
01.02.13;WA21;Verschiedene Lebensmittelzubereitungen;359361;207520;151841
01.02.13;WA22;Getränke, alkoholhaltige Flüssigkeiten, Essig;370624;499928;-129304
01.02.13;WA23;Rückstände der Lebensmittelindustrie, Futter;304288;270405;33883
01.02.13;WA24;Tabak;307033;156191;150842
01.02.13;WA25;Salz, Schwefel, Steine, Erden usw.;154195;132923;21272
01.02.13;WA26;Erze, Schlacken, Aschen;27698;561154;-533456
01.02.13;WA27;Mineralische Brennstoffe usw.;2388165;11001666;-8613501
01.02.13;WA28;Anorganische chemische Erzeugnisse;736425;477681;258744
01.02.13;WA29;Organische chemische Erzeugnisse;2105562;1936937;168625
01.02.13;WA30;Pharmazeutische Erzeugnisse;4554032;2803643;1750389
01.02.13;WA31;Düngemittel;262922;156446;106476
01.02.13;WA32;Gerb- und Farbstoffe, Farben, Lacke usw.;810428;433152;377276
01.02.13;WA33;Etherische Öle, Riech-, Schönheitsmittel;666669;397724;268945
01.02.13;WA34;Seifen, Waschmittel usw.;506950;256065;250885
01.02.13;WA35;Eiweissstoffe, Klebstoffe, Enzyme;225049;148166;76883
01.02.13;WA36;Sprengstoffe, pyrotechnische Artikel usw.;17160;10670;6490
01.02.13;WA37;Photochemische Erzeugnisse;87086;59020;28066
01.02.13;WA38;Verschiedene Erzeugnisse der Chemischen Industrie;1544975;930703;614272
01.02.13;WA39;Kunststoffe und Waren daraus;4127309;2546556;1580753
01.02.13;WA40;Kautschuk und Waren daraus;1100151;1069956;30195
01.02.13;WA41;Häute, Felle, Leder;83479;75147;8332
01.02.13;WA42;Lederwaren, Sattlerwaren;137973;259124;-121151
01.02.13;WA43;Pelzfelle, künstliches Pelzwerk;14809;11280;3529
01.02.13;WA44;Holz, Holzwaren, Holzkohle;510588;514986;-4398
01.02.13;WA45;Kork, Korkwaren;1852;5777;-3925
01.02.13;WA46;Flechtwaren, Korbmacherwaren;2780;7953;-5173
01.02.13;WA47;Halbstoffe aus Holz usw., Papierabfall;101511;276149;-174638
01.02.13;WA48;Papier, Pappe und Waren daraus;1270211;874815;395396
01.02.13;WA49;Bücher, Zeitungen, Bilddrucke usw.;328646;141033;187613
01.02.13;WA50;Seide;5128;5872;-744
01.02.13;WA51;Wolle, feine und grobe Tierhaare;47545;47833;-288
01.02.13;WA52;Baumwolle;74884;76403;-1519
01.02.13;WA53;Andere pflanzliche Spinnstoffe, Papiergarn;3996;5476;-1480
01.02.13;WA54;Synthetisches oder künstliches Filament;150469;103527;46942
01.02.13;WA55;Synthetische oder künstliche Spinnfaser;153318;117465;35853
01.02.13;WA56;Watte, Filz, Vliesstoff usw., Tauwerk;169550;94016;75534
01.02.13;WA57;Teppiche, Fussbodenbelag aus Spinnstoff;43289;90563;-47274
01.02.13;WA58;Spezialgewebe, Spitzen, Tapisserien;34260;22024;12236
01.02.13;WA59;Getränkte, bestrichene usw. Gewebe;164539;86939;77600
01.02.13;WA60;Gewirke und Gestricke;59167;29600;29567
01.02.13;WA61;Bekleidung usw. aus Gewirken, Gestricken;524967;1006632;-481665
01.02.13;WA62;Andere Bekleidung, Bekleidungszubehör;681460;1165368;-483908
01.02.13;WA63;Andere Konfektion, Spinnstoffwaren usw.;158760;247656;-88896
01.02.13;WA64;Schuhe, Gamaschen, ähnliche Waren;376295;737579;-361284
01.02.13;WA65;Kopfbedeckungen und Teile davon;24669;34545;-9876
01.02.13;WA66;Schirme, Gehstöcke usw., Peitschen;6453;22307;-15854
01.02.13;WA67;Zugerichtete Federn, Daunen, künstliche Blumen;9325;14369;-5044
01.02.13;WA68;Waren aus Steinen, Gips, Zement usw.;275124;187910;87214
01.02.13;WA69;Keramische Waren;207672;168723;38949
01.02.13;WA70;Glas und Glaswaren;399937;295283;104654
01.02.13;WA71;Perlen, Edelsteine, Edelmetalle;1117994;1290391;-172397
01.02.13;WA72;Eisen und Stahl;1929306;1895541;33765
01.02.13;WA73;Waren aus Eisen oder Stahl;2066858;1322974;743884
01.02.13;WA74;Kupfer und Waren daraus;960484;854678;105806
01.02.13;WA75;Nickel und Waren daraus;83962;130205;-46243
01.02.13;WA76;Aluminium und Waren daraus;1003756;1108098;-104342
01.02.13;WA78;Blei und Waren daraus;37432;36433;999
01.02.13;WA79;Zink und Waren daraus;44381;86678;-42297
01.02.13;WA80;Zinn und Waren daraus;10026;38603;-28577
01.02.13;WA81;Andere unedle Metalle, Cermets usw.;104855;129605;-24750
01.02.13;WA82;Werkzeuge, Schneidwaren, Essbestecke;559719;321312;238407
01.02.13;WA83;Verschiedene Waren aus unedlen Metallen;509377;309047;200330
01.02.13;WA84;Maschinen, Apparate, mechanische Geräte;14951766;8616635;6335131
01.02.13;WA85;Elektrotechnische Erzeugnisse;8169773;7178814;990959
01.02.13;WA86;Schienenfahrzeuge;239048;177841;61207
01.02.13;WA87;Kraftfahrzeuge, Landfahrzeuge;15172028;5757289;9414739
01.02.13;WA88;Luftfahrzeuge, Raumfahrzeuge;2691978;1234845;1457133
01.02.13;WA89;Wasserfahrzeuge;238042;121195;116847
01.02.13;WA90;Optische, photografische usw. Erzeugnisse;3948715;2128917;1819798
01.02.13;WA91;Uhrmacherwaren;121223;157314;-36091
01.02.13;WA92;Musikinstrumente;36483;43306;-6823
01.02.13;WA93;Waffen und Munition;40011;12997;27014
01.02.13;WA94;Möbel, Beleuchtungskörper usw.;1040237;1234922;-194685
01.02.13;WA95;Spielzeug, Spiele usw., Sportgeräte;247722;390168;-142446
01.02.13;WA96;Verschiedene Waren;259101;181535;77566
01.02.13;WA97;Kunstgegenstände, Sammlungsstücke;39984;17788;22196
01.02.13;WA98;Vollständige Fabrikationsanlagen;284280;1102;283178
01.02.13;WA99;Zusammenstellungen verschiedener Waren;1338823;727136;611687
01.02.14;WA01;Lebende Tiere;124809;164521;-39712
01.02.14;WA02;Fleisch;564502;461877;102625
01.02.14;WA03;Fische, Krebs- und Weichtiere;93487;263872;-170385
01.02.14;WA04;Milch, Milcherzeugnisse, Eier, Honig;780283;541699;238584
01.02.14;WA05;Andere Waren tierischen Ursprungs;64152;73135;-8983
01.02.14;WA06;Pflanzen, Waren des Blumenhandels;66752;257970;-191218
01.02.14;WA07;Gemüse, Pflanzen für Ernährung;79538;491023;-411485
01.02.14;WA08;Geniessbare Früchte und Nüsse;108917;554989;-446072
01.02.14;WA09;Kaffee, Tee, Mate, Gewürze;184958;246556;-61598
01.02.14;WA10;Getreide;312871;263513;49358
01.02.14;WA11;Müllereierzeugnisse, Malz usw.;116141;39510;76631
01.02.14;WA12;Ölsamen usw., Heilpflanzen usw.;153209;349165;-195956
01.02.14;WA13;Schellack, Gummen, Harz, Pflanzensaft;43331;43441;-110
01.02.14;WA14;Flechtstoffe usw. pflanzlichen Ursprungs;896;3086;-2190
01.02.14;WA15;Tierische und pflanzliche Fette, Öle, Wachs;208142;284631;-76489
01.02.14;WA16;Zubereitungen von Fleisch, Fisch usw.;221986;171747;50239
01.02.14;WA17;Zucker und Zuckerwaren;139405;141151;-1746
01.02.14;WA18;Kakao und Zubereitungen aus Kakao;340773;290764;50009
01.02.14;WA19;Zubereitungen aus Getreide usw., Backwaren;394968;263213;131755
01.02.14;WA20;Zubereitungen von Gemüse, Früchten usw.;178612;332851;-154239
01.02.14;WA21;Verschiedene Lebensmittelzubereitungen;376402;221974;154428
01.02.14;WA22;Getränke, alkoholhaltige Flüssigkeiten, Essig;396438;472017;-75579
01.02.14;WA23;Rückstände der Lebensmittelindustrie, Futter;292215;277950;14265
01.02.14;WA24;Tabak;268386;133159;135227
01.02.14;WA25;Salz, Schwefel, Steine, Erden usw.;151373;149985;1388
01.02.14;WA26;Erze, Schlacken, Aschen;21057;678261;-657204
01.02.14;WA27;Mineralische Brennstoffe usw.;2347726;10203459;-7855733
01.02.14;WA28;Anorganische chemische Erzeugnisse;609017;570303;38714
01.02.14;WA29;Organische chemische Erzeugnisse;2068560;2088610;-20050
01.02.14;WA30;Pharmazeutische Erzeugnisse;4619309;3111293;1508016
01.02.14;WA31;Düngemittel;196273;123197;73076
01.02.14;WA32;Gerb- und Farbstoffe, Farben, Lacke usw.;867739;496106;371633
01.02.14;WA33;Etherische Öle, Riech-, Schönheitsmittel;677347;433468;243879
01.02.14;WA34;Seifen, Waschmittel usw.;545388;285991;259397
01.02.14;WA35;Eiweissstoffe, Klebstoffe, Enzyme;251062;161071;89991
01.02.14;WA36;Sprengstoffe, pyrotechnische Artikel usw.;13867;12863;1004
01.02.14;WA37;Photochemische Erzeugnisse;90734;66146;24588
01.02.14;WA38;Verschiedene Erzeugnisse der Chemischen Industrie;1674197;976522;697675
01.02.14;WA39;Kunststoffe und Waren daraus;4320723;2795779;1524944
01.02.14;WA40;Kautschuk und Waren daraus;1119859;1123106;-3247
01.02.14;WA41;Häute, Felle, Leder;93950;93681;269
01.02.14;WA42;Lederwaren, Sattlerwaren;145857;277026;-131169
01.02.14;WA43;Pelzfelle, künstliches Pelzwerk;12259;8778;3481
01.02.14;WA44;Holz, Holzwaren, Holzkohle;548431;564267;-15836
01.02.14;WA45;Kork, Korkwaren;2074;8850;-6776
01.02.14;WA46;Flechtwaren, Korbmacherwaren;2915;9142;-6227
01.02.14;WA47;Halbstoffe aus Holz usw., Papierabfall;98571;287390;-188819
01.02.14;WA48;Papier, Pappe und Waren daraus;1407572;971355;436217
01.02.14;WA49;Bücher, Zeitungen, Bilddrucke usw.;316843;153612;163231
01.02.14;WA50;Seide;4960;4846;114
01.02.14;WA51;Wolle, feine und grobe Tierhaare;41991;46562;-4571
01.02.14;WA52;Baumwolle;82584;78621;3963
01.02.14;WA53;Andere pflanzliche Spinnstoffe, Papiergarn;3720;5399;-1679
01.02.14;WA54;Synthetisches oder künstliches Filament;156784;126485;30299
01.02.14;WA55;Synthetische oder künstliche Spinnfaser;164108;125177;38931
01.02.14;WA56;Watte, Filz, Vliesstoff usw., Tauwerk;187121;96044;91077
01.02.14;WA57;Teppiche, Fussbodenbelag aus Spinnstoff;40625;87687;-47062
01.02.14;WA58;Spezialgewebe, Spitzen, Tapisserien;37238;22973;14265
01.02.14;WA59;Getränkte, bestrichene usw. Gewebe;167270;87496;79774
01.02.14;WA60;Gewirke und Gestricke;63285;33839;29446
01.02.14;WA61;Bekleidung usw. aus Gewirken, Gestricken;589113;1113801;-524688
01.02.14;WA62;Andere Bekleidung, Bekleidungszubehör;722671;1217587;-494916
01.02.14;WA63;Andere Konfektion, Spinnstoffwaren usw.;176417;258727;-82310
01.02.14;WA64;Schuhe, Gamaschen, ähnliche Waren;396585;751932;-355347
01.02.14;WA65;Kopfbedeckungen und Teile davon;27584;39395;-11811
01.02.14;WA66;Schirme, Gehstöcke usw., Peitschen;9992;28326;-18334
01.02.14;WA67;Zugerichtete Federn, Daunen, künstliche Blumen;8633;10772;-2139
01.02.14;WA68;Waren aus Steinen, Gips, Zement usw.;305881;198960;106921
01.02.14;WA69;Keramische Waren;237941;199118;38823
01.02.14;WA70;Glas und Glaswaren;439106;356750;82356
01.02.14;WA71;Perlen, Edelsteine, Edelmetalle;996211;1310261;-314050
01.02.14;WA72;Eisen und Stahl;1822868;1970039;-147171
01.02.14;WA73;Waren aus Eisen oder Stahl;2082507;1508171;574336
01.02.14;WA74;Kupfer und Waren daraus;881646;804663;76983
01.02.14;WA75;Nickel und Waren daraus;84740;109313;-24573
01.02.14;WA76;Aluminium und Waren daraus;1033373;1036836;-3463
01.02.14;WA78;Blei und Waren daraus;37548;26607;10941
01.02.14;WA79;Zink und Waren daraus;49754;87978;-38224
01.02.14;WA80;Zinn und Waren daraus;10644;38582;-27938
01.02.14;WA81;Andere unedle Metalle, Cermets usw.;108412;125176;-16764
01.02.14;WA82;Werkzeuge, Schneidwaren, Essbestecke;602559;357237;245322
01.02.14;WA83;Verschiedene Waren aus unedlen Metallen;553688;333841;219847
01.02.14;WA84;Maschinen, Apparate, mechanische Geräte;15306064;9059091;6246973
01.02.14;WA85;Elektrotechnische Erzeugnisse;8658617;7667104;991513
01.02.14;WA86;Schienenfahrzeuge;254415;152007;102408
01.02.14;WA87;Kraftfahrzeuge, Landfahrzeuge;16569270;6491950;10077320
01.02.14;WA88;Luftfahrzeuge, Raumfahrzeuge;2836660;2091677;744983
01.02.14;WA89;Wasserfahrzeuge;178255;62183;116072
01.02.14;WA90;Optische, photografische usw. Erzeugnisse;4176617;2301612;1875005
01.02.14;WA91;Uhrmacherwaren;134185;146877;-12692
01.02.14;WA92;Musikinstrumente;37595;37795;-200
01.02.14;WA93;Waffen und Munition;37051;14884;22167
01.02.14;WA94;Möbel, Beleuchtungskörper usw.;1137377;1365901;-228524
01.02.14;WA95;Spielzeug, Spiele usw., Sportgeräte;230894;358736;-127842
01.02.14;WA96;Verschiedene Waren;278785;183983;94802
01.02.14;WA97;Kunstgegenstände, Sammlungsstücke;35863;16504;19359
01.02.14;WA98;Vollständige Fabrikationsanlagen;201001;2164;198837
01.02.14;WA99;Zusammenstellungen verschiedener Waren;1384776;752092;632684
01.02.15;WA01;Lebende Tiere;108734;151109;-42375
01.02.15;WA02;Fleisch;547247;429553;117694
01.02.15;WA03;Fische, Krebs- und Weichtiere;109527;276125;-166598
01.02.15;WA04;Milch, Milcherzeugnisse, Eier, Honig;638612;507844;130768
01.02.15;WA05;Andere Waren tierischen Ursprungs;59932;69783;-9851
01.02.15;WA06;Pflanzen, Waren des Blumenhandels;63351;231263;-167912
01.02.15;WA07;Gemüse, Pflanzen für Ernährung;76745;460918;-384173
01.02.15;WA08;Geniessbare Früchte und Nüsse;143184;610062;-466878
01.02.15;WA09;Kaffee, Tee, Mate, Gewürze;207016;371221;-164205
01.02.15;WA10;Getreide;341520;266082;75438
01.02.15;WA11;Müllereierzeugnisse, Malz usw.;116896;39927;76969
01.02.15;WA12;Ölsamen usw., Heilpflanzen usw.;144193;341423;-197230
01.02.15;WA13;Schellack, Gummen, Harz, Pflanzensaft;44929;37762;7167
01.02.15;WA14;Flechtstoffe usw. pflanzlichen Ursprungs;759;2936;-2177
01.02.15;WA15;Tierische und pflanzliche Fette, Öle, Wachs;221336;264420;-43084
01.02.15;WA16;Zubereitungen von Fleisch, Fisch usw.;208260;169882;38378
01.02.15;WA17;Zucker und Zuckerwaren;133848;122875;10973
01.02.15;WA18;Kakao und Zubereitungen aus Kakao;396073;345180;50893
01.02.15;WA19;Zubereitungen aus Getreide usw., Backwaren;419282;285379;133903
01.02.15;WA20;Zubereitungen von Gemüse, Früchten usw.;182049;357832;-175783
01.02.15;WA21;Verschiedene Lebensmittelzubereitungen;393928;217881;176047
01.02.15;WA22;Getränke, alkoholhaltige Flüssigkeiten, Essig;358840;435366;-76526
01.02.15;WA23;Rückstände der Lebensmittelindustrie, Futter;313969;262122;51847
01.02.15;WA24;Tabak;333592;151835;181757
01.02.15;WA25;Salz, Schwefel, Steine, Erden usw.;148540;139915;8625
01.02.15;WA26;Erze, Schlacken, Aschen;21882;555050;-533168
01.02.15;WA27;Mineralische Brennstoffe usw.;2107522;7137563;-5030041
01.02.15;WA28;Anorganische chemische Erzeugnisse;651311;503633;147678
01.02.15;WA29;Organische chemische Erzeugnisse;1942870;2432782;-489912
01.02.15;WA30;Pharmazeutische Erzeugnisse;4851948;2906439;1945509
01.02.15;WA31;Düngemittel;240180;150526;89654
01.02.15;WA32;Gerb- und Farbstoffe, Farben, Lacke usw.;812485;471624;340861
01.02.15;WA33;Etherische Öle, Riech-, Schönheitsmittel;690951;482333;208618
01.02.15;WA34;Seifen, Waschmittel usw.;541543;274441;267102
01.02.15;WA35;Eiweissstoffe, Klebstoffe, Enzyme;247176;166573;80603
01.02.15;WA36;Sprengstoffe, pyrotechnische Artikel usw.;18603;13324;5279
01.02.15;WA37;Photochemische Erzeugnisse;88591;57917;30674
01.02.15;WA38;Verschiedene Erzeugnisse der Chemischen Industrie;1720931;1027931;693000
01.02.15;WA39;Kunststoffe und Waren daraus;4400844;2813862;1586982
01.02.15;WA40;Kautschuk und Waren daraus;1144746;1092386;52360
01.02.15;WA41;Häute, Felle, Leder;94067;72951;21116
01.02.15;WA42;Lederwaren, Sattlerwaren;152261;335547;-183286
01.02.15;WA43;Pelzfelle, künstliches Pelzwerk;10040;9575;465
01.02.15;WA44;Holz, Holzwaren, Holzkohle;554774;584583;-29809
01.02.15;WA45;Kork, Korkwaren;2132;6764;-4632
01.02.15;WA46;Flechtwaren, Korbmacherwaren;3675;11811;-8136
01.02.15;WA47;Halbstoffe aus Holz usw., Papierabfall;93846;283719;-189873
01.02.15;WA48;Papier, Pappe und Waren daraus;1334275;979984;354291
01.02.15;WA49;Bücher, Zeitungen, Bilddrucke usw.;330766;171187;159579
01.02.15;WA50;Seide;4340;4696;-356
01.02.15;WA51;Wolle, feine und grobe Tierhaare;45836;49064;-3228
01.02.15;WA52;Baumwolle;72752;74753;-2001
01.02.15;WA53;Andere pflanzliche Spinnstoffe, Papiergarn;3109;4881;-1772
01.02.15;WA54;Synthetisches oder künstliches Filament;158112;120097;38015
01.02.15;WA55;Synthetische oder künstliche Spinnfaser;154692;124559;30133
01.02.15;WA56;Watte, Filz, Vliesstoff usw., Tauwerk;189896;101857;88039
01.02.15;WA57;Teppiche, Fussbodenbelag aus Spinnstoff;45129;93347;-48218
01.02.15;WA58;Spezialgewebe, Spitzen, Tapisserien;37683;22510;15173
01.02.15;WA59;Getränkte, bestrichene usw. Gewebe;173825;92293;81532
01.02.15;WA60;Gewirke und Gestricke;62333;36543;25790
01.02.15;WA61;Bekleidung usw. aus Gewirken, Gestricken;592708;1219429;-626721
01.02.15;WA62;Andere Bekleidung, Bekleidungszubehör;725835;1396727;-670892
01.02.15;WA63;Andere Konfektion, Spinnstoffwaren usw.;193512;294509;-100997
01.02.15;WA64;Schuhe, Gamaschen, ähnliche Waren;482570;954973;-472403
01.02.15;WA65;Kopfbedeckungen und Teile davon;30947;46015;-15068
01.02.15;WA66;Schirme, Gehstöcke usw., Peitschen;9451;29883;-20432
01.02.15;WA67;Zugerichtete Federn, Daunen, künstliche Blumen;10346;14608;-4262
01.02.15;WA68;Waren aus Steinen, Gips, Zement usw.;311998;237087;74911
01.02.15;WA69;Keramische Waren;229040;195951;33089
01.02.15;WA70;Glas und Glaswaren;451758;374017;77741
01.02.15;WA71;Perlen, Edelsteine, Edelmetalle;1100593;1475869;-375276
01.02.15;WA72;Eisen und Stahl;1839506;1933477;-93971
01.02.15;WA73;Waren aus Eisen oder Stahl;2135617;1507469;628148
01.02.15;WA74;Kupfer und Waren daraus;808640;735882;72758
01.02.15;WA75;Nickel und Waren daraus;99655;131699;-32044
01.02.15;WA76;Aluminium und Waren daraus;1152958;1298235;-145277
01.02.15;WA78;Blei und Waren daraus;31786;26705;5081
01.02.15;WA79;Zink und Waren daraus;48905;95063;-46158
01.02.15;WA80;Zinn und Waren daraus;9809;28704;-18895
01.02.15;WA81;Andere unedle Metalle, Cermets usw.;121045;142960;-21915
01.02.15;WA82;Werkzeuge, Schneidwaren, Essbestecke;632416;390285;242131
01.02.15;WA83;Verschiedene Waren aus unedlen Metallen;573773;354079;219694
01.02.15;WA84;Maschinen, Apparate, mechanische Geräte;15626390;9437077;6189313
01.02.15;WA85;Elektrotechnische Erzeugnisse;9256905;8584002;672903
01.02.15;WA86;Schienenfahrzeuge;331052;198364;132688
01.02.15;WA87;Kraftfahrzeuge, Landfahrzeuge;17984380;7016488;10967892
01.02.15;WA88;Luftfahrzeuge, Raumfahrzeuge;3430707;2435070;995637
01.02.15;WA89;Wasserfahrzeuge;75301;41051;34250
01.02.15;WA90;Optische, photografische usw. Erzeugnisse;4303717;2532049;1771668
01.02.15;WA91;Uhrmacherwaren;164232;179872;-15640
01.02.15;WA92;Musikinstrumente;41651;40872;779
01.02.15;WA93;Waffen und Munition;30647;15786;14861
01.02.15;WA94;Möbel, Beleuchtungskörper usw.;1187084;1518043;-330959
01.02.15;WA95;Spielzeug, Spiele usw., Sportgeräte;287389;436649;-149260
01.02.15;WA96;Verschiedene Waren;273954;202029;71925
01.02.15;WA97;Kunstgegenstände, Sammlungsstücke;50635;41431;9204
01.02.15;WA98;Vollständige Fabrikationsanlagen;188489;2238;186251
01.02.15;WA99;Zusammenstellungen verschiedener Waren;1825426;791998;1033428
01.02.16;WA01;Lebende Tiere;109954;150809;-40855
01.02.16;WA02;Fleisch;558005;512340;45665
01.02.16;WA03;Fische, Krebs- und Weichtiere;122549;324193;-201644
01.02.16;WA04;Milch, Milcherzeugnisse, Eier, Honig;626434;558156;68278
01.02.16;WA05;Andere Waren tierischen Ursprungs;64275;66474;-2199
01.02.16;WA06;Pflanzen, Waren des Blumenhandels;63689;246725;-183036
01.02.16;WA07;Gemüse, Pflanzen für Ernährung;85936;522465;-436529
01.02.16;WA08;Geniessbare Früchte und Nüsse;149773;715236;-565463
01.02.16;WA09;Kaffee, Tee, Mate, Gewürze;208377;330317;-121940
01.02.16;WA10;Getreide;218299;256576;-38277
01.02.16;WA11;Müllereierzeugnisse, Malz usw.;121636;45082;76554
01.02.16;WA12;Ölsamen usw., Heilpflanzen usw.;163738;431409;-267671
01.02.16;WA13;Schellack, Gummen, Harz, Pflanzensaft;48040;45529;2511
01.02.16;WA14;Flechtstoffe usw. pflanzlichen Ursprungs;669;3423;-2754
01.02.16;WA15;Tierische und pflanzliche Fette, Öle, Wachs;240303;302883;-62580
01.02.16;WA16;Zubereitungen von Fleisch, Fisch usw.;232359;198016;34343
01.02.16;WA17;Zucker und Zuckerwaren;149324;140355;8969
01.02.16;WA18;Kakao und Zubereitungen aus Kakao;393273;362501;30772
01.02.16;WA19;Zubereitungen aus Getreide usw., Backwaren;452316;321812;130504
01.02.16;WA20;Zubereitungen von Gemüse, Früchten usw.;203966;370217;-166251
01.02.16;WA21;Verschiedene Lebensmittelzubereitungen;410470;255887;154583
01.02.16;WA22;Getränke, alkoholhaltige Flüssigkeiten, Essig;400010;474524;-74514
01.02.16;WA23;Rückstände der Lebensmittelindustrie, Futter;314433;301580;12853
01.02.16;WA24;Tabak;375005;160100;214905
01.02.16;WA25;Salz, Schwefel, Steine, Erden usw.;165490;153176;12314
01.02.16;WA26;Erze, Schlacken, Aschen;25386;461734;-436348
01.02.16;WA27;Mineralische Brennstoffe usw.;1714266;5238151;-3523885
01.02.16;WA28;Anorganische chemische Erzeugnisse;662636;478542;184094
01.02.16;WA29;Organische chemische Erzeugnisse;1909290;2569819;-660529
01.02.16;WA30;Pharmazeutische Erzeugnisse;5573479;3665824;1907655
01.02.16;WA31;Düngemittel;229508;155398;74110
01.02.16;WA32;Gerb- und Farbstoffe, Farben, Lacke usw.;896262;475989;420273
01.02.16;WA33;Etherische Öle, Riech-, Schönheitsmittel;744783;532343;212440
01.02.16;WA34;Seifen, Waschmittel usw.;587243;291116;296127
01.02.16;WA35;Eiweissstoffe, Klebstoffe, Enzyme;257963;166139;91824
01.02.16;WA36;Sprengstoffe, pyrotechnische Artikel usw.;19890;11622;8268
01.02.16;WA37;Photochemische Erzeugnisse;102428;63258;39170
01.02.16;WA38;Verschiedene Erzeugnisse der Chemischen Industrie;1826237;1108189;718048
01.02.16;WA39;Kunststoffe und Waren daraus;4672090;3074663;1597427
01.02.16;WA40;Kautschuk und Waren daraus;1182265;1143076;39189
01.02.16;WA41;Häute, Felle, Leder;91297;72438;18859
01.02.16;WA42;Lederwaren, Sattlerwaren;162718;348512;-185794
01.02.16;WA43;Pelzfelle, künstliches Pelzwerk;10483;8054;2429
01.02.16;WA44;Holz, Holzwaren, Holzkohle;609071;635228;-26157
01.02.16;WA45;Kork, Korkwaren;2420;9194;-6774
01.02.16;WA46;Flechtwaren, Korbmacherwaren;4536;12694;-8158
01.02.16;WA47;Halbstoffe aus Holz usw., Papierabfall;104121;324051;-219930
01.02.16;WA48;Papier, Pappe und Waren daraus;1458437;1035218;423219
01.02.16;WA49;Bücher, Zeitungen, Bilddrucke usw.;337013;223211;113802
01.02.16;WA50;Seide;4042;4235;-193
01.02.16;WA51;Wolle, feine und grobe Tierhaare;45832;48096;-2264
01.02.16;WA52;Baumwolle;73112;74883;-1771
01.02.16;WA53;Andere pflanzliche Spinnstoffe, Papiergarn;4388;6794;-2406
01.02.16;WA54;Synthetisches oder künstliches Filament;163156;127530;35626
01.02.16;WA55;Synthetische oder künstliche Spinnfaser;152113;132727;19386
01.02.16;WA56;Watte, Filz, Vliesstoff usw., Tauwerk;185667;113630;72037
01.02.16;WA57;Teppiche, Fussbodenbelag aus Spinnstoff;44978;99014;-54036
01.02.16;WA58;Spezialgewebe, Spitzen, Tapisserien;39628;23533;16095
01.02.16;WA59;Getränkte, bestrichene usw. Gewebe;196474;97076;99398
01.02.16;WA60;Gewirke und Gestricke;66160;37590;28570
01.02.16;WA61;Bekleidung usw. aus Gewirken, Gestricken;625687;1292058;-666371
01.02.16;WA62;Andere Bekleidung, Bekleidungszubehör;774625;1488874;-714249
01.02.16;WA63;Andere Konfektion, Spinnstoffwaren usw.;201191;336485;-135294
01.02.16;WA64;Schuhe, Gamaschen, ähnliche Waren;541303;1033215;-491912
01.02.16;WA65;Kopfbedeckungen und Teile davon;32734;51154;-18420
01.02.16;WA66;Schirme, Gehstöcke usw., Peitschen;16576;33423;-16847
01.02.16;WA67;Zugerichtete Federn, Daunen, künstliche Blumen;11092;16098;-5006
01.02.16;WA68;Waren aus Steinen, Gips, Zement usw.;349052;253576;95476
01.02.16;WA69;Keramische Waren;253917;234810;19107
01.02.16;WA70;Glas und Glaswaren;492306;417265;75041
01.02.16;WA71;Perlen, Edelsteine, Edelmetalle;803682;1081684;-278002
01.02.16;WA72;Eisen und Stahl;1583622;1727771;-144149
01.02.16;WA73;Waren aus Eisen oder Stahl;2091988;1620833;471155
01.02.16;WA74;Kupfer und Waren daraus;820959;792477;28482
01.02.16;WA75;Nickel und Waren daraus;81015;96891;-15876
01.02.16;WA76;Aluminium und Waren daraus;1122343;1260490;-138147
01.02.16;WA78;Blei und Waren daraus;28773;26631;2142
01.02.16;WA79;Zink und Waren daraus;46170;93887;-47717
01.02.16;WA80;Zinn und Waren daraus;9269;31652;-22383
01.02.16;WA81;Andere unedle Metalle, Cermets usw.;120438;131973;-11535
01.02.16;WA82;Werkzeuge, Schneidwaren, Essbestecke;646732;392446;254286
01.02.16;WA83;Verschiedene Waren aus unedlen Metallen;616652;381205;235447
01.02.16;WA84;Maschinen, Apparate, mechanische Geräte;16041929;10279265;5762664
01.02.16;WA85;Elektrotechnische Erzeugnisse;9676384;9450058;226326
01.02.16;WA86;Schienenfahrzeuge;304899;175177;129722
01.02.16;WA87;Kraftfahrzeuge, Landfahrzeuge;19202857;8235982;10966875
01.02.16;WA88;Luftfahrzeuge, Raumfahrzeuge;2885471;1839931;1045540
01.02.16;WA89;Wasserfahrzeuge;475959;152855;323104
01.02.16;WA90;Optische, photografische usw. Erzeugnisse;4547344;2860661;1686683
01.02.16;WA91;Uhrmacherwaren;154648;180261;-25613
01.02.16;WA92;Musikinstrumente;42004;44934;-2930
01.02.16;WA93;Waffen und Munition;40257;20694;19563
01.02.16;WA94;Möbel, Beleuchtungskörper usw.;1308538;1718315;-409777
01.02.16;WA95;Spielzeug, Spiele usw., Sportgeräte;328501;460539;-132038
01.02.16;WA96;Verschiedene Waren;301521;227363;74158
01.02.16;WA97;Kunstgegenstände, Sammlungsstücke;66916;47981;18935
01.02.16;WA98;Vollständige Fabrikationsanlagen;219874;902;218972
01.02.16;WA99;Zusammenstellungen verschiedener Waren;1662666;838975;823691
01.02.17;WA01;Lebende Tiere;99931;161804;-61873
01.02.17;WA02;Fleisch;598203;479851;118352
01.02.17;WA03;Fische, Krebs- und Weichtiere;118404;326706;-208302
01.02.17;WA04;Milch, Milcherzeugnisse, Eier, Honig;683716;597644;86072
01.02.17;WA05;Andere Waren tierischen Ursprungs;63426;74692;-11266
01.02.17;WA06;Pflanzen, Waren des Blumenhandels;67809;250928;-183119
01.02.17;WA07;Gemüse, Pflanzen für Ernährung;92352;655979;-563627
01.02.17;WA08;Geniessbare Früchte und Nüsse;156018;698227;-542209
01.02.17;WA09;Kaffee, Tee, Mate, Gewürze;247081;364106;-117025
01.02.17;WA10;Getreide;190634;227874;-37240
01.02.17;WA11;Müllereierzeugnisse, Malz usw.;112948;41504;71444
01.02.17;WA12;Ölsamen usw., Heilpflanzen usw.;191109;402479;-211370
01.02.17;WA13;Schellack, Gummen, Harz, Pflanzensaft;51409;39119;12290
01.02.17;WA14;Flechtstoffe usw. pflanzlichen Ursprungs;574;2970;-2396
01.02.17;WA15;Tierische und pflanzliche Fette, Öle, Wachs;237588;336168;-98580
01.02.17;WA16;Zubereitungen von Fleisch, Fisch usw.;218962;191283;27679
01.02.17;WA17;Zucker und Zuckerwaren;161714;136126;25588
01.02.17;WA18;Kakao und Zubereitungen aus Kakao;415138;374632;40506
01.02.17;WA19;Zubereitungen aus Getreide usw., Backwaren;480145;322217;157928
01.02.17;WA20;Zubereitungen von Gemüse, Früchten usw.;227639;371460;-143821
01.02.17;WA21;Verschiedene Lebensmittelzubereitungen;431499;256042;175457
01.02.17;WA22;Getränke, alkoholhaltige Flüssigkeiten, Essig;416181;492410;-76229
01.02.17;WA23;Rückstände der Lebensmittelindustrie, Futter;296038;282353;13685
01.02.17;WA24;Tabak;332218;145576;186642
01.02.17;WA25;Salz, Schwefel, Steine, Erden usw.;163089;137186;25903
01.02.17;WA26;Erze, Schlacken, Aschen;35506;630470;-594964
01.02.17;WA27;Mineralische Brennstoffe usw.;2075041;7062722;-4987681
01.02.17;WA28;Anorganische chemische Erzeugnisse;696822;466532;230290
01.02.17;WA29;Organische chemische Erzeugnisse;1938924;2408809;-469885
01.02.17;WA30;Pharmazeutische Erzeugnisse;5910681;3860780;2049901
01.02.17;WA31;Düngemittel;206896;121967;84929
01.02.17;WA32;Gerb- und Farbstoffe, Farben, Lacke usw.;924037;427885;496152
01.02.17;WA33;Etherische Öle, Riech-, Schönheitsmittel;734331;545361;188970
01.02.17;WA34;Seifen, Waschmittel usw.;588851;307508;281343
01.02.17;WA35;Eiweissstoffe, Klebstoffe, Enzyme;258947;164842;94105
01.02.17;WA36;Sprengstoffe, pyrotechnische Artikel usw.;17677;12342;5335
01.02.17;WA37;Photochemische Erzeugnisse;100960;70499;30461
01.02.17;WA38;Verschiedene Erzeugnisse der Chemischen Industrie;1979046;1055173;923873
01.02.17;WA39;Kunststoffe und Waren daraus;4797840;3093825;1704015
01.02.17;WA40;Kautschuk und Waren daraus;1209708;1110375;99333
01.02.17;WA41;Häute, Felle, Leder;79473;69430;10043
01.02.17;WA42;Lederwaren, Sattlerwaren;173036;326022;-152986
01.02.17;WA43;Pelzfelle, künstliches Pelzwerk;13006;10153;2853
01.02.17;WA44;Holz, Holzwaren, Holzkohle;603053;617503;-14450
01.02.17;WA45;Kork, Korkwaren;2313;8434;-6121
01.02.17;WA46;Flechtwaren, Korbmacherwaren;4974;9527;-4553
01.02.17;WA47;Halbstoffe aus Holz usw., Papierabfall;108260;286106;-177846
01.02.17;WA48;Papier, Pappe und Waren daraus;1380605;962745;417860
01.02.17;WA49;Bücher, Zeitungen, Bilddrucke usw.;329572;190665;138907
01.02.17;WA50;Seide;3860;4231;-371
01.02.17;WA51;Wolle, feine und grobe Tierhaare;48220;54703;-6483
01.02.17;WA52;Baumwolle;68428;73740;-5312
01.02.17;WA53;Andere pflanzliche Spinnstoffe, Papiergarn;3014;5228;-2214
01.02.17;WA54;Synthetisches oder künstliches Filament;157698;123634;34064
01.02.17;WA55;Synthetische oder künstliche Spinnfaser;142728;119303;23425
01.02.17;WA56;Watte, Filz, Vliesstoff usw., Tauwerk;200970;113797;87173
01.02.17;WA57;Teppiche, Fussbodenbelag aus Spinnstoff;47778;87243;-39465
01.02.17;WA58;Spezialgewebe, Spitzen, Tapisserien;42514;22021;20493
01.02.17;WA59;Getränkte, bestrichene usw. Gewebe;199517;94349;105168
01.02.17;WA60;Gewirke und Gestricke;68789;37339;31450
01.02.17;WA61;Bekleidung usw. aus Gewirken, Gestricken;658096;1295002;-636906
01.02.17;WA62;Andere Bekleidung, Bekleidungszubehör;789107;1410601;-621494
01.02.17;WA63;Andere Konfektion, Spinnstoffwaren usw.;191998;290586;-98588
01.02.17;WA64;Schuhe, Gamaschen, ähnliche Waren;594583;996326;-401743
01.02.17;WA65;Kopfbedeckungen und Teile davon;30595;49345;-18750
01.02.17;WA66;Schirme, Gehstöcke usw., Peitschen;8054;27473;-19419
01.02.17;WA67;Zugerichtete Federn, Daunen, künstliche Blumen;11108;14973;-3865
01.02.17;WA68;Waren aus Steinen, Gips, Zement usw.;354167;244507;109660
01.02.17;WA69;Keramische Waren;248405;212201;36204
01.02.17;WA70;Glas und Glaswaren;500522;412480;88042
01.02.17;WA71;Perlen, Edelsteine, Edelmetalle;872127;1361101;-488974
01.02.17;WA72;Eisen und Stahl;1863812;2022594;-158782
01.02.17;WA73;Waren aus Eisen oder Stahl;2132038;1581050;550988
01.02.17;WA74;Kupfer und Waren daraus;994315;815048;179267
01.02.17;WA75;Nickel und Waren daraus;78789;100948;-22159
01.02.17;WA76;Aluminium und Waren daraus;1131887;1314447;-182560
01.02.17;WA78;Blei und Waren daraus;30339;33580;-3241
01.02.17;WA79;Zink und Waren daraus;56362;126388;-70026
01.02.17;WA80;Zinn und Waren daraus;10850;38747;-27897
01.02.17;WA81;Andere unedle Metalle, Cermets usw.;123406;156978;-33572
01.02.17;WA82;Werkzeuge, Schneidwaren, Essbestecke;674094;386872;287222
01.02.17;WA83;Verschiedene Waren aus unedlen Metallen;598909;374799;224110
01.02.17;WA84;Maschinen, Apparate, mechanische Geräte;17284323;10226865;7057458
01.02.17;WA85;Elektrotechnische Erzeugnisse;10515307;9871782;643525
01.02.17;WA86;Schienenfahrzeuge;438656;194623;244033
01.02.17;WA87;Kraftfahrzeuge, Landfahrzeuge;18735404;8901983;9833421
01.02.17;WA88;Luftfahrzeuge, Raumfahrzeuge;3160570;1503608;1656962
01.02.17;WA89;Wasserfahrzeuge;116279;182402;-66123
01.02.17;WA90;Optische, photografische usw. Erzeugnisse;4979783;2772768;2207015
01.02.17;WA91;Uhrmacherwaren;126931;138384;-11453
01.02.17;WA92;Musikinstrumente;40790;38183;2607
01.02.17;WA93;Waffen und Munition;43777;20026;23751
01.02.17;WA94;Möbel, Beleuchtungskörper usw.;1208935;1480825;-271890
01.02.17;WA95;Spielzeug, Spiele usw., Sportgeräte;318893;426000;-107107
01.02.17;WA96;Verschiedene Waren;299540;217327;82213
01.02.17;WA97;Kunstgegenstände, Sammlungsstücke;68683;29155;39528
01.02.17;WA98;Vollständige Fabrikationsanlagen;187821;0;187821
01.02.17;WA99;Zusammenstellungen verschiedener Waren;1712266;954575;757691
01.02.18;WA01;Lebende Tiere;114376;136194;-21818
01.02.18;WA02;Fleisch;584028;502650;81378
01.02.18;WA03;Fische, Krebs- und Weichtiere;120736;290116;-169380
01.02.18;WA04;Milch, Milcherzeugnisse, Eier, Honig;677209;640835;36374
01.02.18;WA05;Andere Waren tierischen Ursprungs;71014;79871;-8857
01.02.18;WA06;Pflanzen, Waren des Blumenhandels;70736;283957;-213221
01.02.18;WA07;Gemüse, Pflanzen für Ernährung;79247;582571;-503324
01.02.18;WA08;Geniessbare Früchte und Nüsse;156882;792520;-635638
01.02.18;WA09;Kaffee, Tee, Mate, Gewürze;216226;309993;-93767
01.02.18;WA10;Getreide;156477;228796;-72319
01.02.18;WA11;Müllereierzeugnisse, Malz usw.;127198;49091;78107
01.02.18;WA12;Ölsamen usw., Heilpflanzen usw.;202519;430015;-227496
01.02.18;WA13;Schellack, Gummen, Harz, Pflanzensaft;51541;47955;3586
01.02.18;WA14;Flechtstoffe usw. pflanzlichen Ursprungs;731;3868;-3137
01.02.18;WA15;Tierische und pflanzliche Fette, Öle, Wachs;196561;293540;-96979
01.02.18;WA16;Zubereitungen von Fleisch, Fisch usw.;239315;242343;-3028
01.02.18;WA17;Zucker und Zuckerwaren;167181;130825;36356
01.02.18;WA18;Kakao und Zubereitungen aus Kakao;486281;379552;106729
01.02.18;WA19;Zubereitungen aus Getreide usw., Backwaren;504604;339826;164778
01.02.18;WA20;Zubereitungen von Gemüse, Früchten usw.;225814;383476;-157662
01.02.18;WA21;Verschiedene Lebensmittelzubereitungen;451097;275186;175911
01.02.18;WA22;Getränke, alkoholhaltige Flüssigkeiten, Essig;419028;506220;-87192
01.02.18;WA23;Rückstände der Lebensmittelindustrie, Futter;325488;292792;32696
01.02.18;WA24;Tabak;344920;155513;189407
01.02.18;WA25;Salz, Schwefel, Steine, Erden usw.;155342;155935;-593
01.02.18;WA26;Erze, Schlacken, Aschen;42431;817200;-774769
01.02.18;WA27;Mineralische Brennstoffe usw.;2355617;7741384;-5385767
01.02.18;WA28;Anorganische chemische Erzeugnisse;740349;628314;112035
01.02.18;WA29;Organische chemische Erzeugnisse;2159906;2937441;-777535
01.02.18;WA30;Pharmazeutische Erzeugnisse;6654044;3940131;2713913
01.02.18;WA31;Düngemittel;181839;96734;85105
01.02.18;WA32;Gerb- und Farbstoffe, Farben, Lacke usw.;965955;462432;503523
01.02.18;WA33;Etherische Öle, Riech-, Schönheitsmittel;776502;569442;207060
01.02.18;WA34;Seifen, Waschmittel usw.;632565;328780;303785
01.02.18;WA35;Eiweissstoffe, Klebstoffe, Enzyme;280419;175331;105088
01.02.18;WA36;Sprengstoffe, pyrotechnische Artikel usw.;23116;13608;9508
01.02.18;WA37;Photochemische Erzeugnisse;97766;77049;20717
01.02.18;WA38;Verschiedene Erzeugnisse der Chemischen Industrie;2002457;1110082;892375
01.02.18;WA39;Kunststoffe und Waren daraus;5125603;3401022;1724581
01.02.18;WA40;Kautschuk und Waren daraus;1222014;1179958;42056
01.02.18;WA41;Häute, Felle, Leder;76648;60186;16462
01.02.18;WA42;Lederwaren, Sattlerwaren;182774;324443;-141669
01.02.18;WA43;Pelzfelle, künstliches Pelzwerk;11346;11688;-342
01.02.18;WA44;Holz, Holzwaren, Holzkohle;650249;648753;1496
01.02.18;WA45;Kork, Korkwaren;2363;8681;-6318
01.02.18;WA46;Flechtwaren, Korbmacherwaren;4185;9577;-5392
01.02.18;WA47;Halbstoffe aus Holz usw., Papierabfall;95787;325352;-229565
01.02.18;WA48;Papier, Pappe und Waren daraus;1532570;1012328;520242
01.02.18;WA49;Bücher, Zeitungen, Bilddrucke usw.;339363;195778;143585
01.02.18;WA50;Seide;3598;3966;-368
01.02.18;WA51;Wolle, feine und grobe Tierhaare;43692;49249;-5557
01.02.18;WA52;Baumwolle;68856;76558;-7702
01.02.18;WA53;Andere pflanzliche Spinnstoffe, Papiergarn;3257;5758;-2501
01.02.18;WA54;Synthetisches oder künstliches Filament;161390;126558;34832
01.02.18;WA55;Synthetische oder künstliche Spinnfaser;148613;120754;27859
01.02.18;WA56;Watte, Filz, Vliesstoff usw., Tauwerk;211110;120560;90550
01.02.18;WA57;Teppiche, Fussbodenbelag aus Spinnstoff;48222;91971;-43749
01.02.18;WA58;Spezialgewebe, Spitzen, Tapisserien;44170;21987;22183
01.02.18;WA59;Getränkte, bestrichene usw. Gewebe;215601;95033;120568
01.02.18;WA60;Gewirke und Gestricke;63123;36887;26236
01.02.18;WA61;Bekleidung usw. aus Gewirken, Gestricken;764140;1297614;-533474
01.02.18;WA62;Andere Bekleidung, Bekleidungszubehör;902032;1412552;-510520
01.02.18;WA63;Andere Konfektion, Spinnstoffwaren usw.;204465;317262;-112797
01.02.18;WA64;Schuhe, Gamaschen, ähnliche Waren;647963;1055297;-407334
01.02.18;WA65;Kopfbedeckungen und Teile davon;44302;51415;-7113
01.02.18;WA66;Schirme, Gehstöcke usw., Peitschen;9411;30045;-20634
01.02.18;WA67;Zugerichtete Federn, Daunen, künstliche Blumen;12213;16767;-4554
01.02.18;WA68;Waren aus Steinen, Gips, Zement usw.;387891;263758;124133
01.02.18;WA69;Keramische Waren;267577;234775;32802
01.02.18;WA70;Glas und Glaswaren;530105;433121;96984
01.02.18;WA71;Perlen, Edelsteine, Edelmetalle;901119;1140047;-238928
01.02.18;WA72;Eisen und Stahl;2065762;2379411;-313649
01.02.18;WA73;Waren aus Eisen oder Stahl;2347462;1743508;603954
01.02.18;WA74;Kupfer und Waren daraus;891663;857247;34416
01.02.18;WA75;Nickel und Waren daraus;95864;130435;-34571
01.02.18;WA76;Aluminium und Waren daraus;1253878;1399589;-145711
01.02.18;WA78;Blei und Waren daraus;41954;41836;118
01.02.18;WA79;Zink und Waren daraus;72553;122500;-49947
01.02.18;WA80;Zinn und Waren daraus;11490;34879;-23389
01.02.18;WA81;Andere unedle Metalle, Cermets usw.;134959;172006;-37047
01.02.18;WA82;Werkzeuge, Schneidwaren, Essbestecke;700281;423523;276758
01.02.18;WA83;Verschiedene Waren aus unedlen Metallen;638711;408968;229743
01.02.18;WA84;Maschinen, Apparate, mechanische Geräte;18226535;10726252;7500283
01.02.18;WA85;Elektrotechnische Erzeugnisse;10572782;10083474;489308
01.02.18;WA86;Schienenfahrzeuge;404495;239179;165316
01.02.18;WA87;Kraftfahrzeuge, Landfahrzeuge;18745296;8895676;9849620
01.02.18;WA88;Luftfahrzeuge, Raumfahrzeuge;1612263;1222112;390151
01.02.18;WA89;Wasserfahrzeuge;192299;225184;-32885
01.02.18;WA90;Optische, photografische usw. Erzeugnisse;5113824;2882162;2231662
01.02.18;WA91;Uhrmacherwaren;129991;147608;-17617
01.02.18;WA92;Musikinstrumente;48946;46319;2627
01.02.18;WA93;Waffen und Munition;37237;17530;19707
01.02.18;WA94;Möbel, Beleuchtungskörper usw.;1278302;1614371;-336069
01.02.18;WA95;Spielzeug, Spiele usw., Sportgeräte;335432;491115;-155683
01.02.18;WA96;Verschiedene Waren;320963;223612;97351
01.02.18;WA97;Kunstgegenstände, Sammlungsstücke;76770;39475;37295
01.02.18;WA98;Vollständige Fabrikationsanlagen;100187;76;100111
01.02.18;WA99;Zusammenstellungen verschiedener Waren;1287875;926968;360907
01.02.19;WA01;Lebende Tiere;117121;143455;-26334
01.02.19;WA02;Fleisch;555636;473039;82597
01.02.19;WA03;Fische, Krebs- und Weichtiere;109149;318051;-208902
01.02.19;WA04;Milch, Milcherzeugnisse, Eier, Honig;728920;644750;84170
01.02.19;WA05;Andere Waren tierischen Ursprungs;75685;84097;-8412
01.02.19;WA06;Pflanzen, Waren des Blumenhandels;73187;273711;-200524
01.02.19;WA07;Gemüse, Pflanzen für Ernährung;101935;644494;-542559
01.02.19;WA08;Geniessbare Früchte und Nüsse;142888;757954;-615066
01.02.19;WA09;Kaffee, Tee, Mate, Gewürze;216094;300152;-84058
01.02.19;WA10;Getreide;167143;302923;-135780
01.02.19;WA11;Müllereierzeugnisse, Malz usw.;128253;59803;68450
01.02.19;WA12;Ölsamen usw., Heilpflanzen usw.;170377;435028;-264651
01.02.19;WA13;Schellack, Gummen, Harz, Pflanzensaft;60030;50441;9589
01.02.19;WA14;Flechtstoffe usw. pflanzlichen Ursprungs;811;4200;-3389
01.02.19;WA15;Tierische und pflanzliche Fette, Öle, Wachs;189978;279322;-89344
01.02.19;WA16;Zubereitungen von Fleisch, Fisch usw.;264702;228396;36306
01.02.19;WA17;Zucker und Zuckerwaren;174944;152574;22370
01.02.19;WA18;Kakao und Zubereitungen aus Kakao;451032;371099;79933
01.02.19;WA19;Zubereitungen aus Getreide usw., Backwaren;506345;356930;149415
01.02.19;WA20;Zubereitungen von Gemüse, Früchten usw.;225989;379825;-153836
01.02.19;WA21;Verschiedene Lebensmittelzubereitungen;482316;294259;188057
01.02.19;WA22;Getränke, alkoholhaltige Flüssigkeiten, Essig;441419;525951;-84532
01.02.19;WA23;Rückstände der Lebensmittelindustrie, Futter;340092;346225;-6133
01.02.19;WA24;Tabak;267556;161942;105614
01.02.19;WA25;Salz, Schwefel, Steine, Erden usw.;165258;154609;10649
01.02.19;WA26;Erze, Schlacken, Aschen;34463;769413;-734950
01.02.19;WA27;Mineralische Brennstoffe usw.;2646730;8720249;-6073519
01.02.19;WA28;Anorganische chemische Erzeugnisse;813924;566108;247816
01.02.19;WA29;Organische chemische Erzeugnisse;2218565;3402718;-1184153
01.02.19;WA30;Pharmazeutische Erzeugnisse;6186177;4088982;2097195
01.02.19;WA31;Düngemittel;217563;95584;121979
01.02.19;WA32;Gerb- und Farbstoffe, Farben, Lacke usw.;938881;547237;391644
01.02.19;WA33;Etherische Öle, Riech-, Schönheitsmittel;846064;605286;240778
01.02.19;WA34;Seifen, Waschmittel usw.;623287;330935;292352
01.02.19;WA35;Eiweissstoffe, Klebstoffe, Enzyme;274637;185747;88890
01.02.19;WA36;Sprengstoffe, pyrotechnische Artikel usw.;21972;11015;10957
01.02.19;WA37;Photochemische Erzeugnisse;102500;72606;29894
01.02.19;WA38;Verschiedene Erzeugnisse der Chemischen Industrie;2171543;1264234;907309
01.02.19;WA39;Kunststoffe und Waren daraus;5081754;3462230;1619524
01.02.19;WA40;Kautschuk und Waren daraus;1247960;1168535;79425
01.02.19;WA41;Häute, Felle, Leder;65691;53815;11876
01.02.19;WA42;Lederwaren, Sattlerwaren;186560;335331;-148771
01.02.19;WA43;Pelzfelle, künstliches Pelzwerk;7050;7293;-243
01.02.19;WA44;Holz, Holzwaren, Holzkohle;707232;683516;23716
01.02.19;WA45;Kork, Korkwaren;2601;8816;-6215
01.02.19;WA46;Flechtwaren, Korbmacherwaren;4076;12558;-8482
01.02.19;WA47;Halbstoffe aus Holz usw., Papierabfall;113181;306070;-192889
01.02.19;WA48;Papier, Pappe und Waren daraus;1525512;992683;532829
01.02.19;WA49;Bücher, Zeitungen, Bilddrucke usw.;324028;214164;109864
01.02.19;WA50;Seide;2598;2301;297
01.02.19;WA51;Wolle, feine und grobe Tierhaare;43041;52180;-9139
01.02.19;WA52;Baumwolle;60940;62028;-1088
01.02.19;WA53;Andere pflanzliche Spinnstoffe, Papiergarn;4018;5713;-1695
01.02.19;WA54;Synthetisches oder künstliches Filament;156322;130967;25355
01.02.19;WA55;Synthetische oder künstliche Spinnfaser;144574;127376;17198
01.02.19;WA56;Watte, Filz, Vliesstoff usw., Tauwerk;206603;124716;81887
01.02.19;WA57;Teppiche, Fussbodenbelag aus Spinnstoff;49992;93560;-43568
01.02.19;WA58;Spezialgewebe, Spitzen, Tapisserien;44341;21077;23264
01.02.19;WA59;Getränkte, bestrichene usw. Gewebe;206356;97980;108376
01.02.19;WA60;Gewirke und Gestricke;58723;34093;24630
01.02.19;WA61;Bekleidung usw. aus Gewirken, Gestricken;737434;1315091;-577657
01.02.19;WA62;Andere Bekleidung, Bekleidungszubehör;874321;1430648;-556327
01.02.19;WA63;Andere Konfektion, Spinnstoffwaren usw.;209988;327216;-117228
01.02.19;WA64;Schuhe, Gamaschen, ähnliche Waren;673289;1009202;-335913
01.02.19;WA65;Kopfbedeckungen und Teile davon;35357;58107;-22750
01.02.19;WA66;Schirme, Gehstöcke usw., Peitschen;8714;32822;-24108
01.02.19;WA67;Zugerichtete Federn, Daunen, künstliche Blumen;14305;18800;-4495
01.02.19;WA68;Waren aus Steinen, Gips, Zement usw.;395478;279969;115509
01.02.19;WA69;Keramische Waren;302496;244128;58368
01.02.19;WA70;Glas und Glaswaren;560524;445732;114792
01.02.19;WA71;Perlen, Edelsteine, Edelmetalle;967894;1268147;-300253
01.02.19;WA72;Eisen und Stahl;1872311;2258269;-385958
01.02.19;WA73;Waren aus Eisen oder Stahl;2388051;1844489;543562
01.02.19;WA74;Kupfer und Waren daraus;999757;800237;199520
01.02.19;WA75;Nickel und Waren daraus;121831;137793;-15962
01.02.19;WA76;Aluminium und Waren daraus;1240439;1370439;-130000
01.02.19;WA78;Blei und Waren daraus;36879;46905;-10026
01.02.19;WA79;Zink und Waren daraus;65612;114552;-48940
01.02.19;WA80;Zinn und Waren daraus;9458;33893;-24435
01.02.19;WA81;Andere unedle Metalle, Cermets usw.;142198;157685;-15487
01.02.19;WA82;Werkzeuge, Schneidwaren, Essbestecke;746973;437995;308978
01.02.19;WA83;Verschiedene Waren aus unedlen Metallen;615804;409381;206423
01.02.19;WA84;Maschinen, Apparate, mechanische Geräte;18955134;11728262;7226872
01.02.19;WA85;Elektrotechnische Erzeugnisse;11328845;10788418;540427
01.02.19;WA86;Schienenfahrzeuge;306843;249896;56947
01.02.19;WA87;Kraftfahrzeuge, Landfahrzeuge;19091768;9922485;9169283
01.02.19;WA88;Luftfahrzeuge, Raumfahrzeuge;2874522;1189216;1685306
01.02.19;WA89;Wasserfahrzeuge;411615;44230;367385
01.02.19;WA90;Optische, photografische usw. Erzeugnisse;5627184;3112173;2515011
01.02.19;WA91;Uhrmacherwaren;122243;132115;-9872
01.02.19;WA92;Musikinstrumente;50418;47880;2538
01.02.19;WA93;Waffen und Munition;36663;17922;18741
01.02.19;WA94;Möbel, Beleuchtungskörper usw.;1307632;1626437;-318805
01.02.19;WA95;Spielzeug, Spiele usw., Sportgeräte;331426;510489;-179063
01.02.19;WA96;Verschiedene Waren;323051;226544;96507
01.02.19;WA97;Kunstgegenstände, Sammlungsstücke;39184;34261;4923
01.02.19;WA98;Vollständige Fabrikationsanlagen;125809;1259;124550
01.02.19;WA99;Zusammenstellungen verschiedener Waren;1389005;1013785;375220
01.02.20;WA01;Lebende Tiere;114978;156349;-41371
01.02.20;WA02;Fleisch;718920;563155;155765
01.02.20;WA03;Fische, Krebs- und Weichtiere;116481;327887;-211406
01.02.20;WA04;Milch, Milcherzeugnisse, Eier, Honig;816202;662512;153690
01.02.20;WA05;Andere Waren tierischen Ursprungs;75832;72188;3644
01.02.20;WA06;Pflanzen, Waren des Blumenhandels;72697;250067;-177370
01.02.20;WA07;Gemüse, Pflanzen für Ernährung;100466;645974;-545508
01.02.20;WA08;Geniessbare Früchte und Nüsse;167324;858231;-690907
01.02.20;WA09;Kaffee, Tee, Mate, Gewürze;225205;295453;-70248
01.02.20;WA10;Getreide;265163;267600;-2437
01.02.20;WA11;Müllereierzeugnisse, Malz usw.;137312;53766;83546
01.02.20;WA12;Ölsamen usw., Heilpflanzen usw.;161349;507117;-345768
01.02.20;WA13;Schellack, Gummen, Harz, Pflanzensaft;60742;50826;9916
01.02.20;WA14;Flechtstoffe usw. pflanzlichen Ursprungs;825;4169;-3344
01.02.20;WA15;Tierische und pflanzliche Fette, Öle, Wachs;220358;318102;-97744
01.02.20;WA16;Zubereitungen von Fleisch, Fisch usw.;293590;279704;13886
01.02.20;WA17;Zucker und Zuckerwaren;187753;126809;60944
01.02.20;WA18;Kakao und Zubereitungen aus Kakao;477647;371597;106050
01.02.20;WA19;Zubereitungen aus Getreide usw., Backwaren;534261;363326;170935
01.02.20;WA20;Zubereitungen von Gemüse, Früchten usw.;257247;420437;-163190
01.02.20;WA21;Verschiedene Lebensmittelzubereitungen;506696;307087;199609
01.02.20;WA22;Getränke, alkoholhaltige Flüssigkeiten, Essig;429326;574280;-144954
01.02.20;WA23;Rückstände der Lebensmittelindustrie, Futter;393283;316530;76753
01.02.20;WA24;Tabak;209329;174962;34367
01.02.20;WA25;Salz, Schwefel, Steine, Erden usw.;161760;139219;22541
01.02.20;WA26;Erze, Schlacken, Aschen;49034;733699;-684665
01.02.20;WA27;Mineralische Brennstoffe usw.;2548929;7484902;-4935973
01.02.20;WA28;Anorganische chemische Erzeugnisse;996504;436275;560229
01.02.20;WA29;Organische chemische Erzeugnisse;2095790;2649218;-553428
01.02.20;WA30;Pharmazeutische Erzeugnisse;6904339;4845649;2058690
01.02.20;WA31;Düngemittel;200438;100715;99723
01.02.20;WA32;Gerb- und Farbstoffe, Farben, Lacke usw.;994829;474565;520264
01.02.20;WA33;Etherische Öle, Riech-, Schönheitsmittel;802516;561770;240746
01.02.20;WA34;Seifen, Waschmittel usw.;657293;338614;318679
01.02.20;WA35;Eiweissstoffe, Klebstoffe, Enzyme;293140;190730;102410
01.02.20;WA36;Sprengstoffe, pyrotechnische Artikel usw.;23057;11655;11402
01.02.20;WA37;Photochemische Erzeugnisse;91838;70535;21303
01.02.20;WA38;Verschiedene Erzeugnisse der Chemischen Industrie;2067903;1234654;833249
01.02.20;WA39;Kunststoffe und Waren daraus;5044936;3188938;1855998
01.02.20;WA40;Kautschuk und Waren daraus;1242407;1079462;162945
01.02.20;WA41;Häute, Felle, Leder;64635;52920;11715
01.02.20;WA42;Lederwaren, Sattlerwaren;204867;360642;-155775
01.02.20;WA43;Pelzfelle, künstliches Pelzwerk;7602;8704;-1102
01.02.20;WA44;Holz, Holzwaren, Holzkohle;725581;634781;90800
01.02.20;WA45;Kork, Korkwaren;2346;8683;-6337
01.02.20;WA46;Flechtwaren, Korbmacherwaren;4519;9801;-5282
01.02.20;WA47;Halbstoffe aus Holz usw., Papierabfall;86119;229348;-143229
01.02.20;WA48;Papier, Pappe und Waren daraus;1503894;924733;579161
01.02.20;WA49;Bücher, Zeitungen, Bilddrucke usw.;310029;195790;114239
01.02.20;WA50;Seide;3523;2980;543
01.02.20;WA51;Wolle, feine und grobe Tierhaare;40959;45759;-4800
01.02.20;WA52;Baumwolle;61557;57828;3729
01.02.20;WA53;Andere pflanzliche Spinnstoffe, Papiergarn;3832;5754;-1922
01.02.20;WA54;Synthetisches oder künstliches Filament;146734;120730;26004
01.02.20;WA55;Synthetische oder künstliche Spinnfaser;144171;111663;32508
01.02.20;WA56;Watte, Filz, Vliesstoff usw., Tauwerk;208257;126069;82188
01.02.20;WA57;Teppiche, Fussbodenbelag aus Spinnstoff;48739;89814;-41075
01.02.20;WA58;Spezialgewebe, Spitzen, Tapisserien;44306;20512;23794
01.02.20;WA59;Getränkte, bestrichene usw. Gewebe;200761;93082;107679
01.02.20;WA60;Gewirke und Gestricke;62792;37348;25444
01.02.20;WA61;Bekleidung usw. aus Gewirken, Gestricken;797794;1296252;-498458
01.02.20;WA62;Andere Bekleidung, Bekleidungszubehör;958186;1396068;-437882
01.02.20;WA63;Andere Konfektion, Spinnstoffwaren usw.;267999;318642;-50643
01.02.20;WA64;Schuhe, Gamaschen, ähnliche Waren;729127;1126960;-397833
01.02.20;WA65;Kopfbedeckungen und Teile davon;42409;64722;-22313
01.02.20;WA66;Schirme, Gehstöcke usw., Peitschen;7338;24814;-17476
01.02.20;WA67;Zugerichtete Federn, Daunen, künstliche Blumen;14157;16838;-2681
01.02.20;WA68;Waren aus Steinen, Gips, Zement usw.;411869;282703;129166
01.02.20;WA69;Keramische Waren;276040;234376;41664
01.02.20;WA70;Glas und Glaswaren;535241;423281;111960
01.02.20;WA71;Perlen, Edelsteine, Edelmetalle;1633735;1886110;-252375
01.02.20;WA72;Eisen und Stahl;1886214;1864295;21919
01.02.20;WA73;Waren aus Eisen oder Stahl;2338773;1704635;634138
01.02.20;WA74;Kupfer und Waren daraus;910074;727768;182306
01.02.20;WA75;Nickel und Waren daraus;120169;138696;-18527
01.02.20;WA76;Aluminium und Waren daraus;1209052;1278344;-69292
01.02.20;WA78;Blei und Waren daraus;34090;31956;2134
01.02.20;WA79;Zink und Waren daraus;55631;101898;-46267
01.02.20;WA80;Zinn und Waren daraus;7264;29028;-21764
01.02.20;WA81;Andere unedle Metalle, Cermets usw.;120507;145163;-24656
01.02.20;WA82;Werkzeuge, Schneidwaren, Essbestecke;699330;412460;286870
01.02.20;WA83;Verschiedene Waren aus unedlen Metallen;658762;424054;234708
01.02.20;WA84;Maschinen, Apparate, mechanische Geräte;18351037;11444578;6906459
01.02.20;WA85;Elektrotechnische Erzeugnisse;11349441;10408485;940956
01.02.20;WA86;Schienenfahrzeuge;330086;241299;88787
01.02.20;WA87;Kraftfahrzeuge, Landfahrzeuge;18454924;10026773;8428151
01.02.20;WA88;Luftfahrzeuge, Raumfahrzeuge;2504600;1129467;1375133
01.02.20;WA89;Wasserfahrzeuge;608722;89811;518911
01.02.20;WA90;Optische, photografische usw. Erzeugnisse;5550563;3178584;2371979
01.02.20;WA91;Uhrmacherwaren;126303;170276;-43973
01.02.20;WA92;Musikinstrumente;57262;51877;5385
01.02.20;WA93;Waffen und Munition;36811;17362;19449
01.02.20;WA94;Möbel, Beleuchtungskörper usw.;1344208;1698217;-354009
01.02.20;WA95;Spielzeug, Spiele usw., Sportgeräte;360327;489323;-128996
01.02.20;WA96;Verschiedene Waren;318727;236324;82403
01.02.20;WA97;Kunstgegenstände, Sammlungsstücke;81730;47960;33770
01.02.20;WA98;Vollständige Fabrikationsanlagen;90689;NULL;#WERT!
01.02.20;WA99;Zusammenstellungen verschiedener Waren;1265120;1080621;184499
01.02.21;WA01;Lebende Tiere;85372;94524;-9152
01.02.21;WA02;Fleisch;513617;409088;104529
01.02.21;WA03;Fische, Krebs- und Weichtiere;101432;290268;-188836
01.02.21;WA04;Milch, Milcherzeugnisse, Eier, Honig;747353;664362;82991
01.02.21;WA05;Andere Waren tierischen Ursprungs;68368;72477;-4109
01.02.21;WA06;Pflanzen, Waren des Blumenhandels;72930;308852;-235922
01.02.21;WA07;Gemüse, Pflanzen für Ernährung;82120;681202;-599082
01.02.21;WA08;Geniessbare Früchte und Nüsse;152735;825366;-672631
01.02.21;WA09;Kaffee, Tee, Mate, Gewürze;207875;293934;-86059
01.02.21;WA10;Getreide;236572;295736;-59164
01.02.21;WA11;Müllereierzeugnisse, Malz usw.;138241;55466;82775
01.02.21;WA12;Ölsamen usw., Heilpflanzen usw.;175022;457220;-282198
01.02.21;WA13;Schellack, Gummen, Harz, Pflanzensaft;58680;53535;5145
01.02.21;WA14;Flechtstoffe usw. pflanzlichen Ursprungs;892;2542;-1650
01.02.21;WA15;Tierische und pflanzliche Fette, Öle, Wachs;295912;310812;-14900
01.02.21;WA16;Zubereitungen von Fleisch, Fisch usw.;237066;251570;-14504
01.02.21;WA17;Zucker und Zuckerwaren;187327;121595;65732
01.02.21;WA18;Kakao und Zubereitungen aus Kakao;444254;345192;99062
01.02.21;WA19;Zubereitungen aus Getreide usw., Backwaren;515446;380566;134880
01.02.21;WA20;Zubereitungen von Gemüse, Früchten usw.;230343;414732;-184389
01.02.21;WA21;Verschiedene Lebensmittelzubereitungen;489299;322099;167200
01.02.21;WA22;Getränke, alkoholhaltige Flüssigkeiten, Essig;393314;552167;-158853
01.02.21;WA23;Rückstände der Lebensmittelindustrie, Futter;525969;345563;180406
01.02.21;WA24;Tabak;209463;205209;4254
01.02.21;WA25;Salz, Schwefel, Steine, Erden usw.;154969;144034;10935
01.02.21;WA26;Erze, Schlacken, Aschen;51136;1017536;-966400
01.02.21;WA27;Mineralische Brennstoffe usw.;1575756;5598442;-4022686
01.02.21;WA28;Anorganische chemische Erzeugnisse;1147382;459042;688340
01.02.21;WA29;Organische chemische Erzeugnisse;1925521;2715203;-789682
01.02.21;WA30;Pharmazeutische Erzeugnisse;6799923;4394586;2405337
01.02.21;WA31;Düngemittel;204455;102279;102176
01.02.21;WA32;Gerb- und Farbstoffe, Farben, Lacke usw.;977758;468813;508945
01.02.21;WA33;Etherische Öle, Riech-, Schönheitsmittel;759296;522942;236354
01.02.21;WA34;Seifen, Waschmittel usw.;648671;345247;303424
01.02.21;WA35;Eiweissstoffe, Klebstoffe, Enzyme;321711;185089;136622
01.02.21;WA36;Sprengstoffe, pyrotechnische Artikel usw.;20372;10111;10261
01.02.21;WA37;Photochemische Erzeugnisse;81020;50724;30296
01.02.21;WA38;Verschiedene Erzeugnisse der Chemischen Industrie;2235067;1385529;849538
01.02.21;WA39;Kunststoffe und Waren daraus;5359433;3504029;1855404
01.02.21;WA40;Kautschuk und Waren daraus;1226008;1254364;-28356
01.02.21;WA41;Häute, Felle, Leder;46751;36304;10447
01.02.21;WA42;Lederwaren, Sattlerwaren;177657;308365;-130708
01.02.21;WA43;Pelzfelle, künstliches Pelzwerk;3192;4721;-1529
01.02.21;WA44;Holz, Holzwaren, Holzkohle;788311;702754;85557
01.02.21;WA45;Kork, Korkwaren;3089;7551;-4462
01.02.21;WA46;Flechtwaren, Korbmacherwaren;4835;13742;-8907
01.02.21;WA47;Halbstoffe aus Holz usw., Papierabfall;76912;262855;-185943
01.02.21;WA48;Papier, Pappe und Waren daraus;1417647;887145;530502
01.02.21;WA49;Bücher, Zeitungen, Bilddrucke usw.;301390;223049;78341
01.02.21;WA50;Seide;1568;977;591
01.02.21;WA51;Wolle, feine und grobe Tierhaare;34884;34382;502
01.02.21;WA52;Baumwolle;48546;55463;-6917
01.02.21;WA53;Andere pflanzliche Spinnstoffe, Papiergarn;3963;6824;-2861
01.02.21;WA54;Synthetisches oder künstliches Filament;127230;100349;26881
01.02.21;WA55;Synthetische oder künstliche Spinnfaser;118740;108271;10469
01.02.21;WA56;Watte, Filz, Vliesstoff usw., Tauwerk;218268;136391;81877
01.02.21;WA57;Teppiche, Fussbodenbelag aus Spinnstoff;44297;92013;-47716
01.02.21;WA58;Spezialgewebe, Spitzen, Tapisserien;40458;19634;20824
01.02.21;WA59;Getränkte, bestrichene usw. Gewebe;192261;94980;97281
01.02.21;WA60;Gewirke und Gestricke;58128;37152;20976
01.02.21;WA61;Bekleidung usw. aus Gewirken, Gestricken;821177;1390329;-569152
01.02.21;WA62;Andere Bekleidung, Bekleidungszubehör;820843;1278821;-457978
01.02.21;WA63;Andere Konfektion, Spinnstoffwaren usw.;303421;661508;-358087
01.02.21;WA64;Schuhe, Gamaschen, ähnliche Waren;680202;981328;-301126
01.02.21;WA65;Kopfbedeckungen und Teile davon;48254;63736;-15482
01.02.21;WA66;Schirme, Gehstöcke usw., Peitschen;6774;32904;-26130
01.02.21;WA67;Zugerichtete Federn, Daunen, künstliche Blumen;13050;15851;-2801
01.02.21;WA68;Waren aus Steinen, Gips, Zement usw.;403143;261483;141660
01.02.21;WA69;Keramische Waren;285709;267106;18603
01.02.21;WA70;Glas und Glaswaren;518121;408358;109763
01.02.21;WA71;Perlen, Edelsteine, Edelmetalle;1708173;2660616;-952443
01.02.21;WA72;Eisen und Stahl;2032005;2025067;6938
01.02.21;WA73;Waren aus Eisen oder Stahl;2263752;1805811;457941
01.02.21;WA74;Kupfer und Waren daraus;1021490;885388;136102
01.02.21;WA75;Nickel und Waren daraus;100063;131422;-31359
01.02.21;WA76;Aluminium und Waren daraus;1207889;1344685;-136796
01.02.21;WA78;Blei und Waren daraus;45580;33786;11794
01.02.21;WA79;Zink und Waren daraus;64268;112547;-48279
01.02.21;WA80;Zinn und Waren daraus;10467;35420;-24953
01.02.21;WA81;Andere unedle Metalle, Cermets usw.;96357;110505;-14148
01.02.21;WA82;Werkzeuge, Schneidwaren, Essbestecke;754978;456819;298159
01.02.21;WA83;Verschiedene Waren aus unedlen Metallen;651108;433072;218036
01.02.21;WA84;Maschinen, Apparate, mechanische Geräte;17975659;11778903;6196756
01.02.21;WA85;Elektrotechnische Erzeugnisse;11849049;11463832;385217
01.02.21;WA86;Schienenfahrzeuge;269323;221355;47968
01.02.21;WA87;Kraftfahrzeuge, Landfahrzeuge;18096984;9529477;8567507
01.02.21;WA88;Luftfahrzeuge, Raumfahrzeuge;1473003;719589;753414
01.02.21;WA89;Wasserfahrzeuge;1453244;84431;1368813
01.02.21;WA90;Optische, photografische usw. Erzeugnisse;5471179;3183458;2287721
01.02.21;WA91;Uhrmacherwaren;114970;157913;-42943
01.02.21;WA92;Musikinstrumente;52911;55251;-2340
01.02.21;WA93;Waffen und Munition;41068;18142;22926
01.02.21;WA94;Möbel, Beleuchtungskörper usw.;1285164;1782882;-497718
01.02.21;WA95;Spielzeug, Spiele usw., Sportgeräte;401397;636035;-234638
01.02.21;WA96;Verschiedene Waren;312521;239010;73511
01.02.21;WA97;Kunstgegenstände, Sammlungsstücke;78385;31708;46677
01.02.21;WA98;Vollständige Fabrikationsanlagen;36017;4884;31133
01.02.21;WA99;Zusammenstellungen verschiedener Waren;1129155;901214;227941
01.02.22;WA01;Lebende Tiere;90635;83451;7184
01.02.22;WA02;Fleisch;528212;486622;41590
01.02.22;WA03;Fische, Krebs- und Weichtiere;110836;316987;-206151
01.02.22;WA04;Milch, Milcherzeugnisse, Eier, Honig;893894;766904;126990
01.02.22;WA05;Andere Waren tierischen Ursprungs;77082;90715;-13633
01.02.22;WA06;Pflanzen, Waren des Blumenhandels;85425;332261;-246836
01.02.22;WA07;Gemüse, Pflanzen für Ernährung;99593;677072;-577479
01.02.22;WA08;Geniessbare Früchte und Nüsse;157098;848183;-691085
01.02.22;WA09;Kaffee, Tee, Mate, Gewürze;294523;453365;-158842
01.02.22;WA10;Getreide;241309;315748;-74439
01.02.22;WA11;Müllereierzeugnisse, Malz usw.;171051;66057;104994
01.02.22;WA12;Ölsamen usw., Heilpflanzen usw.;221431;701500;-480069
01.02.22;WA13;Schellack, Gummen, Harz, Pflanzensaft;61040;61832;-792
01.02.22;WA14;Flechtstoffe usw. pflanzlichen Ursprungs;1303;4774;-3471
01.02.22;WA15;Tierische und pflanzliche Fette, Öle, Wachs;346316;405499;-59183
01.02.22;WA16;Zubereitungen von Fleisch, Fisch usw.;243812;262976;-19164
01.02.22;WA17;Zucker und Zuckerwaren;240757;144635;96122
01.02.22;WA18;Kakao und Zubereitungen aus Kakao;505471;366271;139200
01.02.22;WA19;Zubereitungen aus Getreide usw., Backwaren;584543;394274;190269
01.02.22;WA20;Zubereitungen von Gemüse, Früchten usw.;236968;416872;-179904
01.02.22;WA21;Verschiedene Lebensmittelzubereitungen;559842;350588;209254
01.02.22;WA22;Getränke, alkoholhaltige Flüssigkeiten, Essig;486350;635539;-149189
01.02.22;WA23;Rückstände der Lebensmittelindustrie, Futter;511664;437049;74615
01.02.22;WA24;Tabak;206302;196740;9562
01.02.22;WA25;Salz, Schwefel, Steine, Erden usw.;189535;170729;18806
01.02.22;WA26;Erze, Schlacken, Aschen;60512;873303;-812791
01.02.22;WA27;Mineralische Brennstoffe usw.;4022765;12263352;-8240587
01.02.22;WA28;Anorganische chemische Erzeugnisse;1268191;709047;559144
01.02.22;WA29;Organische chemische Erzeugnisse;2805943;5455505;-2649562
01.02.22;WA30;Pharmazeutische Erzeugnisse;8879124;5508220;3370904
01.02.22;WA31;Düngemittel;385255;158084;227171
01.02.22;WA32;Gerb- und Farbstoffe, Farben, Lacke usw.;1094073;540870;553203
01.02.22;WA33;Etherische Öle, Riech-, Schönheitsmittel;845223;545791;299432
01.02.22;WA34;Seifen, Waschmittel usw.;742885;386482;356403
01.02.22;WA35;Eiweissstoffe, Klebstoffe, Enzyme;388865;241176;147689
01.02.22;WA36;Sprengstoffe, pyrotechnische Artikel usw.;20781;14729;6052
01.02.22;WA37;Photochemische Erzeugnisse;91885;51991;39894
01.02.22;WA38;Verschiedene Erzeugnisse der Chemischen Industrie;2843966;1979574;864392
01.02.22;WA39;Kunststoffe und Waren daraus;6644102;4337340;2306762
01.02.22;WA40;Kautschuk und Waren daraus;1292911;1273079;19832
01.02.22;WA41;Häute, Felle, Leder;61348;49170;12178
01.02.22;WA42;Lederwaren, Sattlerwaren;211448;345854;-134406
01.02.22;WA43;Pelzfelle, künstliches Pelzwerk;3924;7440;-3516
01.02.22;WA44;Holz, Holzwaren, Holzkohle;1049620;937486;112134
01.02.22;WA45;Kork, Korkwaren;3070;9365;-6295
01.02.22;WA46;Flechtwaren, Korbmacherwaren;6758;18772;-12014
01.02.22;WA47;Halbstoffe aus Holz usw., Papierabfall;130002;354846;-224844
01.02.22;WA48;Papier, Pappe und Waren daraus;1884143;1116117;768026
01.02.22;WA49;Bücher, Zeitungen, Bilddrucke usw.;297601;241340;56261
01.02.22;WA50;Seide;1961;2275;-314
01.02.22;WA51;Wolle, feine und grobe Tierhaare;43204;43822;-618
01.02.22;WA52;Baumwolle;59943;65779;-5836
01.02.22;WA53;Andere pflanzliche Spinnstoffe, Papiergarn;4498;7680;-3182
01.02.22;WA54;Synthetisches oder künstliches Filament;148151;131600;16551
01.02.22;WA55;Synthetische oder künstliche Spinnfaser;130458;122657;7801
01.02.22;WA56;Watte, Filz, Vliesstoff usw., Tauwerk;228006;156678;71328
01.02.22;WA57;Teppiche, Fussbodenbelag aus Spinnstoff;46947;103286;-56339
01.02.22;WA58;Spezialgewebe, Spitzen, Tapisserien;46146;22377;23769
01.02.22;WA59;Getränkte, bestrichene usw. Gewebe;209747;99332;110415
01.02.22;WA60;Gewirke und Gestricke;62654;40677;21977
01.02.22;WA61;Bekleidung usw. aus Gewirken, Gestricken;988036;1671336;-683300
01.02.22;WA62;Andere Bekleidung, Bekleidungszubehör;916131;1431705;-515574
01.02.22;WA63;Andere Konfektion, Spinnstoffwaren usw.;276000;447860;-171860
01.02.22;WA64;Schuhe, Gamaschen, ähnliche Waren;723881;1032658;-308777
01.02.22;WA65;Kopfbedeckungen und Teile davon;55046;71181;-16135
01.02.22;WA66;Schirme, Gehstöcke usw., Peitschen;9748;32154;-22406
01.02.22;WA67;Zugerichtete Federn, Daunen, künstliche Blumen;14836;21802;-6966
01.02.22;WA68;Waren aus Steinen, Gips, Zement usw.;436153;302868;133285
01.02.22;WA69;Keramische Waren;338443;270553;67890
01.02.22;WA70;Glas und Glaswaren;609364;446047;163317
01.02.22;WA71;Perlen, Edelsteine, Edelmetalle;1720498;2776258;-1055760
01.02.22;WA72;Eisen und Stahl;2984733;3107796;-123063
01.02.22;WA73;Waren aus Eisen oder Stahl;2690020;2317773;372247
01.02.22;WA74;Kupfer und Waren daraus;1348363;1264336;84027
01.02.22;WA75;Nickel und Waren daraus;136237;188731;-52494
01.02.22;WA76;Aluminium und Waren daraus;1695986;2032776;-336790
01.02.22;WA78;Blei und Waren daraus;34656;50168;-15512
01.02.22;WA79;Zink und Waren daraus;80186;149868;-69682
01.02.22;WA80;Zinn und Waren daraus;15030;66033;-51003
01.02.22;WA81;Andere unedle Metalle, Cermets usw.;139902;185591;-45689
01.02.22;WA82;Werkzeuge, Schneidwaren, Essbestecke;792266;492017;300249
01.02.22;WA83;Verschiedene Waren aus unedlen Metallen;713255;490182;223073
01.02.22;WA84;Maschinen, Apparate, mechanische Geräte;19249133;12495742;6753391
01.02.22;WA85;Elektrotechnische Erzeugnisse;12944095;13742063;-797968
01.02.22;WA86;Schienenfahrzeuge;272713;239073;33640
01.02.22;WA87;Kraftfahrzeuge, Landfahrzeuge;19998809;9926873;10071936
01.02.22;WA88;Luftfahrzeuge, Raumfahrzeuge;2138542;664330;1474212
01.02.22;WA89;Wasserfahrzeuge;227301;243099;-15798
01.02.22;WA90;Optische, photografische usw. Erzeugnisse;5834276;3295539;2538737
01.02.22;WA91;Uhrmacherwaren;132270;196714;-64444
01.02.22;WA92;Musikinstrumente;72853;61973;10880
01.02.22;WA93;Waffen und Munition;54153;22723;31430
01.02.22;WA94;Möbel, Beleuchtungskörper usw.;1457047;1977220;-520173
01.02.22;WA95;Spielzeug, Spiele usw., Sportgeräte;373945;657733;-283788
01.02.22;WA96;Verschiedene Waren;324800;272053;52747
01.02.22;WA97;Kunstgegenstände, Sammlungsstücke;61637;60936;701
01.02.22;WA98;Vollständige Fabrikationsanlagen;22016;NULL;#WERT!
01.02.22;WA99;Zusammenstellungen verschiedener Waren;1074991;859284;215707
01.02.23;WA01;Lebende Tiere;102992;143283;-40291
01.02.23;WA02;Fleisch;556166;594412;-38246
01.02.23;WA03;Fische, Krebs- und Weichtiere;123896;366007;-242111
01.02.23;WA04;Milch, Milcherzeugnisse, Eier, Honig;1042974;914955;128019
01.02.23;WA05;Andere Waren tierischen Ursprungs;76105;105467;-29362
01.02.23;WA06;Pflanzen, Waren des Blumenhandels;83254;294808;-211554
01.02.23;WA07;Gemüse, Pflanzen für Ernährung;121718;801521;-679803
01.02.23;WA08;Geniessbare Früchte und Nüsse;168405;880348;-711943
01.02.23;WA09;Kaffee, Tee, Mate, Gewürze;291825;431148;-139323
01.02.23;WA10;Getreide;326223;386732;-60509
01.02.23;WA11;Müllereierzeugnisse, Malz usw.;209224;86235;122989
01.02.23;WA12;Ölsamen usw., Heilpflanzen usw.;224031;790640;-566609
01.02.23;WA13;Schellack, Gummen, Harz, Pflanzensaft;60356;60422;-66
01.02.23;WA14;Flechtstoffe usw. pflanzlichen Ursprungs;1081;4590;-3509
01.02.23;WA15;Tierische und pflanzliche Fette, Öle, Wachs;383712;463238;-79526
01.02.23;WA16;Zubereitungen von Fleisch, Fisch usw.;285041;295385;-10344
01.02.23;WA17;Zucker und Zuckerwaren;287938;204831;83107
01.02.23;WA18;Kakao und Zubereitungen aus Kakao;577239;450480;126759
01.02.23;WA19;Zubereitungen aus Getreide usw., Backwaren;712726;537970;174756
01.02.23;WA20;Zubereitungen von Gemüse, Früchten usw.;259881;490045;-230164
01.02.23;WA21;Verschiedene Lebensmittelzubereitungen;677325;413228;264097
01.02.23;WA22;Getränke, alkoholhaltige Flüssigkeiten, Essig;544041;650589;-106548
01.02.23;WA23;Rückstände der Lebensmittelindustrie, Futter;562192;455421;106771
01.02.23;WA24;Tabak;238940;355598;-116658
01.02.23;WA25;Salz, Schwefel, Steine, Erden usw.;200084;188251;11833
01.02.23;WA26;Erze, Schlacken, Aschen;109254;897209;-787955
01.02.23;WA27;Mineralische Brennstoffe usw.;3141308;10310652;-7169344
01.02.23;WA28;Anorganische chemische Erzeugnisse;1217693;806173;411520
01.02.23;WA29;Organische chemische Erzeugnisse;2590822;4521432;-1930610
01.02.23;WA30;Pharmazeutische Erzeugnisse;10071435;5499381;4572054
01.02.23;WA31;Düngemittel;341366;189496;151870
01.02.23;WA32;Gerb- und Farbstoffe, Farben, Lacke usw.;1001352;481106;520246
01.02.23;WA33;Etherische Öle, Riech-, Schönheitsmittel;1004303;674866;329437
01.02.23;WA34;Seifen, Waschmittel usw.;731282;423879;307403
01.02.23;WA35;Eiweissstoffe, Klebstoffe, Enzyme;393589;248921;144668
01.02.23;WA36;Sprengstoffe, pyrotechnische Artikel usw.;29257;16666;12591
01.02.23;WA37;Photochemische Erzeugnisse;79233;49938;29295
01.02.23;WA38;Verschiedene Erzeugnisse der Chemischen Industrie;3009487;1769123;1240364
01.02.23;WA39;Kunststoffe und Waren daraus;5893949;4004330;1889619
01.02.23;WA40;Kautschuk und Waren daraus;1416497;1319539;96958
01.02.23;WA41;Häute, Felle, Leder;45400;40791;4609
01.02.23;WA42;Lederwaren, Sattlerwaren;237429;370298;-132869
01.02.23;WA43;Pelzfelle, künstliches Pelzwerk;3552;3852;-300
01.02.23;WA44;Holz, Holzwaren, Holzkohle;917696;771645;146051
01.02.23;WA45;Kork, Korkwaren;2323;8571;-6248
01.02.23;WA46;Flechtwaren, Korbmacherwaren;5824;12198;-6374
01.02.23;WA47;Halbstoffe aus Holz usw., Papierabfall;127153;339804;-212651
01.02.23;WA48;Papier, Pappe und Waren daraus;1753593;1113601;639992
01.02.23;WA49;Bücher, Zeitungen, Bilddrucke usw.;291108;217995;73113
01.02.23;WA50;Seide;2246;1994;252
01.02.23;WA51;Wolle, feine und grobe Tierhaare;46109;48460;-2351
01.02.23;WA52;Baumwolle;60866;56316;4550
01.02.23;WA53;Andere pflanzliche Spinnstoffe, Papiergarn;5009;6230;-1221
01.02.23;WA54;Synthetisches oder künstliches Filament;129811;117054;12757
01.02.23;WA55;Synthetische oder künstliche Spinnfaser;144042;114269;29773
01.02.23;WA56;Watte, Filz, Vliesstoff usw., Tauwerk;224336;147849;76487
01.02.23;WA57;Teppiche, Fussbodenbelag aus Spinnstoff;49777;87567;-37790
01.02.23;WA58;Spezialgewebe, Spitzen, Tapisserien;46755;22532;24223
01.02.23;WA59;Getränkte, bestrichene usw. Gewebe;227102;112108;114994
01.02.23;WA60;Gewirke und Gestricke;58876;39327;19549
01.02.23;WA61;Bekleidung usw. aus Gewirken, Gestricken;1022383;1672643;-650260
01.02.23;WA62;Andere Bekleidung, Bekleidungszubehör;1058600;1625533;-566933
01.02.23;WA63;Andere Konfektion, Spinnstoffwaren usw.;256179;356665;-100486
01.02.23;WA64;Schuhe, Gamaschen, ähnliche Waren;861484;1165483;-303999
01.02.23;WA65;Kopfbedeckungen und Teile davon;62164;72879;-10715
01.02.23;WA66;Schirme, Gehstöcke usw., Peitschen;7640;25904;-18264
01.02.23;WA67;Zugerichtete Federn, Daunen, künstliche Blumen;15836;19077;-3241
01.02.23;WA68;Waren aus Steinen, Gips, Zement usw.;462086;305220;156866
01.02.23;WA69;Keramische Waren;336486;256945;79541
01.02.23;WA70;Glas und Glaswaren;671110;513646;157464
01.02.23;WA71;Perlen, Edelsteine, Edelmetalle;1671124;1970001;-298877
01.02.23;WA72;Eisen und Stahl;2774556;2599712;174844
01.02.23;WA73;Waren aus Eisen oder Stahl;2796709;2395664;401045
01.02.23;WA74;Kupfer und Waren daraus;1195430;1051310;144120
01.02.23;WA75;Nickel und Waren daraus;209166;195073;14093
01.02.23;WA76;Aluminium und Waren daraus;1585485;1775812;-190327
01.02.23;WA78;Blei und Waren daraus;38771;57397;-18626
01.02.23;WA79;Zink und Waren daraus;55457;166238;-110781
01.02.23;WA80;Zinn und Waren daraus;11916;41146;-29230
01.02.23;WA81;Andere unedle Metalle, Cermets usw.;140731;169406;-28675
01.02.23;WA82;Werkzeuge, Schneidwaren, Essbestecke;779884;484221;295663
01.02.23;WA83;Verschiedene Waren aus unedlen Metallen;685615;467383;218232
01.02.23;WA84;Maschinen, Apparate, mechanische Geräte;20812266;13406136;7406130
01.02.23;WA85;Elektrotechnische Erzeugnisse;14342962;16587901;-2244939
01.02.23;WA86;Schienenfahrzeuge;231803;264891;-33088
01.02.23;WA87;Kraftfahrzeuge, Landfahrzeuge;23890740;11598526;12292214
01.02.23;WA88;Luftfahrzeuge, Raumfahrzeuge;2417498;927252;1490246
01.02.23;WA89;Wasserfahrzeuge;268107;500610;-232503
01.02.23;WA90;Optische, photografische usw. Erzeugnisse;6140569;3594704;2545865
01.02.23;WA91;Uhrmacherwaren;143319;194848;-51529
01.02.23;WA92;Musikinstrumente;77776;62446;15330
01.02.23;WA93;Waffen und Munition;54763;30221;24542
01.02.23;WA94;Möbel, Beleuchtungskörper usw.;1451792;1863066;-411274
01.02.23;WA95;Spielzeug, Spiele usw., Sportgeräte;387924;628052;-240128
01.02.23;WA96;Verschiedene Waren;342145;285994;56151
01.02.23;WA97;Kunstgegenstände, Sammlungsstücke;76491;64346;12145
01.02.23;WA98;Vollständige Fabrikationsanlagen;49881;754;49127
01.02.23;WA99;Zusammenstellungen verschiedener Waren;1143998;892695;251303
01.02.24;WA01;Lebende Tiere;119022;152168;-33146
01.02.24;WA02;Fleisch;599378;616177;-16799
01.02.24;WA03;Fische, Krebs- und Weichtiere;103884;353277;-249393
01.02.24;WA04;Milch, Milcherzeugnisse, Eier, Honig;1017683;920141;97542
01.02.24;WA05;Andere Waren tierischen Ursprungs;72491;92012;-19521
01.02.24;WA06;Pflanzen, Waren des Blumenhandels;81998;311603;-229605
01.02.24;WA07;Gemüse, Pflanzen für Ernährung;146056;788829;-642773
01.02.24;WA08;Geniessbare Früchte und Nüsse;180089;1031000;-850911
01.02.24;WA09;Kaffee, Tee, Mate, Gewürze;306466;487703;-181237
01.02.24;WA10;Getreide;276158;406581;-130423
01.02.24;WA11;Müllereierzeugnisse, Malz usw.;205054;81652;123402
01.02.24;WA12;Ölsamen usw., Heilpflanzen usw.;272186;633625;-361439
01.02.24;WA13;Schellack, Gummen, Harz, Pflanzensaft;59523;51900;7623
01.02.24;WA14;Flechtstoffe usw. pflanzlichen Ursprungs;1180;3402;-2222
01.02.24;WA15;Tierische und pflanzliche Fette, Öle, Wachs;280731;445316;-164585
01.02.24;WA16;Zubereitungen von Fleisch, Fisch usw.;296108;315858;-19750
01.02.24;WA17;Zucker und Zuckerwaren;300227;207977;92250
01.02.24;WA18;Kakao und Zubereitungen aus Kakao;662442;592709;69733
01.02.24;WA19;Zubereitungen aus Getreide usw., Backwaren;774377;591629;182748
01.02.24;WA20;Zubereitungen von Gemüse, Früchten usw.;298810;571613;-272803
01.02.24;WA21;Verschiedene Lebensmittelzubereitungen;725195;474055;251140
01.02.24;WA22;Getränke, alkoholhaltige Flüssigkeiten, Essig;543398;677821;-134423
01.02.24;WA23;Rückstände der Lebensmittelindustrie, Futter;598443;458885;139558
01.02.24;WA24;Tabak;269891;464438;-194547
01.02.24;WA25;Salz, Schwefel, Steine, Erden usw.;208743;168634;40109
01.02.24;WA26;Erze, Schlacken, Aschen;67709;815978;-748269
01.02.24;WA27;Mineralische Brennstoffe usw.;2844306;8271964;-5427658
01.02.24;WA28;Anorganische chemische Erzeugnisse;1042619;706309;336310
01.02.24;WA29;Organische chemische Erzeugnisse;2376894;2961594;-584700
01.02.24;WA30;Pharmazeutische Erzeugnisse;9678833;5984430;3694403
01.02.24;WA31;Düngemittel;276538;143765;132773
01.02.24;WA32;Gerb- und Farbstoffe, Farben, Lacke usw.;1024585;463369;561216
01.02.24;WA33;Etherische Öle, Riech-, Schönheitsmittel;1077840;746192;331648
01.02.24;WA34;Seifen, Waschmittel usw.;790996;449961;341035
01.02.24;WA35;Eiweissstoffe, Klebstoffe, Enzyme;395452;240956;154496
01.02.24;WA36;Sprengstoffe, pyrotechnische Artikel usw.;35918;19387;16531
01.02.24;WA37;Photochemische Erzeugnisse;79056;50080;28976
01.02.24;WA38;Verschiedene Erzeugnisse der Chemischen Industrie;2900695;1700438;1200257
01.02.24;WA39;Kunststoffe und Waren daraus;6013896;3858420;2155476
01.02.24;WA40;Kautschuk und Waren daraus;1442157;1350300;91857
01.02.24;WA41;Häute, Felle, Leder;47368;41269;6099
01.02.24;WA42;Lederwaren, Sattlerwaren;252577;364076;-111499
01.02.24;WA43;Pelzfelle, künstliches Pelzwerk;4477;5249;-772
01.02.24;WA44;Holz, Holzwaren, Holzkohle;846654;661690;184964
01.02.24;WA45;Kork, Korkwaren;1859;8038;-6179
01.02.24;WA46;Flechtwaren, Korbmacherwaren;5892;12817;-6925
01.02.24;WA47;Halbstoffe aus Holz usw., Papierabfall;124775;330879;-206104
01.02.24;WA48;Papier, Pappe und Waren daraus;1674764;1098393;576371
01.02.24;WA49;Bücher, Zeitungen, Bilddrucke usw.;277755;220655;57100
01.02.24;WA50;Seide;1719;3713;-1994
01.02.24;WA51;Wolle, feine und grobe Tierhaare;36402;39959;-3557
01.02.24;WA52;Baumwolle;52090;45629;6461
01.02.24;WA53;Andere pflanzliche Spinnstoffe, Papiergarn;3826;5236;-1410
01.02.24;WA54;Synthetisches oder künstliches Filament;139231;116067;23164
01.02.24;WA55;Synthetische oder künstliche Spinnfaser;120593;108552;12041
01.02.24;WA56;Watte, Filz, Vliesstoff usw., Tauwerk;224366;138529;85837
01.02.24;WA57;Teppiche, Fussbodenbelag aus Spinnstoff;52032;87868;-35836
01.02.24;WA58;Spezialgewebe, Spitzen, Tapisserien;45485;22489;22996
01.02.24;WA59;Getränkte, bestrichene usw. Gewebe;229674;109987;119687
01.02.24;WA60;Gewirke und Gestricke;55224;35483;19741
01.02.24;WA61;Bekleidung usw. aus Gewirken, Gestricken;1049909;1520056;-470147
01.02.24;WA62;Andere Bekleidung, Bekleidungszubehör;1128728;1525157;-396429
01.02.24;WA63;Andere Konfektion, Spinnstoffwaren usw.;259239;337702;-78463
01.02.24;WA64;Schuhe, Gamaschen, ähnliche Waren;973617;1146567;-172950
01.02.24;WA65;Kopfbedeckungen und Teile davon;64953;77957;-13004
01.02.24;WA66;Schirme, Gehstöcke usw., Peitschen;7268;27609;-20341
01.02.24;WA67;Zugerichtete Federn, Daunen, künstliche Blumen;14711;24138;-9427
01.02.24;WA68;Waren aus Steinen, Gips, Zement usw.;474250;316894;157356
01.02.24;WA69;Keramische Waren;328310;244891;83419
01.02.24;WA70;Glas und Glaswaren;644620;479719;164901
01.02.24;WA71;Perlen, Edelsteine, Edelmetalle;1890089;1558304;331785
01.02.24;WA72;Eisen und Stahl;2631468;2348209;283259
01.02.24;WA73;Waren aus Eisen oder Stahl;2776056;2152120;623936
01.02.24;WA74;Kupfer und Waren daraus;1184563;1052107;132456
01.02.24;WA75;Nickel und Waren daraus;169314;193442;-24128
01.02.24;WA76;Aluminium und Waren daraus;1468304;1628337;-160033
01.02.24;WA78;Blei und Waren daraus;49041;47349;1692
01.02.24;WA79;Zink und Waren daraus;59003;116697;-57694
01.02.24;WA80;Zinn und Waren daraus;10921;40457;-29536
01.02.24;WA81;Andere unedle Metalle, Cermets usw.;141885;172548;-30663
01.02.24;WA82;Werkzeuge, Schneidwaren, Essbestecke;838063;487326;350737
01.02.24;WA83;Verschiedene Waren aus unedlen Metallen;728352;481600;246752
01.02.24;WA84;Maschinen, Apparate, mechanische Geräte;21482227;13419005;8063222
01.02.24;WA85;Elektrotechnische Erzeugnisse;14060111;15333777;-1273666
01.02.24;WA86;Schienenfahrzeuge;263064;286132;-23068
01.02.24;WA87;Kraftfahrzeuge, Landfahrzeuge;23832212;11540616;12291596
01.02.24;WA88;Luftfahrzeuge, Raumfahrzeuge;2266687;864383;1402304
01.02.24;WA89;Wasserfahrzeuge;147239;637693;-490454
01.02.24;WA90;Optische, photografische usw. Erzeugnisse;6611505;3815443;2796062
01.02.24;WA91;Uhrmacherwaren;140800;211890;-71090
01.02.24;WA92;Musikinstrumente;78389;63558;14831
01.02.24;WA93;Waffen und Munition;58028;35005;23023
01.02.24;WA94;Möbel, Beleuchtungskörper usw.;1472055;1908682;-436627
01.02.24;WA95;Spielzeug, Spiele usw., Sportgeräte;364903;535144;-170241
01.02.24;WA96;Verschiedene Waren;350925;286114;64811
01.02.24;WA97;Kunstgegenstände, Sammlungsstücke;172526;43003;129523
01.02.24;WA98;Vollständige Fabrikationsanlagen;87000;13;86987
01.02.24;WA99;Zusammenstellungen verschiedener Waren;1231742;994657;237085
01.02.25;WA01;Lebende Tiere;123485;117740;5745
01.02.25;WA02;Fleisch;588440;673184;-84744
01.02.25;WA03;Fische, Krebs- und Weichtiere;111432;358011;-246579
01.02.25;WA04;Milch, Milcherzeugnisse, Eier, Honig;1049029;1024140;24889
01.02.25;WA05;Andere Waren tierischen Ursprungs;71229;109370;-38141
01.02.25;WA06;Pflanzen, Waren des Blumenhandels;77047;350336;-273289
01.02.25;WA07;Gemüse, Pflanzen für Ernährung;151792;840338;-688546
01.02.25;WA08;Geniessbare Früchte und Nüsse;186599;1155141;-968542
01.02.25;WA09;Kaffee, Tee, Mate, Gewürze;415172;551395;-136223
01.02.25;WA10;Getreide;239432;304761;-65329
01.02.25;WA11;Müllereierzeugnisse, Malz usw.;188686;83390;105296
01.02.25;WA12;Ölsamen usw., Heilpflanzen usw.;297930;510189;-212259
01.02.25;WA13;Schellack, Gummen, Harz, Pflanzensaft;60863;56340;4523
01.02.25;WA14;Flechtstoffe usw. pflanzlichen Ursprungs;1222;3817;-2595
01.02.25;WA15;Tierische und pflanzliche Fette, Öle, Wachs;301840;435155;-133315
01.02.25;WA16;Zubereitungen von Fleisch, Fisch usw.;294986;338316;-43330
01.02.25;WA17;Zucker und Zuckerwaren;309149;200751;108398
01.02.25;WA18;Kakao und Zubereitungen aus Kakao;953399;1003339;-49940
01.02.25;WA19;Zubereitungen aus Getreide usw., Backwaren;810835;627761;183074
01.02.25;WA20;Zubereitungen von Gemüse, Früchten usw.;313076;607154;-294078
01.02.25;WA21;Verschiedene Lebensmittelzubereitungen;780331;527580;252751
01.02.25;WA22;Getränke, alkoholhaltige Flüssigkeiten, Essig;566597;696326;-129729
01.02.25;WA23;Rückstände der Lebensmittelindustrie, Futter;564333;503969;60364
01.02.25;WA24;Tabak;301375;447916;-146541
01.02.25;WA25;Salz, Schwefel, Steine, Erden usw.;202927;172902;30025
01.02.25;WA26;Erze, Schlacken, Aschen;51591;704650;-653059
01.02.25;WA27;Mineralische Brennstoffe usw.;2879124;9573379;-6694255
01.02.25;WA28;Anorganische chemische Erzeugnisse;1100231;604766;495465
01.02.25;WA29;Organische chemische Erzeugnisse;2329599;3399666;-1070067
01.02.25;WA30;Pharmazeutische Erzeugnisse;10177344;6319752;3857592
01.02.25;WA31;Düngemittel;257798;211465;46333
01.02.25;WA32;Gerb- und Farbstoffe, Farben, Lacke usw.;989510;491412;498098
01.02.25;WA33;Etherische Öle, Riech-, Schönheitsmittel;1020566;789543;231023
01.02.25;WA34;Seifen, Waschmittel usw.;793063;451217;341846
01.02.25;WA35;Eiweissstoffe, Klebstoffe, Enzyme;405941;242327;163614
01.02.25;WA36;Sprengstoffe, pyrotechnische Artikel usw.;36103;19751;16352
01.02.25;WA37;Photochemische Erzeugnisse;80679;58610;22069
01.02.25;WA38;Verschiedene Erzeugnisse der Chemischen Industrie;2752157;1679845;1072312
01.02.25;WA39;Kunststoffe und Waren daraus;5843125;3838545;2004580
01.02.25;WA40;Kautschuk und Waren daraus;1376025;1340681;35344
01.02.25;WA41;Häute, Felle, Leder;42336;38389;3947
01.02.25;WA42;Lederwaren, Sattlerwaren;245296;414359;-169063
01.02.25;WA43;Pelzfelle, künstliches Pelzwerk;2839;4216;-1377
01.02.25;WA44;Holz, Holzwaren, Holzkohle;806767;726339;80428
01.02.25;WA45;Kork, Korkwaren;2276;7822;-5546
01.02.25;WA46;Flechtwaren, Korbmacherwaren;5257;14921;-9664
01.02.25;WA47;Halbstoffe aus Holz usw., Papierabfall;121822;282629;-160807
01.02.25;WA48;Papier, Pappe und Waren daraus;1633151;1127678;505473
01.02.25;WA49;Bücher, Zeitungen, Bilddrucke usw.;265521;219384;46137
01.02.25;WA50;Seide;1908;2450;-542
01.02.25;WA51;Wolle, feine und grobe Tierhaare;35834;34621;1213
01.02.25;WA52;Baumwolle;44405;47883;-3478
01.02.25;WA53;Andere pflanzliche Spinnstoffe, Papiergarn;3756;7674;-3918
01.02.25;WA54;Synthetisches oder künstliches Filament;133873;106506;27367
01.02.25;WA55;Synthetische oder künstliche Spinnfaser;129472;106065;23407
01.02.25;WA56;Watte, Filz, Vliesstoff usw., Tauwerk;234429;149977;84452
01.02.25;WA57;Teppiche, Fussbodenbelag aus Spinnstoff;57652;99129;-41477
01.02.25;WA58;Spezialgewebe, Spitzen, Tapisserien;42906;22356;20550
01.02.25;WA59;Getränkte, bestrichene usw. Gewebe;224852;102673;122179
01.02.25;WA60;Gewirke und Gestricke;52183;32652;19531
01.02.25;WA61;Bekleidung usw. aus Gewirken, Gestricken;1008332;1698091;-689759
01.02.25;WA62;Andere Bekleidung, Bekleidungszubehör;1068400;1655225;-586825
01.02.25;WA63;Andere Konfektion, Spinnstoffwaren usw.;249239;418397;-169158
01.02.25;WA64;Schuhe, Gamaschen, ähnliche Waren;931666;1277581;-345915
01.02.25;WA65;Kopfbedeckungen und Teile davon;64651;85805;-21154
01.02.25;WA66;Schirme, Gehstöcke usw., Peitschen;10176;29425;-19249
01.02.25;WA67;Zugerichtete Federn, Daunen, künstliche Blumen;15210;27843;-12633
01.02.25;WA68;Waren aus Steinen, Gips, Zement usw.;466553;314440;152113
01.02.25;WA69;Keramische Waren;314818;257608;57210
01.02.25;WA70;Glas und Glaswaren;612338;456812;155526
01.02.25;WA71;Perlen, Edelsteine, Edelmetalle;2235272;2364672;-129400
01.02.25;WA72;Eisen und Stahl;2436040;2025986;410054
01.02.25;WA73;Waren aus Eisen oder Stahl;2722399;2106273;616126
01.02.25;WA74;Kupfer und Waren daraus;1297311;1032076;265235
01.02.25;WA75;Nickel und Waren daraus;170271;178222;-7951
01.02.25;WA76;Aluminium und Waren daraus;1576632;1731358;-154726
01.02.25;WA78;Blei und Waren daraus;42090;44787;-2697
01.02.25;WA79;Zink und Waren daraus;79815;117667;-37852
01.02.25;WA80;Zinn und Waren daraus;13386;49300;-35914
01.02.25;WA81;Andere unedle Metalle, Cermets usw.;163276;181039;-17763
01.02.25;WA82;Werkzeuge, Schneidwaren, Essbestecke;768047;517720;250327
01.02.25;WA83;Verschiedene Waren aus unedlen Metallen;698821;489694;209127
01.02.25;WA84;Maschinen, Apparate, mechanische Geräte;20903248;13591044;7312204
01.02.25;WA85;Elektrotechnische Erzeugnisse;13304104;14638029;-1333925
01.02.25;WA86;Schienenfahrzeuge;250264;235668;14596
01.02.25;WA87;Kraftfahrzeuge, Landfahrzeuge;21789612;10712134;11077478
01.02.25;WA88;Luftfahrzeuge, Raumfahrzeuge;2431532;986611;1444921
01.02.25;WA89;Wasserfahrzeuge;679302;1310716;-631414
01.02.25;WA90;Optische, photografische usw. Erzeugnisse;6592588;3874516;2718072
01.02.25;WA91;Uhrmacherwaren;161587;195344;-33757
01.02.25;WA92;Musikinstrumente;70241;58959;11282
01.02.25;WA93;Waffen und Munition;47601;23200;24401
01.02.25;WA94;Möbel, Beleuchtungskörper usw.;1461351;2044824;-583473
01.02.25;WA95;Spielzeug, Spiele usw., Sportgeräte;357579;565257;-207678
01.02.25;WA96;Verschiedene Waren;341116;296959;44157
01.02.25;WA97;Kunstgegenstände, Sammlungsstücke;92578;52347;40231
01.02.25;WA98;Vollständige Fabrikationsanlagen;81440;13228;68212
01.02.25;WA99;Zusammenstellungen verschiedener Waren;1325252;968967;356285
01.03.08;WA01;Lebende Tiere;68068;83516;-15448
01.03.08;WA02;Fleisch;406253;419111;-12858
01.03.08;WA03;Fische, Krebs- und Weichtiere;83545;194081;-110536
01.03.08;WA04;Milch, Milcherzeugnisse, Eier, Honig;607799;514152;93647
01.03.08;WA05;Andere Waren tierischen Ursprungs;37913;42832;-4919
01.03.08;WA06;Pflanzen, Waren des Blumenhandels;61782;257163;-195381
01.03.08;WA07;Gemüse, Pflanzen für Ernährung;68899;431151;-362252
01.03.08;WA08;Geniessbare Früchte und Nüsse;100722;473607;-372885
01.03.08;WA09;Kaffee, Tee, Mate, Gewürze;127281;192973;-65692
01.03.08;WA10;Getreide;157782;206813;-49031
01.03.08;WA11;Müllereierzeugnisse, Malz usw.;68878;37115;31763
01.03.08;WA12;Ölsamen usw., Heilpflanzen usw.;130424;233172;-102748
01.03.08;WA13;Schellack, Gummen, Harz, Pflanzensaft;42376;29293;13083
01.03.08;WA14;Flechtstoffe usw. pflanzlichen Ursprungs;1029;2343;-1314
01.03.08;WA15;Tierische und pflanzliche Fette, Öle, Wachs;168649;296680;-128031
01.03.08;WA16;Zubereitungen von Fleisch, Fisch usw.;178478;151680;26798
01.03.08;WA17;Zucker und Zuckerwaren;94968;109367;-14399
01.03.08;WA18;Kakao und Zubereitungen aus Kakao;166698;157611;9087
01.03.08;WA19;Zubereitungen aus Getreide usw., Backwaren;317692;195738;121954
01.03.08;WA20;Zubereitungen von Gemüse, Früchten usw.;172728;315967;-143239
01.03.08;WA21;Verschiedene Lebensmittelzubereitungen;286084;188081;98003
01.03.08;WA22;Getränke, alkoholhaltige Flüssigkeiten, Essig;305599;371638;-66039
01.03.08;WA23;Rückstände der Lebensmittelindustrie, Futter;175677;180572;-4895
01.03.08;WA24;Tabak;271221;104332;166889
01.03.08;WA25;Salz, Schwefel, Steine, Erden usw.;184518;152545;31973
01.03.08;WA26;Erze, Schlacken, Aschen;26733;471918;-445185
01.03.08;WA27;Mineralische Brennstoffe usw.;2467271;8639600;-6172329
01.03.08;WA28;Anorganische chemische Erzeugnisse;683953;448183;235770
01.03.08;WA29;Organische chemische Erzeugnisse;2057492;1834544;222948
01.03.08;WA30;Pharmazeutische Erzeugnisse;3398877;2385088;1013789
01.03.08;WA31;Düngemittel;221681;100222;121459
01.03.08;WA32;Gerb- und Farbstoffe, Farben, Lacke usw.;693541;315476;378065
01.03.08;WA33;Etherische Öle, Riech-, Schönheitsmittel;500804;277600;223204
01.03.08;WA34;Seifen, Waschmittel usw.;383207;166399;216808
01.03.08;WA35;Eiweissstoffe, Klebstoffe, Enzyme;169920;124301;45619
01.03.08;WA36;Sprengstoffe, pyrotechnische Artikel usw.;19100;12570;6530
01.03.08;WA37;Photochemische Erzeugnisse;103222;104406;-1184
01.03.08;WA38;Verschiedene Erzeugnisse der Chemischen Industrie;1347980;894920;453060
01.03.08;WA39;Kunststoffe und Waren daraus;3903475;2300203;1603272
01.03.08;WA40;Kautschuk und Waren daraus;850247;855319;-5072
01.03.08;WA41;Häute, Felle, Leder;77437;75240;2197
01.03.08;WA42;Lederwaren, Sattlerwaren;103126;161954;-58828
01.03.08;WA43;Pelzfelle, künstliches Pelzwerk;12162;9295;2867
01.03.08;WA44;Holz, Holzwaren, Holzkohle;635528;516377;119151
01.03.08;WA45;Kork, Korkwaren;3605;13279;-9674
01.03.08;WA46;Flechtwaren, Korbmacherwaren;3670;7702;-4032
01.03.08;WA47;Halbstoffe aus Holz usw., Papierabfall;96365;308287;-211922
01.03.08;WA48;Papier, Pappe und Waren daraus;1442608;971036;471572
01.03.08;WA49;Bücher, Zeitungen, Bilddrucke usw.;422172;175393;246779
01.03.08;WA50;Seide;6298;6013;285
01.03.08;WA51;Wolle, feine und grobe Tierhaare;58438;70647;-12209
01.03.08;WA52;Baumwolle;90077;86283;3794
01.03.08;WA53;Andere pflanzliche Spinnstoffe, Papiergarn;5500;7038;-1538
01.03.08;WA54;Synthetisches oder künstliches Filament;210205;137934;72271
01.03.08;WA55;Synthetische oder künstliche Spinnfaser;144570;122489;22081
01.03.08;WA56;Watte, Filz, Vliesstoff usw., Tauwerk;163008;85396;77612
01.03.08;WA57;Teppiche, Fussbodenbelag aus Spinnstoff;42680;88291;-45611
01.03.08;WA58;Spezialgewebe, Spitzen, Tapisserien;44613;27310;17303
01.03.08;WA59;Getränkte, bestrichene usw. Gewebe;155192;100462;54730
01.03.08;WA60;Gewirke und Gestricke;76913;37137;39776
01.03.08;WA61;Bekleidung usw. aus Gewirken, Gestricken;477895;772660;-294765
01.03.08;WA62;Andere Bekleidung, Bekleidungszubehör;740572;979642;-239070
01.03.08;WA63;Andere Konfektion, Spinnstoffwaren usw.;123712;186821;-63109
01.03.08;WA64;Schuhe, Gamaschen, ähnliche Waren;258281;456497;-198216
01.03.08;WA65;Kopfbedeckungen und Teile davon;25390;24998;392
01.03.08;WA66;Schirme, Gehstöcke usw., Peitschen;5900;18341;-12441
01.03.08;WA67;Zugerichtete Federn, Daunen, künstliche Blumen;4646;5952;-1306
01.03.08;WA68;Waren aus Steinen, Gips, Zement usw.;308744;184775;123969
01.03.08;WA69;Keramische Waren;267354;157140;110214
01.03.08;WA70;Glas und Glaswaren;392831;339049;53782
01.03.08;WA71;Perlen, Edelsteine, Edelmetalle;747070;837000;-89930
01.03.08;WA72;Eisen und Stahl;2330089;2404404;-74315
01.03.08;WA73;Waren aus Eisen oder Stahl;2062414;1365801;696613
01.03.08;WA74;Kupfer und Waren daraus;942708;944279;-1571
01.03.08;WA75;Nickel und Waren daraus;107693;188753;-81060
01.03.08;WA76;Aluminium und Waren daraus;1112367;1049146;63221
01.03.08;WA78;Blei und Waren daraus;40499;31071;9428
01.03.08;WA79;Zink und Waren daraus;58279;74604;-16325
01.03.08;WA80;Zinn und Waren daraus;9666;26776;-17110
01.03.08;WA81;Andere unedle Metalle, Cermets usw.;100692;138294;-37602
01.03.08;WA82;Werkzeuge, Schneidwaren, Essbestecke;557878;311341;246537
01.03.08;WA83;Verschiedene Waren aus unedlen Metallen;516731;287175;229556
01.03.08;WA84;Maschinen, Apparate, mechanische Geräte;15360004;8723774;6636230
01.03.08;WA85;Elektrotechnische Erzeugnisse;8403459;7034143;1369316
01.03.08;WA86;Schienenfahrzeuge;235527;127423;108104
01.03.08;WA87;Kraftfahrzeuge, Landfahrzeuge;14598555;6035462;8563093
01.03.08;WA88;Luftfahrzeuge, Raumfahrzeuge;1541624;694941;846683
01.03.08;WA89;Wasserfahrzeuge;137065;923721;-786656
01.03.08;WA90;Optische, photografische usw. Erzeugnisse;3243631;1819915;1423716
01.03.08;WA91;Uhrmacherwaren;94143;88428;5715
01.03.08;WA92;Musikinstrumente;37174;27279;9895
01.03.08;WA93;Waffen und Munition;27160;12494;14666
01.03.08;WA94;Möbel, Beleuchtungskörper usw.;1003922;919613;84309
01.03.08;WA95;Spielzeug, Spiele usw., Sportgeräte;339476;456248;-116772
01.03.08;WA96;Verschiedene Waren;152542;89325;63217
01.03.08;WA97;Kunstgegenstände, Sammlungsstücke;32718;24183;8535
01.03.08;WA98;Vollständige Fabrikationsanlagen;250953;2804;248149
01.03.08;WA99;Zusammenstellungen verschiedener Waren;1198885;943083;255802
01.03.09;WA01;Lebende Tiere;79379;128549;-49170
01.03.09;WA02;Fleisch;455543;381901;73642
01.03.09;WA03;Fische, Krebs- und Weichtiere;88798;222257;-133459
01.03.09;WA04;Milch, Milcherzeugnisse, Eier, Honig;494880;435485;59395
01.03.09;WA05;Andere Waren tierischen Ursprungs;43480;48707;-5227
01.03.09;WA06;Pflanzen, Waren des Blumenhandels;69710;272216;-202506
01.03.09;WA07;Gemüse, Pflanzen für Ernährung;69539;433787;-364248
01.03.09;WA08;Geniessbare Früchte und Nüsse;109936;448870;-338934
01.03.09;WA09;Kaffee, Tee, Mate, Gewürze;142805;248308;-105503
01.03.09;WA10;Getreide;200948;231985;-31037
01.03.09;WA11;Müllereierzeugnisse, Malz usw.;70261;35614;34647
01.03.09;WA12;Ölsamen usw., Heilpflanzen usw.;103738;308593;-204855
01.03.09;WA13;Schellack, Gummen, Harz, Pflanzensaft;43828;29193;14635
01.03.09;WA14;Flechtstoffe usw. pflanzlichen Ursprungs;781;1776;-995
01.03.09;WA15;Tierische und pflanzliche Fette, Öle, Wachs;140650;214824;-74174
01.03.09;WA16;Zubereitungen von Fleisch, Fisch usw.;188661;151588;37073
01.03.09;WA17;Zucker und Zuckerwaren;107738;105664;2074
01.03.09;WA18;Kakao und Zubereitungen aus Kakao;190243;178377;11866
01.03.09;WA19;Zubereitungen aus Getreide usw., Backwaren;351625;201457;150168
01.03.09;WA20;Zubereitungen von Gemüse, Früchten usw.;182049;309332;-127283
01.03.09;WA21;Verschiedene Lebensmittelzubereitungen;320372;230713;89659
01.03.09;WA22;Getränke, alkoholhaltige Flüssigkeiten, Essig;304945;439673;-134728
01.03.09;WA23;Rückstände der Lebensmittelindustrie, Futter;202063;236605;-34542
01.03.09;WA24;Tabak;287280;141887;145393
01.03.09;WA25;Salz, Schwefel, Steine, Erden usw.;156768;106170;50598
01.03.09;WA26;Erze, Schlacken, Aschen;11911;314093;-302182
01.03.09;WA27;Mineralische Brennstoffe usw.;1433898;6732961;-5299063
01.03.09;WA28;Anorganische chemische Erzeugnisse;527338;424216;103122
01.03.09;WA29;Organische chemische Erzeugnisse;1914334;1513861;400473
01.03.09;WA30;Pharmazeutische Erzeugnisse;4131892;2659890;1472002
01.03.09;WA31;Düngemittel;261943;119455;142488
01.03.09;WA32;Gerb- und Farbstoffe, Farben, Lacke usw.;571101;260364;310737
01.03.09;WA33;Etherische Öle, Riech-, Schönheitsmittel;537446;323342;214104
01.03.09;WA34;Seifen, Waschmittel usw.;369175;194336;174839
01.03.09;WA35;Eiweissstoffe, Klebstoffe, Enzyme;159548;127551;31997
01.03.09;WA36;Sprengstoffe, pyrotechnische Artikel usw.;14682;11008;3674
01.03.09;WA37;Photochemische Erzeugnisse;88397;66978;21419
01.03.09;WA38;Verschiedene Erzeugnisse der Chemischen Industrie;1202872;837091;365781
01.03.09;WA39;Kunststoffe und Waren daraus;2975344;1715652;1259692
01.03.09;WA40;Kautschuk und Waren daraus;730766;688223;42543
01.03.09;WA41;Häute, Felle, Leder;48586;53417;-4831
01.03.09;WA42;Lederwaren, Sattlerwaren;111752;161345;-49593
01.03.09;WA43;Pelzfelle, künstliches Pelzwerk;7741;9707;-1966
01.03.09;WA44;Holz, Holzwaren, Holzkohle;523541;389848;133693
01.03.09;WA45;Kork, Korkwaren;2857;12141;-9284
01.03.09;WA46;Flechtwaren, Korbmacherwaren;4435;8183;-3748
01.03.09;WA47;Halbstoffe aus Holz usw., Papierabfall;65388;179613;-114225
01.03.09;WA48;Papier, Pappe und Waren daraus;1272623;884513;388110
01.03.09;WA49;Bücher, Zeitungen, Bilddrucke usw.;394151;180196;213955
01.03.09;WA50;Seide;5349;4928;421
01.03.09;WA51;Wolle, feine und grobe Tierhaare;44347;49337;-4990
01.03.09;WA52;Baumwolle;72063;62839;9224
01.03.09;WA53;Andere pflanzliche Spinnstoffe, Papiergarn;3959;4733;-774
01.03.09;WA54;Synthetisches oder künstliches Filament;136617;90379;46238
01.03.09;WA55;Synthetische oder künstliche Spinnfaser;123970;95522;28448
01.03.09;WA56;Watte, Filz, Vliesstoff usw., Tauwerk;131461;85147;46314
01.03.09;WA57;Teppiche, Fussbodenbelag aus Spinnstoff;41081;93923;-52842
01.03.09;WA58;Spezialgewebe, Spitzen, Tapisserien;36621;25661;10960
01.03.09;WA59;Getränkte, bestrichene usw. Gewebe;124578;87004;37574
01.03.09;WA60;Gewirke und Gestricke;60430;31895;28535
01.03.09;WA61;Bekleidung usw. aus Gewirken, Gestricken;463753;836782;-373029
01.03.09;WA62;Andere Bekleidung, Bekleidungszubehör;674005;978003;-303998
01.03.09;WA63;Andere Konfektion, Spinnstoffwaren usw.;147370;200046;-52676
01.03.09;WA64;Schuhe, Gamaschen, ähnliche Waren;288526;444843;-156317
01.03.09;WA65;Kopfbedeckungen und Teile davon;23070;24203;-1133
01.03.09;WA66;Schirme, Gehstöcke usw., Peitschen;24107;16216;7891
01.03.09;WA67;Zugerichtete Federn, Daunen, künstliche Blumen;5679;7019;-1340
01.03.09;WA68;Waren aus Steinen, Gips, Zement usw.;225523;146868;78655
01.03.09;WA69;Keramische Waren;201433;152972;48461
01.03.09;WA70;Glas und Glaswaren;384750;258763;125987
01.03.09;WA71;Perlen, Edelsteine, Edelmetalle;669655;1065705;-396050
01.03.09;WA72;Eisen und Stahl;1412884;1365587;47297
01.03.09;WA73;Waren aus Eisen oder Stahl;1774301;1041995;732306
01.03.09;WA74;Kupfer und Waren daraus;488908;418477;70431
01.03.09;WA75;Nickel und Waren daraus;62471;68433;-5962
01.03.09;WA76;Aluminium und Waren daraus;752128;617352;134776
01.03.09;WA78;Blei und Waren daraus;20634;11268;9366
01.03.09;WA79;Zink und Waren daraus;31679;41329;-9650
01.03.09;WA80;Zinn und Waren daraus;5498;14072;-8574
01.03.09;WA81;Andere unedle Metalle, Cermets usw.;61754;77220;-15466
01.03.09;WA82;Werkzeuge, Schneidwaren, Essbestecke;405136;233791;171345
01.03.09;WA83;Verschiedene Waren aus unedlen Metallen;399161;222951;176210
01.03.09;WA84;Maschinen, Apparate, mechanische Geräte;13350472;7540429;5810043
01.03.09;WA85;Elektrotechnische Erzeugnisse;6823413;6145076;678337
01.03.09;WA86;Schienenfahrzeuge;358425;168433;189992
01.03.09;WA87;Kraftfahrzeuge, Landfahrzeuge;9816555;6033086;3783469
01.03.09;WA88;Luftfahrzeuge, Raumfahrzeuge;2093163;1716126;377037
01.03.09;WA89;Wasserfahrzeuge;389501;119183;270318
01.03.09;WA90;Optische, photografische usw. Erzeugnisse;2941878;1685116;1256762
01.03.09;WA91;Uhrmacherwaren;76599;91251;-14652
01.03.09;WA92;Musikinstrumente;28692;33632;-4940
01.03.09;WA93;Waffen und Munition;36728;12849;23879
01.03.09;WA94;Möbel, Beleuchtungskörper usw.;949921;953781;-3860
01.03.09;WA95;Spielzeug, Spiele usw., Sportgeräte;423427;522917;-99490
01.03.09;WA96;Verschiedene Waren;143943;85164;58779
01.03.09;WA97;Kunstgegenstände, Sammlungsstücke;37458;26112;11346
01.03.09;WA98;Vollständige Fabrikationsanlagen;471180;2296;468884
01.03.09;WA99;Zusammenstellungen verschiedener Waren;1151988;1340911;-188923
01.03.10;WA01;Lebende Tiere;85927;115442;-29515
01.03.10;WA02;Fleisch;542354;460056;82298
01.03.10;WA03;Fische, Krebs- und Weichtiere;91317;242331;-151014
01.03.10;WA04;Milch, Milcherzeugnisse, Eier, Honig;600650;537003;63647
01.03.10;WA05;Andere Waren tierischen Ursprungs;51920;55606;-3686
01.03.10;WA06;Pflanzen, Waren des Blumenhandels;76635;304287;-227652
01.03.10;WA07;Gemüse, Pflanzen für Ernährung;83309;517440;-434131
01.03.10;WA08;Geniessbare Früchte und Nüsse;109218;485529;-376311
01.03.10;WA09;Kaffee, Tee, Mate, Gewürze;164519;251489;-86970
01.03.10;WA10;Getreide;175159;149105;26054
01.03.10;WA11;Müllereierzeugnisse, Malz usw.;76996;34634;42362
01.03.10;WA12;Ölsamen usw., Heilpflanzen usw.;130248;242292;-112044
01.03.10;WA13;Schellack, Gummen, Harz, Pflanzensaft;43129;30801;12328
01.03.10;WA14;Flechtstoffe usw. pflanzlichen Ursprungs;931;2461;-1530
01.03.10;WA15;Tierische und pflanzliche Fette, Öle, Wachs;154854;267541;-112687
01.03.10;WA16;Zubereitungen von Fleisch, Fisch usw.;205237;169513;35724
01.03.10;WA17;Zucker und Zuckerwaren;141741;109121;32620
01.03.10;WA18;Kakao und Zubereitungen aus Kakao;247092;246610;482
01.03.10;WA19;Zubereitungen aus Getreide usw., Backwaren;372193;214766;157427
01.03.10;WA20;Zubereitungen von Gemüse, Früchten usw.;173040;301136;-128096
01.03.10;WA21;Verschiedene Lebensmittelzubereitungen;337184;231740;105444
01.03.10;WA22;Getränke, alkoholhaltige Flüssigkeiten, Essig;362558;453895;-91337
01.03.10;WA23;Rückstände der Lebensmittelindustrie, Futter;242472;212221;30251
01.03.10;WA24;Tabak;286998;138988;148010
01.03.10;WA25;Salz, Schwefel, Steine, Erden usw.;181722;144998;36724
01.03.10;WA26;Erze, Schlacken, Aschen;32354;484879;-452525
01.03.10;WA27;Mineralische Brennstoffe usw.;1752339;7956002;-6203663
01.03.10;WA28;Anorganische chemische Erzeugnisse;695018;513037;181981
01.03.10;WA29;Organische chemische Erzeugnisse;1981011;1906071;74940
01.03.10;WA30;Pharmazeutische Erzeugnisse;4425803;3245941;1179862
01.03.10;WA31;Düngemittel;199442;99417;100025
01.03.10;WA32;Gerb- und Farbstoffe, Farben, Lacke usw.;757291;379445;377846
01.03.10;WA33;Etherische Öle, Riech-, Schönheitsmittel;638013;361107;276906
01.03.10;WA34;Seifen, Waschmittel usw.;467393;247044;220349
01.03.10;WA35;Eiweissstoffe, Klebstoffe, Enzyme;195978;132049;63929
01.03.10;WA36;Sprengstoffe, pyrotechnische Artikel usw.;18931;14146;4785
01.03.10;WA37;Photochemische Erzeugnisse;101842;72734;29108
01.03.10;WA38;Verschiedene Erzeugnisse der Chemischen Industrie;1435681;962356;473325
01.03.10;WA39;Kunststoffe und Waren daraus;4020489;2359640;1660849
01.03.10;WA40;Kautschuk und Waren daraus;1006559;947073;59486
01.03.10;WA41;Häute, Felle, Leder;78577;69661;8916
01.03.10;WA42;Lederwaren, Sattlerwaren;116129;199114;-82985
01.03.10;WA43;Pelzfelle, künstliches Pelzwerk;12469;11016;1453
01.03.10;WA44;Holz, Holzwaren, Holzkohle;572375;526882;45493
01.03.10;WA45;Kork, Korkwaren;3256;13939;-10683
01.03.10;WA46;Flechtwaren, Korbmacherwaren;4576;9621;-5045
01.03.10;WA47;Halbstoffe aus Holz usw., Papierabfall;77002;318421;-241419
01.03.10;WA48;Papier, Pappe und Waren daraus;1541487;951376;590111
01.03.10;WA49;Bücher, Zeitungen, Bilddrucke usw.;374877;165282;209595
01.03.10;WA50;Seide;5774;6235;-461
01.03.10;WA51;Wolle, feine und grobe Tierhaare;55821;65119;-9298
01.03.10;WA52;Baumwolle;83100;74433;8667
01.03.10;WA53;Andere pflanzliche Spinnstoffe, Papiergarn;3813;4531;-718
01.03.10;WA54;Synthetisches oder künstliches Filament;176712;123488;53224
01.03.10;WA55;Synthetische oder künstliche Spinnfaser;165482;121820;43662
01.03.10;WA56;Watte, Filz, Vliesstoff usw., Tauwerk;169275;100121;69154
01.03.10;WA57;Teppiche, Fussbodenbelag aus Spinnstoff;42601;103413;-60812
01.03.10;WA58;Spezialgewebe, Spitzen, Tapisserien;45784;30039;15745
01.03.10;WA59;Getränkte, bestrichene usw. Gewebe;168443;84147;84296
01.03.10;WA60;Gewirke und Gestricke;72855;36819;36036
01.03.10;WA61;Bekleidung usw. aus Gewirken, Gestricken;494327;894095;-399768
01.03.10;WA62;Andere Bekleidung, Bekleidungszubehör;674351;1042464;-368113
01.03.10;WA63;Andere Konfektion, Spinnstoffwaren usw.;159259;256613;-97354
01.03.10;WA64;Schuhe, Gamaschen, ähnliche Waren;299534;527741;-228207
01.03.10;WA65;Kopfbedeckungen und Teile davon;21744;33398;-11654
01.03.10;WA66;Schirme, Gehstöcke usw., Peitschen;19794;22522;-2728
01.03.10;WA67;Zugerichtete Federn, Daunen, künstliche Blumen;7319;9619;-2300
01.03.10;WA68;Waren aus Steinen, Gips, Zement usw.;289567;183610;105957
01.03.10;WA69;Keramische Waren;247395;186266;61129
01.03.10;WA70;Glas und Glaswaren;449399;336583;112816
01.03.10;WA71;Perlen, Edelsteine, Edelmetalle;900446;1023670;-123224
01.03.10;WA72;Eisen und Stahl;1958249;1686996;271253
01.03.10;WA73;Waren aus Eisen oder Stahl;1971721;1194961;776760
01.03.10;WA74;Kupfer und Waren daraus;1065356;789739;275617
01.03.10;WA75;Nickel und Waren daraus;68937;134107;-65170
01.03.10;WA76;Aluminium und Waren daraus;919543;1016961;-97418
01.03.10;WA78;Blei und Waren daraus;45260;27013;18247
01.03.10;WA79;Zink und Waren daraus;52379;93147;-40768
01.03.10;WA80;Zinn und Waren daraus;8131;26408;-18277
01.03.10;WA81;Andere unedle Metalle, Cermets usw.;81104;97747;-16643
01.03.10;WA82;Werkzeuge, Schneidwaren, Essbestecke;539564;301290;238274
01.03.10;WA83;Verschiedene Waren aus unedlen Metallen;517843;296221;221622
01.03.10;WA84;Maschinen, Apparate, mechanische Geräte;14860237;8554587;6305650
01.03.10;WA85;Elektrotechnische Erzeugnisse;8671032;8178265;492767
01.03.10;WA86;Schienenfahrzeuge;436078;151036;285042
01.03.10;WA87;Kraftfahrzeuge, Landfahrzeuge;14299087;5236024;9063063
01.03.10;WA88;Luftfahrzeuge, Raumfahrzeuge;2046040;1268213;777827
01.03.10;WA89;Wasserfahrzeuge;675308;2038562;-1363254
01.03.10;WA90;Optische, photografische usw. Erzeugnisse;3776048;2062165;1713883
01.03.10;WA91;Uhrmacherwaren;93881;102308;-8427
01.03.10;WA92;Musikinstrumente;35232;42203;-6971
01.03.10;WA93;Waffen und Munition;39797;12844;26953
01.03.10;WA94;Möbel, Beleuchtungskörper usw.;1081535;1189542;-108007
01.03.10;WA95;Spielzeug, Spiele usw., Sportgeräte;386293;427095;-40802
01.03.10;WA96;Verschiedene Waren;168629;108051;60578
01.03.10;WA97;Kunstgegenstände, Sammlungsstücke;59227;35389;23838
01.03.10;WA98;Vollständige Fabrikationsanlagen;428198;1744;426454
01.03.10;WA99;Zusammenstellungen verschiedener Waren;1295115;1130443;164672
01.03.11;WA01;Lebende Tiere;92060;129332;-37272
01.03.11;WA02;Fleisch;570513;493573;76940
01.03.11;WA03;Fische, Krebs- und Weichtiere;107436;266475;-159039
01.03.11;WA04;Milch, Milcherzeugnisse, Eier, Honig;706873;544359;162514
01.03.11;WA05;Andere Waren tierischen Ursprungs;62289;66417;-4128
01.03.11;WA06;Pflanzen, Waren des Blumenhandels;87631;317335;-229704
01.03.11;WA07;Gemüse, Pflanzen für Ernährung;105400;480173;-374773
01.03.11;WA08;Geniessbare Früchte und Nüsse;107930;522418;-414488
01.03.11;WA09;Kaffee, Tee, Mate, Gewürze;214464;407440;-192976
01.03.11;WA10;Getreide;295713;252780;42933
01.03.11;WA11;Müllereierzeugnisse, Malz usw.;90300;46341;43959
01.03.11;WA12;Ölsamen usw., Heilpflanzen usw.;128424;324973;-196549
01.03.11;WA13;Schellack, Gummen, Harz, Pflanzensaft;43395;41538;1857
01.03.11;WA14;Flechtstoffe usw. pflanzlichen Ursprungs;1031;2728;-1697
01.03.11;WA15;Tierische und pflanzliche Fette, Öle, Wachs;231601;336673;-105072
01.03.11;WA16;Zubereitungen von Fleisch, Fisch usw.;209243;190183;19060
01.03.11;WA17;Zucker und Zuckerwaren;135298;125788;9510
01.03.11;WA18;Kakao und Zubereitungen aus Kakao;309759;279547;30212
01.03.11;WA19;Zubereitungen aus Getreide usw., Backwaren;380429;239360;141069
01.03.11;WA20;Zubereitungen von Gemüse, Früchten usw.;177519;347799;-170280
01.03.11;WA21;Verschiedene Lebensmittelzubereitungen;373114;182980;190134
01.03.11;WA22;Getränke, alkoholhaltige Flüssigkeiten, Essig;400095;513457;-113362
01.03.11;WA23;Rückstände der Lebensmittelindustrie, Futter;223223;263022;-39799
01.03.11;WA24;Tabak;328369;167954;160415
01.03.11;WA25;Salz, Schwefel, Steine, Erden usw.;199352;151870;47482
01.03.11;WA26;Erze, Schlacken, Aschen;24709;789743;-765034
01.03.11;WA27;Mineralische Brennstoffe usw.;2438983;10085377;-7646394
01.03.11;WA28;Anorganische chemische Erzeugnisse;850499;613015;237484
01.03.11;WA29;Organische chemische Erzeugnisse;2152226;2093281;58945
01.03.11;WA30;Pharmazeutische Erzeugnisse;4451886;3118447;1333439
01.03.11;WA31;Düngemittel;246323;172804;73519
01.03.11;WA32;Gerb- und Farbstoffe, Farben, Lacke usw.;863688;471182;392506
01.03.11;WA33;Etherische Öle, Riech-, Schönheitsmittel;677702;380593;297109
01.03.11;WA34;Seifen, Waschmittel usw.;517679;259012;258667
01.03.11;WA35;Eiweissstoffe, Klebstoffe, Enzyme;226911;151681;75230
01.03.11;WA36;Sprengstoffe, pyrotechnische Artikel usw.;18434;13394;5040
01.03.11;WA37;Photochemische Erzeugnisse;102276;73737;28539
01.03.11;WA38;Verschiedene Erzeugnisse der Chemischen Industrie;1753087;1131792;621295
01.03.11;WA39;Kunststoffe und Waren daraus;4620938;2890143;1730795
01.03.11;WA40;Kautschuk und Waren daraus;1281815;1312143;-30328
01.03.11;WA41;Häute, Felle, Leder;94409;88415;5994
01.03.11;WA42;Lederwaren, Sattlerwaren;134492;249405;-114913
01.03.11;WA43;Pelzfelle, künstliches Pelzwerk;12561;13382;-821
01.03.11;WA44;Holz, Holzwaren, Holzkohle;611718;588947;22771
01.03.11;WA45;Kork, Korkwaren;3005;9483;-6478
01.03.11;WA46;Flechtwaren, Korbmacherwaren;3573;11396;-7823
01.03.11;WA47;Halbstoffe aus Holz usw., Papierabfall;115460;370932;-255472
01.03.11;WA48;Papier, Pappe und Waren daraus;1663320;1049920;613400
01.03.11;WA49;Bücher, Zeitungen, Bilddrucke usw.;382303;183401;198902
01.03.11;WA50;Seide;6690;7266;-576
01.03.11;WA51;Wolle, feine und grobe Tierhaare;72604;92413;-19809
01.03.11;WA52;Baumwolle;108384;115979;-7595
01.03.11;WA53;Andere pflanzliche Spinnstoffe, Papiergarn;4443;7461;-3018
01.03.11;WA54;Synthetisches oder künstliches Filament;203285;134025;69260
01.03.11;WA55;Synthetische oder künstliche Spinnfaser;199358;157589;41769
01.03.11;WA56;Watte, Filz, Vliesstoff usw., Tauwerk;201788;103283;98505
01.03.11;WA57;Teppiche, Fussbodenbelag aus Spinnstoff;44020;95239;-51219
01.03.11;WA58;Spezialgewebe, Spitzen, Tapisserien;44627;29773;14854
01.03.11;WA59;Getränkte, bestrichene usw. Gewebe;190113;104339;85774
01.03.11;WA60;Gewirke und Gestricke;82409;43099;39310
01.03.11;WA61;Bekleidung usw. aus Gewirken, Gestricken;605295;1079063;-473768
01.03.11;WA62;Andere Bekleidung, Bekleidungszubehör;776933;1269736;-492803
01.03.11;WA63;Andere Konfektion, Spinnstoffwaren usw.;183978;290525;-106547
01.03.11;WA64;Schuhe, Gamaschen, ähnliche Waren;392466;604265;-211799
01.03.11;WA65;Kopfbedeckungen und Teile davon;23252;35141;-11889
01.03.11;WA66;Schirme, Gehstöcke usw., Peitschen;8216;22223;-14007
01.03.11;WA67;Zugerichtete Federn, Daunen, künstliche Blumen;7176;9199;-2023
01.03.11;WA68;Waren aus Steinen, Gips, Zement usw.;325997;214837;111160
01.03.11;WA69;Keramische Waren;256446;195957;60489
01.03.11;WA70;Glas und Glaswaren;484304;348967;135337
01.03.11;WA71;Perlen, Edelsteine, Edelmetalle;1295164;1233389;61775
01.03.11;WA72;Eisen und Stahl;2419812;2681710;-261898
01.03.11;WA73;Waren aus Eisen oder Stahl;2208937;1520409;688528
01.03.11;WA74;Kupfer und Waren daraus;1286818;1059145;227673
01.03.11;WA75;Nickel und Waren daraus;98078;191848;-93770
01.03.11;WA76;Aluminium und Waren daraus;1224378;1284010;-59632
01.03.11;WA78;Blei und Waren daraus;46604;41115;5489
01.03.11;WA79;Zink und Waren daraus;62671;101652;-38981
01.03.11;WA80;Zinn und Waren daraus;15518;45208;-29690
01.03.11;WA81;Andere unedle Metalle, Cermets usw.;123640;139045;-15405
01.03.11;WA82;Werkzeuge, Schneidwaren, Essbestecke;589921;371444;218477
01.03.11;WA83;Verschiedene Waren aus unedlen Metallen;581110;336552;244558
01.03.11;WA84;Maschinen, Apparate, mechanische Geräte;17435761;9874674;7561087
01.03.11;WA85;Elektrotechnische Erzeugnisse;9779853;8741120;1038733
01.03.11;WA86;Schienenfahrzeuge;369126;176216;192910
01.03.11;WA87;Kraftfahrzeuge, Landfahrzeuge;16940921;6808410;10132511
01.03.11;WA88;Luftfahrzeuge, Raumfahrzeuge;2410212;1477838;932374
01.03.11;WA89;Wasserfahrzeuge;492660;479004;13656
01.03.11;WA90;Optische, photografische usw. Erzeugnisse;4328428;2308413;2020015
01.03.11;WA91;Uhrmacherwaren;110192;115808;-5616
01.03.11;WA92;Musikinstrumente;41797;39619;2178
01.03.11;WA93;Waffen und Munition;37271;20504;16767
01.03.11;WA94;Möbel, Beleuchtungskörper usw.;1196663;1206060;-9397
01.03.11;WA95;Spielzeug, Spiele usw., Sportgeräte;513007;540056;-27049
01.03.11;WA96;Verschiedene Waren;180439;120816;59623
01.03.11;WA97;Kunstgegenstände, Sammlungsstücke;53148;24735;28413
01.03.11;WA98;Vollständige Fabrikationsanlagen;239618;2176;237442
01.03.11;WA99;Zusammenstellungen verschiedener Waren;1538313;1067983;470330
01.03.12;WA01;Lebende Tiere;114090;147976;-33886
01.03.12;WA02;Fleisch;684975;515797;169178
01.03.12;WA03;Fische, Krebs- und Weichtiere;107232;262294;-155062
01.03.12;WA04;Milch, Milcherzeugnisse, Eier, Honig;677588;571241;106347
01.03.12;WA05;Andere Waren tierischen Ursprungs;69233;69602;-369
01.03.12;WA06;Pflanzen, Waren des Blumenhandels;104975;351025;-246050
01.03.12;WA07;Gemüse, Pflanzen für Ernährung;70167;507676;-437509
01.03.12;WA08;Geniessbare Früchte und Nüsse;106890;514217;-407327
01.03.12;WA09;Kaffee, Tee, Mate, Gewürze;205825;428337;-222512
01.03.12;WA10;Getreide;195451;220742;-25291
01.03.12;WA11;Müllereierzeugnisse, Malz usw.;103025;42630;60395
01.03.12;WA12;Ölsamen usw., Heilpflanzen usw.;128771;361618;-232847
01.03.12;WA13;Schellack, Gummen, Harz, Pflanzensaft;43141;45022;-1881
01.03.12;WA14;Flechtstoffe usw. pflanzlichen Ursprungs;618;2208;-1590
01.03.12;WA15;Tierische und pflanzliche Fette, Öle, Wachs;229228;333511;-104283
01.03.12;WA16;Zubereitungen von Fleisch, Fisch usw.;214800;194420;20380
01.03.12;WA17;Zucker und Zuckerwaren;144286;133943;10343
01.03.12;WA18;Kakao und Zubereitungen aus Kakao;283147;284466;-1319
01.03.12;WA19;Zubereitungen aus Getreide usw., Backwaren;393553;228695;164858
01.03.12;WA20;Zubereitungen von Gemüse, Früchten usw.;191135;356178;-165043
01.03.12;WA21;Verschiedene Lebensmittelzubereitungen;374307;224936;149371
01.03.12;WA22;Getränke, alkoholhaltige Flüssigkeiten, Essig;384609;536582;-151973
01.03.12;WA23;Rückstände der Lebensmittelindustrie, Futter;248443;272005;-23562
01.03.12;WA24;Tabak;341510;158674;182836
01.03.12;WA25;Salz, Schwefel, Steine, Erden usw.;178497;135577;42920
01.03.12;WA26;Erze, Schlacken, Aschen;23779;1024922;-1001143
01.03.12;WA27;Mineralische Brennstoffe usw.;2650140;12342497;-9692357
01.03.12;WA28;Anorganische chemische Erzeugnisse;774404;743008;31396
01.03.12;WA29;Organische chemische Erzeugnisse;2213925;2341733;-127808
01.03.12;WA30;Pharmazeutische Erzeugnisse;4564183;2997377;1566806
01.03.12;WA31;Düngemittel;330333;187260;143073
01.03.12;WA32;Gerb- und Farbstoffe, Farben, Lacke usw.;937066;488009;449057
01.03.12;WA33;Etherische Öle, Riech-, Schönheitsmittel;756556;457803;298753
01.03.12;WA34;Seifen, Waschmittel usw.;537384;286696;250688
01.03.12;WA35;Eiweissstoffe, Klebstoffe, Enzyme;234641;163207;71434
01.03.12;WA36;Sprengstoffe, pyrotechnische Artikel usw.;22913;14604;8309
01.03.12;WA37;Photochemische Erzeugnisse;100224;68989;31235
01.03.12;WA38;Verschiedene Erzeugnisse der Chemischen Industrie;1704180;1037801;666379
01.03.12;WA39;Kunststoffe und Waren daraus;4438512;2821920;1616592
01.03.12;WA40;Kautschuk und Waren daraus;1300441;1290148;10293
01.03.12;WA41;Häute, Felle, Leder;92098;72575;19523
01.03.12;WA42;Lederwaren, Sattlerwaren;125373;201722;-76349
01.03.12;WA43;Pelzfelle, künstliches Pelzwerk;17649;14379;3270
01.03.12;WA44;Holz, Holzwaren, Holzkohle;572854;551361;21493
01.03.12;WA45;Kork, Korkwaren;2869;8669;-5800
01.03.12;WA46;Flechtwaren, Korbmacherwaren;3742;7691;-3949
01.03.12;WA47;Halbstoffe aus Holz usw., Papierabfall;94058;294760;-200702
01.03.12;WA48;Papier, Pappe und Waren daraus;1452528;973190;479338
01.03.12;WA49;Bücher, Zeitungen, Bilddrucke usw.;365239;164877;200362
01.03.12;WA50;Seide;6134;5327;807
01.03.12;WA51;Wolle, feine und grobe Tierhaare;65296;75329;-10033
01.03.12;WA52;Baumwolle;91353;82664;8689
01.03.12;WA53;Andere pflanzliche Spinnstoffe, Papiergarn;3590;6405;-2815
01.03.12;WA54;Synthetisches oder künstliches Filament;171090;127040;44050
01.03.12;WA55;Synthetische oder künstliche Spinnfaser;167119;131214;35905
01.03.12;WA56;Watte, Filz, Vliesstoff usw., Tauwerk;186578;100600;85978
01.03.12;WA57;Teppiche, Fussbodenbelag aus Spinnstoff;44343;85129;-40786
01.03.12;WA58;Spezialgewebe, Spitzen, Tapisserien;40891;27821;13070
01.03.12;WA59;Getränkte, bestrichene usw. Gewebe;182558;103923;78635
01.03.12;WA60;Gewirke und Gestricke;71354;40290;31064
01.03.12;WA61;Bekleidung usw. aus Gewirken, Gestricken;563550;965257;-401707
01.03.12;WA62;Andere Bekleidung, Bekleidungszubehör;714914;1109631;-394717
01.03.12;WA63;Andere Konfektion, Spinnstoffwaren usw.;197060;254361;-57301
01.03.12;WA64;Schuhe, Gamaschen, ähnliche Waren;335826;566339;-230513
01.03.12;WA65;Kopfbedeckungen und Teile davon;22742;31454;-8712
01.03.12;WA66;Schirme, Gehstöcke usw., Peitschen;7999;19099;-11100
01.03.12;WA67;Zugerichtete Federn, Daunen, künstliche Blumen;7810;7180;630
01.03.12;WA68;Waren aus Steinen, Gips, Zement usw.;327114;213250;113864
01.03.12;WA69;Keramische Waren;256241;180970;75271
01.03.12;WA70;Glas und Glaswaren;435693;339874;95819
01.03.12;WA71;Perlen, Edelsteine, Edelmetalle;1496496;1217930;278566
01.03.12;WA72;Eisen und Stahl;2306760;2311545;-4785
01.03.12;WA73;Waren aus Eisen oder Stahl;2380914;1468061;912853
01.03.12;WA74;Kupfer und Waren daraus;1055200;1047511;7689
01.03.12;WA75;Nickel und Waren daraus;102357;199555;-97198
01.03.12;WA76;Aluminium und Waren daraus;1103272;1174800;-71528
01.03.12;WA78;Blei und Waren daraus;48955;33348;15607
01.03.12;WA79;Zink und Waren daraus;58162;89391;-31229
01.03.12;WA80;Zinn und Waren daraus;10832;33466;-22634
01.03.12;WA81;Andere unedle Metalle, Cermets usw.;118833;152987;-34154
01.03.12;WA82;Werkzeuge, Schneidwaren, Essbestecke;629763;340528;289235
01.03.12;WA83;Verschiedene Waren aus unedlen Metallen;566972;324046;242926
01.03.12;WA84;Maschinen, Apparate, mechanische Geräte;17679974;10160144;7519830
01.03.12;WA85;Elektrotechnische Erzeugnisse;9356460;8481855;874605
01.03.12;WA86;Schienenfahrzeuge;373940;125620;248320
01.03.12;WA87;Kraftfahrzeuge, Landfahrzeuge;17371708;7181249;10190459
01.03.12;WA88;Luftfahrzeuge, Raumfahrzeuge;2536594;997200;1539394
01.03.12;WA89;Wasserfahrzeuge;129032;319868;-190836
01.03.12;WA90;Optische, photografische usw. Erzeugnisse;4489611;2355444;2134167
01.03.12;WA91;Uhrmacherwaren;123194;146916;-23722
01.03.12;WA92;Musikinstrumente;38919;37615;1304
01.03.12;WA93;Waffen und Munition;40752;17005;23747
01.03.12;WA94;Möbel, Beleuchtungskörper usw.;1207444;1190407;17037
01.03.12;WA95;Spielzeug, Spiele usw., Sportgeräte;314897;367855;-52958
01.03.12;WA96;Verschiedene Waren;324316;174868;149448
01.03.12;WA97;Kunstgegenstände, Sammlungsstücke;54357;30986;23371
01.03.12;WA98;Vollständige Fabrikationsanlagen;247596;810;246786
01.03.12;WA99;Zusammenstellungen verschiedener Waren;1493698;969578;524120
01.03.13;WA01;Lebende Tiere;130088;170569;-40481
01.03.13;WA02;Fleisch;661418;520404;141014
01.03.13;WA03;Fische, Krebs- und Weichtiere;104229;271928;-167699
01.03.13;WA04;Milch, Milcherzeugnisse, Eier, Honig;714343;544291;170052
01.03.13;WA05;Andere Waren tierischen Ursprungs;71656;74726;-3070
01.03.13;WA06;Pflanzen, Waren des Blumenhandels;102122;309595;-207473
01.03.13;WA07;Gemüse, Pflanzen für Ernährung;99363;548221;-448858
01.03.13;WA08;Geniessbare Früchte und Nüsse;118560;568767;-450207
01.03.13;WA09;Kaffee, Tee, Mate, Gewürze;194133;302171;-108038
01.03.13;WA10;Getreide;334980;254818;80162
01.03.13;WA11;Müllereierzeugnisse, Malz usw.;104742;46079;58663
01.03.13;WA12;Ölsamen usw., Heilpflanzen usw.;136993;410746;-273753
01.03.13;WA13;Schellack, Gummen, Harz, Pflanzensaft;45578;41319;4259
01.03.13;WA14;Flechtstoffe usw. pflanzlichen Ursprungs;746;2413;-1667
01.03.13;WA15;Tierische und pflanzliche Fette, Öle, Wachs;287591;254322;33269
01.03.13;WA16;Zubereitungen von Fleisch, Fisch usw.;224334;188162;36172
01.03.13;WA17;Zucker und Zuckerwaren;152315;133318;18997
01.03.13;WA18;Kakao und Zubereitungen aus Kakao;273927;224156;49771
01.03.13;WA19;Zubereitungen aus Getreide usw., Backwaren;422702;247884;174818
01.03.13;WA20;Zubereitungen von Gemüse, Früchten usw.;202328;331140;-128812
01.03.13;WA21;Verschiedene Lebensmittelzubereitungen;384413;217486;166927
01.03.13;WA22;Getränke, alkoholhaltige Flüssigkeiten, Essig;384939;533625;-148686
01.03.13;WA23;Rückstände der Lebensmittelindustrie, Futter;308326;262132;46194
01.03.13;WA24;Tabak;337350;156140;181210
01.03.13;WA25;Salz, Schwefel, Steine, Erden usw.;164399;146218;18181
01.03.13;WA26;Erze, Schlacken, Aschen;33158;844615;-811457
01.03.13;WA27;Mineralische Brennstoffe usw.;2612273;10166226;-7553953
01.03.13;WA28;Anorganische chemische Erzeugnisse;733248;662629;70619
01.03.13;WA29;Organische chemische Erzeugnisse;2165013;2061223;103790
01.03.13;WA30;Pharmazeutische Erzeugnisse;4398088;2770759;1627329
01.03.13;WA31;Düngemittel;287451;144072;143379
01.03.13;WA32;Gerb- und Farbstoffe, Farben, Lacke usw.;870031;458042;411989
01.03.13;WA33;Etherische Öle, Riech-, Schönheitsmittel;710163;453752;256411
01.03.13;WA34;Seifen, Waschmittel usw.;519605;260354;259251
01.03.13;WA35;Eiweissstoffe, Klebstoffe, Enzyme;220095;158614;61481
01.03.13;WA36;Sprengstoffe, pyrotechnische Artikel usw.;18948;13748;5200
01.03.13;WA37;Photochemische Erzeugnisse;93977;68338;25639
01.03.13;WA38;Verschiedene Erzeugnisse der Chemischen Industrie;1696121;998817;697304
01.03.13;WA39;Kunststoffe und Waren daraus;4305379;2697678;1607701
01.03.13;WA40;Kautschuk und Waren daraus;1159550;1125919;33631
01.03.13;WA41;Häute, Felle, Leder;91414;76415;14999
01.03.13;WA42;Lederwaren, Sattlerwaren;131769;245086;-113317
01.03.13;WA43;Pelzfelle, künstliches Pelzwerk;18341;13820;4521
01.03.13;WA44;Holz, Holzwaren, Holzkohle;552806;529191;23615
01.03.13;WA45;Kork, Korkwaren;2383;10259;-7876
01.03.13;WA46;Flechtwaren, Korbmacherwaren;3143;8646;-5503
01.03.13;WA47;Halbstoffe aus Holz usw., Papierabfall;105776;294565;-188789
01.03.13;WA48;Papier, Pappe und Waren daraus;1477343;979773;497570
01.03.13;WA49;Bücher, Zeitungen, Bilddrucke usw.;341894;133942;207952
01.03.13;WA50;Seide;6207;5768;439
01.03.13;WA51;Wolle, feine und grobe Tierhaare;48464;55778;-7314
01.03.13;WA52;Baumwolle;80474;81211;-737
01.03.13;WA53;Andere pflanzliche Spinnstoffe, Papiergarn;3017;5168;-2151
01.03.13;WA54;Synthetisches oder künstliches Filament;158159;115734;42425
01.03.13;WA55;Synthetische oder künstliche Spinnfaser;154872;119898;34974
01.03.13;WA56;Watte, Filz, Vliesstoff usw., Tauwerk;195910;98737;97173
01.03.13;WA57;Teppiche, Fussbodenbelag aus Spinnstoff;39028;79329;-40301
01.03.13;WA58;Spezialgewebe, Spitzen, Tapisserien;40192;24006;16186
01.03.13;WA59;Getränkte, bestrichene usw. Gewebe;167802;91503;76299
01.03.13;WA60;Gewirke und Gestricke;69866;37605;32261
01.03.13;WA61;Bekleidung usw. aus Gewirken, Gestricken;558988;969300;-410312
01.03.13;WA62;Andere Bekleidung, Bekleidungszubehör;683280;1110432;-427152
01.03.13;WA63;Andere Konfektion, Spinnstoffwaren usw.;167381;240587;-73206
01.03.13;WA64;Schuhe, Gamaschen, ähnliche Waren;340832;616529;-275697
01.03.13;WA65;Kopfbedeckungen und Teile davon;24271;36031;-11760
01.03.13;WA66;Schirme, Gehstöcke usw., Peitschen;7129;19829;-12700
01.03.13;WA67;Zugerichtete Federn, Daunen, künstliche Blumen;7449;8873;-1424
01.03.13;WA68;Waren aus Steinen, Gips, Zement usw.;308343;197499;110844
01.03.13;WA69;Keramische Waren;247517;178403;69114
01.03.13;WA70;Glas und Glaswaren;429724;332437;97287
01.03.13;WA71;Perlen, Edelsteine, Edelmetalle;1210821;1201937;8884
01.03.13;WA72;Eisen und Stahl;1948602;1980456;-31854
01.03.13;WA73;Waren aus Eisen oder Stahl;2215301;1384926;830375
01.03.13;WA74;Kupfer und Waren daraus;959191;924514;34677
01.03.13;WA75;Nickel und Waren daraus;90191;123642;-33451
01.03.13;WA76;Aluminium und Waren daraus;1056752;1117335;-60583
01.03.13;WA78;Blei und Waren daraus;29720;34379;-4659
01.03.13;WA79;Zink und Waren daraus;42838;85229;-42391
01.03.13;WA80;Zinn und Waren daraus;12094;34176;-22082
01.03.13;WA81;Andere unedle Metalle, Cermets usw.;114303;124803;-10500
01.03.13;WA82;Werkzeuge, Schneidwaren, Essbestecke;599166;330145;269021
01.03.13;WA83;Verschiedene Waren aus unedlen Metallen;523352;310569;212783
01.03.13;WA84;Maschinen, Apparate, mechanische Geräte;16106507;9141151;6965356
01.03.13;WA85;Elektrotechnische Erzeugnisse;9106101;7679010;1427091
01.03.13;WA86;Schienenfahrzeuge;288364;228638;59726
01.03.13;WA87;Kraftfahrzeuge, Landfahrzeuge;15800511;6359852;9440659
01.03.13;WA88;Luftfahrzeuge, Raumfahrzeuge;2759334;2439707;319627
01.03.13;WA89;Wasserfahrzeuge;792898;215009;577889
01.03.13;WA90;Optische, photografische usw. Erzeugnisse;4388428;2302812;2085616
01.03.13;WA91;Uhrmacherwaren;132649;141036;-8387
01.03.13;WA92;Musikinstrumente;37368;31001;6367
01.03.13;WA93;Waffen und Munition;42997;18062;24935
01.03.13;WA94;Möbel, Beleuchtungskörper usw.;1105374;1181594;-76220
01.03.13;WA95;Spielzeug, Spiele usw., Sportgeräte;250136;340138;-90002
01.03.13;WA96;Verschiedene Waren;291122;177846;113276
01.03.13;WA97;Kunstgegenstände, Sammlungsstücke;37942;31064;6878
01.03.13;WA98;Vollständige Fabrikationsanlagen;273392;832;272560
01.03.13;WA99;Zusammenstellungen verschiedener Waren;1422414;787706;634708
01.03.14;WA01;Lebende Tiere;114120;147945;-33825
01.03.14;WA02;Fleisch;562608;489912;72696
01.03.14;WA03;Fische, Krebs- und Weichtiere;118780;301793;-183013
01.03.14;WA04;Milch, Milcherzeugnisse, Eier, Honig;800021;587753;212268
01.03.14;WA05;Andere Waren tierischen Ursprungs;70965;75845;-4880
01.03.14;WA06;Pflanzen, Waren des Blumenhandels;104126;279657;-175531
01.03.14;WA07;Gemüse, Pflanzen für Ernährung;90905;487706;-396801
01.03.14;WA08;Geniessbare Früchte und Nüsse;121441;593512;-472071
01.03.14;WA09;Kaffee, Tee, Mate, Gewürze;188567;305097;-116530
01.03.14;WA10;Getreide;297922;247640;50282
01.03.14;WA11;Müllereierzeugnisse, Malz usw.;105430;38080;67350
01.03.14;WA12;Ölsamen usw., Heilpflanzen usw.;150152;342967;-192815
01.03.14;WA13;Schellack, Gummen, Harz, Pflanzensaft;44219;35178;9041
01.03.14;WA14;Flechtstoffe usw. pflanzlichen Ursprungs;983;2642;-1659
01.03.14;WA15;Tierische und pflanzliche Fette, Öle, Wachs;208324;272463;-64139
01.03.14;WA16;Zubereitungen von Fleisch, Fisch usw.;217453;170497;46956
01.03.14;WA17;Zucker und Zuckerwaren;135143;137299;-2156
01.03.14;WA18;Kakao und Zubereitungen aus Kakao;343742;299119;44623
01.03.14;WA19;Zubereitungen aus Getreide usw., Backwaren;420905;264466;156439
01.03.14;WA20;Zubereitungen von Gemüse, Früchten usw.;196794;361862;-165068
01.03.14;WA21;Verschiedene Lebensmittelzubereitungen;394778;241581;153197
01.03.14;WA22;Getränke, alkoholhaltige Flüssigkeiten, Essig;402849;481306;-78457
01.03.14;WA23;Rückstände der Lebensmittelindustrie, Futter;284228;255952;28276
01.03.14;WA24;Tabak;279791;145717;134074
01.03.14;WA25;Salz, Schwefel, Steine, Erden usw.;161953;148792;13161
01.03.14;WA26;Erze, Schlacken, Aschen;30764;675955;-645191
01.03.14;WA27;Mineralische Brennstoffe usw.;2424231;9665277;-7241046
01.03.14;WA28;Anorganische chemische Erzeugnisse;729236;460888;268348
01.03.14;WA29;Organische chemische Erzeugnisse;2137176;2322497;-185321
01.03.14;WA30;Pharmazeutische Erzeugnisse;4943254;3199208;1744046
01.03.14;WA31;Düngemittel;214784;174891;39893
01.03.14;WA32;Gerb- und Farbstoffe, Farben, Lacke usw.;889398;499298;390100
01.03.14;WA33;Etherische Öle, Riech-, Schönheitsmittel;694878;456483;238395
01.03.14;WA34;Seifen, Waschmittel usw.;548940;258703;290237
01.03.14;WA35;Eiweissstoffe, Klebstoffe, Enzyme;236414;159075;77339
01.03.14;WA36;Sprengstoffe, pyrotechnische Artikel usw.;15855;14717;1138
01.03.14;WA37;Photochemische Erzeugnisse;90769;57987;32782
01.03.14;WA38;Verschiedene Erzeugnisse der Chemischen Industrie;1739403;1067016;672387
01.03.14;WA39;Kunststoffe und Waren daraus;4503897;2880838;1623059
01.03.14;WA40;Kautschuk und Waren daraus;1204446;1221844;-17398
01.03.14;WA41;Häute, Felle, Leder;92152;83686;8466
01.03.14;WA42;Lederwaren, Sattlerwaren;135823;250820;-114997
01.03.14;WA43;Pelzfelle, künstliches Pelzwerk;12614;9957;2657
01.03.14;WA44;Holz, Holzwaren, Holzkohle;595392;606987;-11595
01.03.14;WA45;Kork, Korkwaren;2298;7467;-5169
01.03.14;WA46;Flechtwaren, Korbmacherwaren;3172;8163;-4991
01.03.14;WA47;Halbstoffe aus Holz usw., Papierabfall;109454;289686;-180232
01.03.14;WA48;Papier, Pappe und Waren daraus;1414685;976525;438160
01.03.14;WA49;Bücher, Zeitungen, Bilddrucke usw.;338797;142283;196514
01.03.14;WA50;Seide;5482;5392;90
01.03.14;WA51;Wolle, feine und grobe Tierhaare;42225;59601;-17376
01.03.14;WA52;Baumwolle;78477;84880;-6403
01.03.14;WA53;Andere pflanzliche Spinnstoffe, Papiergarn;3188;4899;-1711
01.03.14;WA54;Synthetisches oder künstliches Filament;163050;126827;36223
01.03.14;WA55;Synthetische oder künstliche Spinnfaser;168635;139250;29385
01.03.14;WA56;Watte, Filz, Vliesstoff usw., Tauwerk;192177;108958;83219
01.03.14;WA57;Teppiche, Fussbodenbelag aus Spinnstoff;39184;88448;-49264
01.03.14;WA58;Spezialgewebe, Spitzen, Tapisserien;37248;24483;12765
01.03.14;WA59;Getränkte, bestrichene usw. Gewebe;177003;91050;85953
01.03.14;WA60;Gewirke und Gestricke;66973;37951;29022
01.03.14;WA61;Bekleidung usw. aus Gewirken, Gestricken;577555;1081041;-503486
01.03.14;WA62;Andere Bekleidung, Bekleidungszubehör;698962;1199865;-500903
01.03.14;WA63;Andere Konfektion, Spinnstoffwaren usw.;180881;265532;-84651
01.03.14;WA64;Schuhe, Gamaschen, ähnliche Waren;403316;718602;-315286
01.03.14;WA65;Kopfbedeckungen und Teile davon;28418;35064;-6646
01.03.14;WA66;Schirme, Gehstöcke usw., Peitschen;7007;21620;-14613
01.03.14;WA67;Zugerichtete Federn, Daunen, künstliche Blumen;9431;9608;-177
01.03.14;WA68;Waren aus Steinen, Gips, Zement usw.;329508;233178;96330
01.03.14;WA69;Keramische Waren;247692;198292;49400
01.03.14;WA70;Glas und Glaswaren;453475;367928;85547
01.03.14;WA71;Perlen, Edelsteine, Edelmetalle;852008;984879;-132871
01.03.14;WA72;Eisen und Stahl;1856221;1954883;-98662
01.03.14;WA73;Waren aus Eisen oder Stahl;2151132;1465614;685518
01.03.14;WA74;Kupfer und Waren daraus;850675;679674;171001
01.03.14;WA75;Nickel und Waren daraus;74820;106296;-31476
01.03.14;WA76;Aluminium und Waren daraus;1036694;1095780;-59086
01.03.14;WA78;Blei und Waren daraus;34331;25514;8817
01.03.14;WA79;Zink und Waren daraus;53760;90623;-36863
01.03.14;WA80;Zinn und Waren daraus;10322;34652;-24330
01.03.14;WA81;Andere unedle Metalle, Cermets usw.;130932;130847;85
01.03.14;WA82;Werkzeuge, Schneidwaren, Essbestecke;624989;378125;246864
01.03.14;WA83;Verschiedene Waren aus unedlen Metallen;547546;323154;224392
01.03.14;WA84;Maschinen, Apparate, mechanische Geräte;16322804;9669067;6653737
01.03.14;WA85;Elektrotechnische Erzeugnisse;9221831;8168233;1053598
01.03.14;WA86;Schienenfahrzeuge;322852;173333;149519
01.03.14;WA87;Kraftfahrzeuge, Landfahrzeuge;16808076;7004527;9803549
01.03.14;WA88;Luftfahrzeuge, Raumfahrzeuge;2693680;3289821;-596141
01.03.14;WA89;Wasserfahrzeuge;254339;255203;-864
01.03.14;WA90;Optische, photografische usw. Erzeugnisse;4456486;2454882;2001604
01.03.14;WA91;Uhrmacherwaren;133317;149422;-16105
01.03.14;WA92;Musikinstrumente;40251;39386;865
01.03.14;WA93;Waffen und Munition;39989;15230;24759
01.03.14;WA94;Möbel, Beleuchtungskörper usw.;1134655;1340960;-206305
01.03.14;WA95;Spielzeug, Spiele usw., Sportgeräte;236034;334929;-98895
01.03.14;WA96;Verschiedene Waren;275337;174566;100771
01.03.14;WA97;Kunstgegenstände, Sammlungsstücke;43181;31985;11196
01.03.14;WA98;Vollständige Fabrikationsanlagen;318472;1257;317215
01.03.14;WA99;Zusammenstellungen verschiedener Waren;1481981;813384;668597
01.03.15;WA01;Lebende Tiere;115148;151151;-36003
01.03.15;WA02;Fleisch;653975;567323;86652
01.03.15;WA03;Fische, Krebs- und Weichtiere;124393;329829;-205436
01.03.15;WA04;Milch, Milcherzeugnisse, Eier, Honig;758884;632676;126208
01.03.15;WA05;Andere Waren tierischen Ursprungs;72781;82127;-9346
01.03.15;WA06;Pflanzen, Waren des Blumenhandels;110001;333447;-223446
01.03.15;WA07;Gemüse, Pflanzen für Ernährung;89031;599337;-510306
01.03.15;WA08;Geniessbare Früchte und Nüsse;141523;735722;-594199
01.03.15;WA09;Kaffee, Tee, Mate, Gewürze;242292;397956;-155664
01.03.15;WA10;Getreide;409195;286785;122410
01.03.15;WA11;Müllereierzeugnisse, Malz usw.;121972;43672;78300
01.03.15;WA12;Ölsamen usw., Heilpflanzen usw.;152368;377517;-225149
01.03.15;WA13;Schellack, Gummen, Harz, Pflanzensaft;49885;46373;3512
01.03.15;WA14;Flechtstoffe usw. pflanzlichen Ursprungs;642;3143;-2501
01.03.15;WA15;Tierische und pflanzliche Fette, Öle, Wachs;218406;294649;-76243
01.03.15;WA16;Zubereitungen von Fleisch, Fisch usw.;253557;202081;51476
01.03.15;WA17;Zucker und Zuckerwaren;150007;132225;17782
01.03.15;WA18;Kakao und Zubereitungen aus Kakao;356990;320596;36394
01.03.15;WA19;Zubereitungen aus Getreide usw., Backwaren;471707;325776;145931
01.03.15;WA20;Zubereitungen von Gemüse, Früchten usw.;214934;413781;-198847
01.03.15;WA21;Verschiedene Lebensmittelzubereitungen;439051;256956;182095
01.03.15;WA22;Getränke, alkoholhaltige Flüssigkeiten, Essig;449633;537254;-87621
01.03.15;WA23;Rückstände der Lebensmittelindustrie, Futter;335713;320562;15151
01.03.15;WA24;Tabak;361192;174667;186525
01.03.15;WA25;Salz, Schwefel, Steine, Erden usw.;182602;154298;28304
01.03.15;WA26;Erze, Schlacken, Aschen;27758;563044;-535286
01.03.15;WA27;Mineralische Brennstoffe usw.;2381336;7911570;-5530234
01.03.15;WA28;Anorganische chemische Erzeugnisse;792902;555736;237166
01.03.15;WA29;Organische chemische Erzeugnisse;2161206;2145443;15763
01.03.15;WA30;Pharmazeutische Erzeugnisse;5778946;3545804;2233142
01.03.15;WA31;Düngemittel;267467;179104;88363
01.03.15;WA32;Gerb- und Farbstoffe, Farben, Lacke usw.;983236;525797;457439
01.03.15;WA33;Etherische Öle, Riech-, Schönheitsmittel;761749;518344;243405
01.03.15;WA34;Seifen, Waschmittel usw.;600175;314488;285687
01.03.15;WA35;Eiweissstoffe, Klebstoffe, Enzyme;271488;175740;95748
01.03.15;WA36;Sprengstoffe, pyrotechnische Artikel usw.;25170;15486;9684
01.03.15;WA37;Photochemische Erzeugnisse;108165;70857;37308
01.03.15;WA38;Verschiedene Erzeugnisse der Chemischen Industrie;1901641;1143031;758610
01.03.15;WA39;Kunststoffe und Waren daraus;4806727;2988372;1818355
01.03.15;WA40;Kautschuk und Waren daraus;1269039;1214165;54874
01.03.15;WA41;Häute, Felle, Leder;99475;79966;19509
01.03.15;WA42;Lederwaren, Sattlerwaren;157124;357085;-199961
01.03.15;WA43;Pelzfelle, künstliches Pelzwerk;7996;9601;-1605
01.03.15;WA44;Holz, Holzwaren, Holzkohle;606847;638613;-31766
01.03.15;WA45;Kork, Korkwaren;2946;11368;-8422
01.03.15;WA46;Flechtwaren, Korbmacherwaren;4260;13014;-8754
01.03.15;WA47;Halbstoffe aus Holz usw., Papierabfall;107597;305091;-197494
01.03.15;WA48;Papier, Pappe und Waren daraus;1472243;1005055;467188
01.03.15;WA49;Bücher, Zeitungen, Bilddrucke usw.;370363;189631;180732
01.03.15;WA50;Seide;5657;6459;-802
01.03.15;WA51;Wolle, feine und grobe Tierhaare;56232;60617;-4385
01.03.15;WA52;Baumwolle;76600;79793;-3193
01.03.15;WA53;Andere pflanzliche Spinnstoffe, Papiergarn;3286;6112;-2826
01.03.15;WA54;Synthetisches oder künstliches Filament;171303;141462;29841
01.03.15;WA55;Synthetische oder künstliche Spinnfaser;176176;137721;38455
01.03.15;WA56;Watte, Filz, Vliesstoff usw., Tauwerk;205635;115001;90634
01.03.15;WA57;Teppiche, Fussbodenbelag aus Spinnstoff;42115;89639;-47524
01.03.15;WA58;Spezialgewebe, Spitzen, Tapisserien;39700;23973;15727
01.03.15;WA59;Getränkte, bestrichene usw. Gewebe;189276;99430;89846
01.03.15;WA60;Gewirke und Gestricke;71723;41639;30084
01.03.15;WA61;Bekleidung usw. aus Gewirken, Gestricken;616860;1245463;-628603
01.03.15;WA62;Andere Bekleidung, Bekleidungszubehör;745573;1372404;-626831
01.03.15;WA63;Andere Konfektion, Spinnstoffwaren usw.;221872;322973;-101101
01.03.15;WA64;Schuhe, Gamaschen, ähnliche Waren;472668;918210;-445542
01.03.15;WA65;Kopfbedeckungen und Teile davon;30463;45191;-14728
01.03.15;WA66;Schirme, Gehstöcke usw., Peitschen;8574;30175;-21601
01.03.15;WA67;Zugerichtete Federn, Daunen, künstliche Blumen;9763;12333;-2570
01.03.15;WA68;Waren aus Steinen, Gips, Zement usw.;365409;277907;87502
01.03.15;WA69;Keramische Waren;263806;229477;34329
01.03.15;WA70;Glas und Glaswaren;519217;407485;111732
01.03.15;WA71;Perlen, Edelsteine, Edelmetalle;955706;1234680;-278974
01.03.15;WA72;Eisen und Stahl;1978174;2156368;-178194
01.03.15;WA73;Waren aus Eisen oder Stahl;2370692;1581630;789062
01.03.15;WA74;Kupfer und Waren daraus;905055;854538;50517
01.03.15;WA75;Nickel und Waren daraus;110074;131606;-21532
01.03.15;WA76;Aluminium und Waren daraus;1275665;1330143;-54478
01.03.15;WA78;Blei und Waren daraus;34358;20748;13610
01.03.15;WA79;Zink und Waren daraus;51253;104607;-53354
01.03.15;WA80;Zinn und Waren daraus;9897;27207;-17310
01.03.15;WA81;Andere unedle Metalle, Cermets usw.;129720;148114;-18394
01.03.15;WA82;Werkzeuge, Schneidwaren, Essbestecke;692566;420804;271762
01.03.15;WA83;Verschiedene Waren aus unedlen Metallen;612335;373655;238680
01.03.15;WA84;Maschinen, Apparate, mechanische Geräte;18364902;10970802;7394100
01.03.15;WA85;Elektrotechnische Erzeugnisse;10244152;9534377;709775
01.03.15;WA86;Schienenfahrzeuge;262585;195710;66875
01.03.15;WA87;Kraftfahrzeuge, Landfahrzeuge;20610415;8053664;12556751
01.03.15;WA88;Luftfahrzeuge, Raumfahrzeuge;2835924;2991951;-156027
01.03.15;WA89;Wasserfahrzeuge;1195795;149007;1046788
01.03.15;WA90;Optische, photografische usw. Erzeugnisse;5056066;2932047;2124019
01.03.15;WA91;Uhrmacherwaren;167056;193815;-26759
01.03.15;WA92;Musikinstrumente;47441;51403;-3962
01.03.15;WA93;Waffen und Munition;43021;17537;25484
01.03.15;WA94;Möbel, Beleuchtungskörper usw.;1281207;1619047;-337840
01.03.15;WA95;Spielzeug, Spiele usw., Sportgeräte;305313;457790;-152477
01.03.15;WA96;Verschiedene Waren;316299;220436;95863
01.03.15;WA97;Kunstgegenstände, Sammlungsstücke;60711;37546;23165
01.03.15;WA98;Vollständige Fabrikationsanlagen;233541;3759;229782
01.03.15;WA99;Zusammenstellungen verschiedener Waren;1764990;887947;877043
01.03.16;WA01;Lebende Tiere;114280;162170;-47890
01.03.16;WA02;Fleisch;585538;527187;58351
01.03.16;WA03;Fische, Krebs- und Weichtiere;129627;330529;-200902
01.03.16;WA04;Milch, Milcherzeugnisse, Eier, Honig;687120;567750;119370
01.03.16;WA05;Andere Waren tierischen Ursprungs;59506;72734;-13228
01.03.16;WA06;Pflanzen, Waren des Blumenhandels;107732;310124;-202392
01.03.16;WA07;Gemüse, Pflanzen für Ernährung;89746;617458;-527712
01.03.16;WA08;Geniessbare Früchte und Nüsse;156083;747784;-591701
01.03.16;WA09;Kaffee, Tee, Mate, Gewürze;229368;337416;-108048
01.03.16;WA10;Getreide;288416;241309;47107
01.03.16;WA11;Müllereierzeugnisse, Malz usw.;118801;47560;71241
01.03.16;WA12;Ölsamen usw., Heilpflanzen usw.;176270;378599;-202329
01.03.16;WA13;Schellack, Gummen, Harz, Pflanzensaft;53830;48955;4875
01.03.16;WA14;Flechtstoffe usw. pflanzlichen Ursprungs;569;3116;-2547
01.03.16;WA15;Tierische und pflanzliche Fette, Öle, Wachs;219346;297813;-78467
01.03.16;WA16;Zubereitungen von Fleisch, Fisch usw.;231289;207785;23504
01.03.16;WA17;Zucker und Zuckerwaren;157320;139036;18284
01.03.16;WA18;Kakao und Zubereitungen aus Kakao;352307;368175;-15868
01.03.16;WA19;Zubereitungen aus Getreide usw., Backwaren;478052;336563;141489
01.03.16;WA20;Zubereitungen von Gemüse, Früchten usw.;219538;364677;-145139
01.03.16;WA21;Verschiedene Lebensmittelzubereitungen;448922;276259;172663
01.03.16;WA22;Getränke, alkoholhaltige Flüssigkeiten, Essig;467203;527036;-59833
01.03.16;WA23;Rückstände der Lebensmittelindustrie, Futter;321072;289339;31733
01.03.16;WA24;Tabak;401311;185501;215810
01.03.16;WA25;Salz, Schwefel, Steine, Erden usw.;177329;150221;27108
01.03.16;WA26;Erze, Schlacken, Aschen;29530;434816;-405286
01.03.16;WA27;Mineralische Brennstoffe usw.;1696203;5643366;-3947163
01.03.16;WA28;Anorganische chemische Erzeugnisse;656112;480864;175248
01.03.16;WA29;Organische chemische Erzeugnisse;1947698;2380899;-433201
01.03.16;WA30;Pharmazeutische Erzeugnisse;6114516;3684786;2429730
01.03.16;WA31;Düngemittel;204109;127249;76860
01.03.16;WA32;Gerb- und Farbstoffe, Farben, Lacke usw.;955823;488098;467725
01.03.16;WA33;Etherische Öle, Riech-, Schönheitsmittel;788268;549755;238513
01.03.16;WA34;Seifen, Waschmittel usw.;601644;319877;281767
01.03.16;WA35;Eiweissstoffe, Klebstoffe, Enzyme;263345;167883;95462
01.03.16;WA36;Sprengstoffe, pyrotechnische Artikel usw.;21548;14414;7134
01.03.16;WA37;Photochemische Erzeugnisse;111439;67079;44360
01.03.16;WA38;Verschiedene Erzeugnisse der Chemischen Industrie;1923800;1139500;784300
01.03.16;WA39;Kunststoffe und Waren daraus;4832676;3187100;1645576
01.03.16;WA40;Kautschuk und Waren daraus;1244279;1194949;49330
01.03.16;WA41;Häute, Felle, Leder;93110;68645;24465
01.03.16;WA42;Lederwaren, Sattlerwaren;167747;318690;-150943
01.03.16;WA43;Pelzfelle, künstliches Pelzwerk;7029;10455;-3426
01.03.16;WA44;Holz, Holzwaren, Holzkohle;645223;678874;-33651
01.03.16;WA45;Kork, Korkwaren;3106;9644;-6538
01.03.16;WA46;Flechtwaren, Korbmacherwaren;6447;13381;-6934
01.03.16;WA47;Halbstoffe aus Holz usw., Papierabfall;105972;338794;-232822
01.03.16;WA48;Papier, Pappe und Waren daraus;1493056;1021520;471536
01.03.16;WA49;Bücher, Zeitungen, Bilddrucke usw.;358320;214759;143561
01.03.16;WA50;Seide;4138;3797;341
01.03.16;WA51;Wolle, feine und grobe Tierhaare;55845;63046;-7201
01.03.16;WA52;Baumwolle;73475;78491;-5016
01.03.16;WA53;Andere pflanzliche Spinnstoffe, Papiergarn;3717;7195;-3478
01.03.16;WA54;Synthetisches oder künstliches Filament;166444;131009;35435
01.03.16;WA55;Synthetische oder künstliche Spinnfaser;151261;129032;22229
01.03.16;WA56;Watte, Filz, Vliesstoff usw., Tauwerk;213710;122863;90847
01.03.16;WA57;Teppiche, Fussbodenbelag aus Spinnstoff;48089;98517;-50428
01.03.16;WA58;Spezialgewebe, Spitzen, Tapisserien;44701;23761;20940
01.03.16;WA59;Getränkte, bestrichene usw. Gewebe;207562;100108;107454
01.03.16;WA60;Gewirke und Gestricke;74914;42487;32427
01.03.16;WA61;Bekleidung usw. aus Gewirken, Gestricken;607477;1196238;-588761
01.03.16;WA62;Andere Bekleidung, Bekleidungszubehör;725895;1375707;-649812
01.03.16;WA63;Andere Konfektion, Spinnstoffwaren usw.;239679;325589;-85910
01.03.16;WA64;Schuhe, Gamaschen, ähnliche Waren;489947;866861;-376914
01.03.16;WA65;Kopfbedeckungen und Teile davon;30966;49076;-18110
01.03.16;WA66;Schirme, Gehstöcke usw., Peitschen;25038;24023;1015
01.03.16;WA67;Zugerichtete Federn, Daunen, künstliche Blumen;10822;13145;-2323
01.03.16;WA68;Waren aus Steinen, Gips, Zement usw.;375245;253782;121463
01.03.16;WA69;Keramische Waren;267947;242051;25896
01.03.16;WA70;Glas und Glaswaren;525074;439337;85737
01.03.16;WA71;Perlen, Edelsteine, Edelmetalle;1069894;1314757;-244863
01.03.16;WA72;Eisen und Stahl;1593315;1638336;-45021
01.03.16;WA73;Waren aus Eisen oder Stahl;2149263;1676358;472905
01.03.16;WA74;Kupfer und Waren daraus;810679;727797;82882
01.03.16;WA75;Nickel und Waren daraus;71030;94711;-23681
01.03.16;WA76;Aluminium und Waren daraus;1203383;1278169;-74786
01.03.16;WA78;Blei und Waren daraus;21461;17909;3552
01.03.16;WA79;Zink und Waren daraus;49171;91574;-42403
01.03.16;WA80;Zinn und Waren daraus;7671;32741;-25070
01.03.16;WA81;Andere unedle Metalle, Cermets usw.;115991;139894;-23903
01.03.16;WA82;Werkzeuge, Schneidwaren, Essbestecke;662393;397806;264587
01.03.16;WA83;Verschiedene Waren aus unedlen Metallen;610324;395086;215238
01.03.16;WA84;Maschinen, Apparate, mechanische Geräte;17814424;10719138;7095286
01.03.16;WA85;Elektrotechnische Erzeugnisse;10629199;9773765;855434
01.03.16;WA86;Schienenfahrzeuge;348081;232970;115111
01.03.16;WA87;Kraftfahrzeuge, Landfahrzeuge;19633053;8645376;10987677
01.03.16;WA88;Luftfahrzeuge, Raumfahrzeuge;3879263;1570841;2308422
01.03.16;WA89;Wasserfahrzeuge;885224;173360;711864
01.03.16;WA90;Optische, photografische usw. Erzeugnisse;5044669;2966194;2078475
01.03.16;WA91;Uhrmacherwaren;139562;170436;-30874
01.03.16;WA92;Musikinstrumente;43530;43718;-188
01.03.16;WA93;Waffen und Munition;37519;18857;18662
01.03.16;WA94;Möbel, Beleuchtungskörper usw.;1328282;1627118;-298836
01.03.16;WA95;Spielzeug, Spiele usw., Sportgeräte;398133;429973;-31840
01.03.16;WA96;Verschiedene Waren;325349;226911;98438
01.03.16;WA97;Kunstgegenstände, Sammlungsstücke;52452;51146;1306
01.03.16;WA98;Vollständige Fabrikationsanlagen;239405;100;239305
01.03.16;WA99;Zusammenstellungen verschiedener Waren;2416384;875345;1541039
01.03.17;WA01;Lebende Tiere;114185;156575;-42390
01.03.17;WA02;Fleisch;629452;530588;98864
01.03.17;WA03;Fische, Krebs- und Weichtiere;136051;342091;-206040
01.03.17;WA04;Milch, Milcherzeugnisse, Eier, Honig;789426;670917;118509
01.03.17;WA05;Andere Waren tierischen Ursprungs;75345;77839;-2494
01.03.17;WA06;Pflanzen, Waren des Blumenhandels;103737;273591;-169854
01.03.17;WA07;Gemüse, Pflanzen für Ernährung;105768;632900;-527132
01.03.17;WA08;Geniessbare Früchte und Nüsse;147633;733952;-586319
01.03.17;WA09;Kaffee, Tee, Mate, Gewürze;258728;419589;-160861
01.03.17;WA10;Getreide;303463;255201;48262
01.03.17;WA11;Müllereierzeugnisse, Malz usw.;132187;44712;87475
01.03.17;WA12;Ölsamen usw., Heilpflanzen usw.;165988;417789;-251801
01.03.17;WA13;Schellack, Gummen, Harz, Pflanzensaft;64376;41329;23047
01.03.17;WA14;Flechtstoffe usw. pflanzlichen Ursprungs;786;2551;-1765
01.03.17;WA15;Tierische und pflanzliche Fette, Öle, Wachs;266964;343847;-76883
01.03.17;WA16;Zubereitungen von Fleisch, Fisch usw.;212317;211316;1001
01.03.17;WA17;Zucker und Zuckerwaren;175059;135639;39420
01.03.17;WA18;Kakao und Zubereitungen aus Kakao;374633;358540;16093
01.03.17;WA19;Zubereitungen aus Getreide usw., Backwaren;541942;311940;230002
01.03.17;WA20;Zubereitungen von Gemüse, Früchten usw.;238293;410708;-172415
01.03.17;WA21;Verschiedene Lebensmittelzubereitungen;499981;282082;217899
01.03.17;WA22;Getränke, alkoholhaltige Flüssigkeiten, Essig;488923;578962;-90039
01.03.17;WA23;Rückstände der Lebensmittelindustrie, Futter;310198;326115;-15917
01.03.17;WA24;Tabak;356132;168784;187348
01.03.17;WA25;Salz, Schwefel, Steine, Erden usw.;178584;170033;8551
01.03.17;WA26;Erze, Schlacken, Aschen;51941;781694;-729753
01.03.17;WA27;Mineralische Brennstoffe usw.;2139845;7377557;-5237712
01.03.17;WA28;Anorganische chemische Erzeugnisse;759600;700371;59229
01.03.17;WA29;Organische chemische Erzeugnisse;2283766;3499535;-1215769
01.03.17;WA30;Pharmazeutische Erzeugnisse;6912428;4250887;2661541
01.03.17;WA31;Düngemittel;220308;131251;89057
01.03.17;WA32;Gerb- und Farbstoffe, Farben, Lacke usw.;1020417;582211;438206
01.03.17;WA33;Etherische Öle, Riech-, Schönheitsmittel;855973;585553;270420
01.03.17;WA34;Seifen, Waschmittel usw.;676503;324601;351902
01.03.17;WA35;Eiweissstoffe, Klebstoffe, Enzyme;289343;184966;104377
01.03.17;WA36;Sprengstoffe, pyrotechnische Artikel usw.;24641;12012;12629
01.03.17;WA37;Photochemische Erzeugnisse;113762;80809;32953
01.03.17;WA38;Verschiedene Erzeugnisse der Chemischen Industrie;2154109;1238989;915120
01.03.17;WA39;Kunststoffe und Waren daraus;5433811;3409655;2024156
01.03.17;WA40;Kautschuk und Waren daraus;1459516;1332169;127347
01.03.17;WA41;Häute, Felle, Leder;86659;77304;9355
01.03.17;WA42;Lederwaren, Sattlerwaren;192139;344356;-152217
01.03.17;WA43;Pelzfelle, künstliches Pelzwerk;10254;11415;-1161
01.03.17;WA44;Holz, Holzwaren, Holzkohle;696027;673728;22299
01.03.17;WA45;Kork, Korkwaren;2633;9190;-6557
01.03.17;WA46;Flechtwaren, Korbmacherwaren;4548;13150;-8602
01.03.17;WA47;Halbstoffe aus Holz usw., Papierabfall;113242;324133;-210891
01.03.17;WA48;Papier, Pappe und Waren daraus;1520484;1052038;468446
01.03.17;WA49;Bücher, Zeitungen, Bilddrucke usw.;338327;213448;124879
01.03.17;WA50;Seide;5409;4525;884
01.03.17;WA51;Wolle, feine und grobe Tierhaare;50437;54240;-3803
01.03.17;WA52;Baumwolle;77883;84417;-6534
01.03.17;WA53;Andere pflanzliche Spinnstoffe, Papiergarn;3698;6263;-2565
01.03.17;WA54;Synthetisches oder künstliches Filament;181738;141801;39937
01.03.17;WA55;Synthetische oder künstliche Spinnfaser;167187;130683;36504
01.03.17;WA56;Watte, Filz, Vliesstoff usw., Tauwerk;216394;127756;88638
01.03.17;WA57;Teppiche, Fussbodenbelag aus Spinnstoff;46640;94232;-47592
01.03.17;WA58;Spezialgewebe, Spitzen, Tapisserien;46633;23723;22910
01.03.17;WA59;Getränkte, bestrichene usw. Gewebe;227818;107657;120161
01.03.17;WA60;Gewirke und Gestricke;82685;46003;36682
01.03.17;WA61;Bekleidung usw. aus Gewirken, Gestricken;690435;1358378;-667943
01.03.17;WA62;Andere Bekleidung, Bekleidungszubehör;858649;1525337;-666688
01.03.17;WA63;Andere Konfektion, Spinnstoffwaren usw.;211610;327292;-115682
01.03.17;WA64;Schuhe, Gamaschen, ähnliche Waren;634164;995856;-361692
01.03.17;WA65;Kopfbedeckungen und Teile davon;34460;54379;-19919
01.03.17;WA66;Schirme, Gehstöcke usw., Peitschen;8480;25895;-17415
01.03.17;WA67;Zugerichtete Federn, Daunen, künstliche Blumen;11430;14881;-3451
01.03.17;WA68;Waren aus Steinen, Gips, Zement usw.;421225;273416;147809
01.03.17;WA69;Keramische Waren;278838;227082;51756
01.03.17;WA70;Glas und Glaswaren;566405;460809;105596
01.03.17;WA71;Perlen, Edelsteine, Edelmetalle;1111014;1586651;-475637
01.03.17;WA72;Eisen und Stahl;2171099;2362505;-191406
01.03.17;WA73;Waren aus Eisen oder Stahl;2431584;1795233;636351
01.03.17;WA74;Kupfer und Waren daraus;971672;807167;164505
01.03.17;WA75;Nickel und Waren daraus;91939;108442;-16503
01.03.17;WA76;Aluminium und Waren daraus;1305638;1412392;-106754
01.03.17;WA78;Blei und Waren daraus;42476;56285;-13809
01.03.17;WA79;Zink und Waren daraus;68255;143274;-75019
01.03.17;WA80;Zinn und Waren daraus;11105;36275;-25170
01.03.17;WA81;Andere unedle Metalle, Cermets usw.;142217;170567;-28350
01.03.17;WA82;Werkzeuge, Schneidwaren, Essbestecke;749001;425452;323549
01.03.17;WA83;Verschiedene Waren aus unedlen Metallen;693313;414037;279276
01.03.17;WA84;Maschinen, Apparate, mechanische Geräte;20405524;12126504;8279020
01.03.17;WA85;Elektrotechnische Erzeugnisse;11700782;11049517;651265
01.03.17;WA86;Schienenfahrzeuge;345155;257393;87762
01.03.17;WA87;Kraftfahrzeuge, Landfahrzeuge;22289229;10206588;12082641
01.03.17;WA88;Luftfahrzeuge, Raumfahrzeuge;3433322;1681009;1752313
01.03.17;WA89;Wasserfahrzeuge;1253137;50353;1202784
01.03.17;WA90;Optische, photografische usw. Erzeugnisse;5916493;3246282;2670211
01.03.17;WA91;Uhrmacherwaren;145860;163934;-18074
01.03.17;WA92;Musikinstrumente;52189;48116;4073
01.03.17;WA93;Waffen und Munition;40856;17059;23797
01.03.17;WA94;Möbel, Beleuchtungskörper usw.;1363120;1640847;-277727
01.03.17;WA95;Spielzeug, Spiele usw., Sportgeräte;326532;502292;-175760
01.03.17;WA96;Verschiedene Waren;357631;259379;98252
01.03.17;WA97;Kunstgegenstände, Sammlungsstücke;75536;37873;37663
01.03.17;WA98;Vollständige Fabrikationsanlagen;191233;NULL;#WERT!
01.03.17;WA99;Zusammenstellungen verschiedener Waren;1559344;987746;571598
01.03.18;WA01;Lebende Tiere;103693;143056;-39363
01.03.18;WA02;Fleisch;636145;581711;54434
01.03.18;WA03;Fische, Krebs- und Weichtiere;128885;352180;-223295
01.03.18;WA04;Milch, Milcherzeugnisse, Eier, Honig;777487;727473;50014
01.03.18;WA05;Andere Waren tierischen Ursprungs;77962;85472;-7510
01.03.18;WA06;Pflanzen, Waren des Blumenhandels;105418;310821;-205403
01.03.18;WA07;Gemüse, Pflanzen für Ernährung;96404;594407;-498003
01.03.18;WA08;Geniessbare Früchte und Nüsse;145204;840626;-695422
01.03.18;WA09;Kaffee, Tee, Mate, Gewürze;244132;305083;-60951
01.03.18;WA10;Getreide;182198;227660;-45462
01.03.18;WA11;Müllereierzeugnisse, Malz usw.;126743;47997;78746
01.03.18;WA12;Ölsamen usw., Heilpflanzen usw.;168987;431329;-262342
01.03.18;WA13;Schellack, Gummen, Harz, Pflanzensaft;65750;60285;5465
01.03.18;WA14;Flechtstoffe usw. pflanzlichen Ursprungs;787;3856;-3069
01.03.18;WA15;Tierische und pflanzliche Fette, Öle, Wachs;248372;322537;-74165
01.03.18;WA16;Zubereitungen von Fleisch, Fisch usw.;243798;240917;2881
01.03.18;WA17;Zucker und Zuckerwaren;175414;116147;59267
01.03.18;WA18;Kakao und Zubereitungen aus Kakao;379051;332316;46735
01.03.18;WA19;Zubereitungen aus Getreide usw., Backwaren;550015;339140;210875
01.03.18;WA20;Zubereitungen von Gemüse, Früchten usw.;241787;400714;-158927
01.03.18;WA21;Verschiedene Lebensmittelzubereitungen;478460;280703;197757
01.03.18;WA22;Getränke, alkoholhaltige Flüssigkeiten, Essig;478267;564899;-86632
01.03.18;WA23;Rückstände der Lebensmittelindustrie, Futter;340611;288540;52071
01.03.18;WA24;Tabak;318803;181536;137267
01.03.18;WA25;Salz, Schwefel, Steine, Erden usw.;164580;166090;-1510
01.03.18;WA26;Erze, Schlacken, Aschen;42938;603613;-560675
01.03.18;WA27;Mineralische Brennstoffe usw.;2582396;8254802;-5672406
01.03.18;WA28;Anorganische chemische Erzeugnisse;744418;544986;199432
01.03.18;WA29;Organische chemische Erzeugnisse;2239288;2852201;-612913
01.03.18;WA30;Pharmazeutische Erzeugnisse;7404314;3935013;3469301
01.03.18;WA31;Düngemittel;186099;90854;95245
01.03.18;WA32;Gerb- und Farbstoffe, Farben, Lacke usw.;982314;516899;465415
01.03.18;WA33;Etherische Öle, Riech-, Schönheitsmittel;861096;619814;241282
01.03.18;WA34;Seifen, Waschmittel usw.;663369;336903;326466
01.03.18;WA35;Eiweissstoffe, Klebstoffe, Enzyme;294792;175702;119090
01.03.18;WA36;Sprengstoffe, pyrotechnische Artikel usw.;24103;12092;12011
01.03.18;WA37;Photochemische Erzeugnisse;107786;70127;37659
01.03.18;WA38;Verschiedene Erzeugnisse der Chemischen Industrie;2041145;1243034;798111
01.03.18;WA39;Kunststoffe und Waren daraus;5379796;3497495;1882301
01.03.18;WA40;Kautschuk und Waren daraus;1343968;1292574;51394
01.03.18;WA41;Häute, Felle, Leder;86926;73123;13803
01.03.18;WA42;Lederwaren, Sattlerwaren;183641;299235;-115594
01.03.18;WA43;Pelzfelle, künstliches Pelzwerk;10492;12748;-2256
01.03.18;WA44;Holz, Holzwaren, Holzkohle;700242;707788;-7546
01.03.18;WA45;Kork, Korkwaren;2414;8676;-6262
01.03.18;WA46;Flechtwaren, Korbmacherwaren;4373;9724;-5351
01.03.18;WA47;Halbstoffe aus Holz usw., Papierabfall;91411;336785;-245374
01.03.18;WA48;Papier, Pappe und Waren daraus;1544461;1074683;469778
01.03.18;WA49;Bücher, Zeitungen, Bilddrucke usw.;350690;229588;121102
01.03.18;WA50;Seide;5720;5586;134
01.03.18;WA51;Wolle, feine und grobe Tierhaare;45880;51977;-6097
01.03.18;WA52;Baumwolle;70525;74656;-4131
01.03.18;WA53;Andere pflanzliche Spinnstoffe, Papiergarn;3080;5215;-2135
01.03.18;WA54;Synthetisches oder künstliches Filament;170769;142160;28609
01.03.18;WA55;Synthetische oder künstliche Spinnfaser;159988;134560;25428
01.03.18;WA56;Watte, Filz, Vliesstoff usw., Tauwerk;210343;129657;80686
01.03.18;WA57;Teppiche, Fussbodenbelag aus Spinnstoff;47709;93418;-45709
01.03.18;WA58;Spezialgewebe, Spitzen, Tapisserien;44172;23216;20956
01.03.18;WA59;Getränkte, bestrichene usw. Gewebe;232568;97023;135545
01.03.18;WA60;Gewirke und Gestricke;71638;46316;25322
01.03.18;WA61;Bekleidung usw. aus Gewirken, Gestricken;709005;1229432;-520427
01.03.18;WA62;Andere Bekleidung, Bekleidungszubehör;913034;1378887;-465853
01.03.18;WA63;Andere Konfektion, Spinnstoffwaren usw.;214253;308066;-93813
01.03.18;WA64;Schuhe, Gamaschen, ähnliche Waren;627263;855469;-228206
01.03.18;WA65;Kopfbedeckungen und Teile davon;38741;49274;-10533
01.03.18;WA66;Schirme, Gehstöcke usw., Peitschen;10709;29279;-18570
01.03.18;WA67;Zugerichtete Federn, Daunen, künstliche Blumen;11432;15288;-3856
01.03.18;WA68;Waren aus Steinen, Gips, Zement usw.;406297;280479;125818
01.03.18;WA69;Keramische Waren;292626;244403;48223
01.03.18;WA70;Glas und Glaswaren;559730;462699;97031
01.03.18;WA71;Perlen, Edelsteine, Edelmetalle;1063921;1444401;-380480
01.03.18;WA72;Eisen und Stahl;2158049;2422360;-264311
01.03.18;WA73;Waren aus Eisen oder Stahl;2434615;1859850;574765
01.03.18;WA74;Kupfer und Waren daraus;1035046;860475;174571
01.03.18;WA75;Nickel und Waren daraus;111008;134474;-23466
01.03.18;WA76;Aluminium und Waren daraus;1334310;1413149;-78839
01.03.18;WA78;Blei und Waren daraus;28852;39087;-10235
01.03.18;WA79;Zink und Waren daraus;65554;152476;-86922
01.03.18;WA80;Zinn und Waren daraus;9450;41386;-31936
01.03.18;WA81;Andere unedle Metalle, Cermets usw.;126738;185480;-58742
01.03.18;WA82;Werkzeuge, Schneidwaren, Essbestecke;759834;443166;316668
01.03.18;WA83;Verschiedene Waren aus unedlen Metallen;647944;433517;214427
01.03.18;WA84;Maschinen, Apparate, mechanische Geräte;20414749;11736211;8678538
01.03.18;WA85;Elektrotechnische Erzeugnisse;11646427;10925579;720848
01.03.18;WA86;Schienenfahrzeuge;315238;172750;142488
01.03.18;WA87;Kraftfahrzeuge, Landfahrzeuge;20947397;10411334;10536063
01.03.18;WA88;Luftfahrzeuge, Raumfahrzeuge;3075950;1145892;1930058
01.03.18;WA89;Wasserfahrzeuge;1055336;52159;1003177
01.03.18;WA90;Optische, photografische usw. Erzeugnisse;5843829;3138525;2705304
01.03.18;WA91;Uhrmacherwaren;128172;144608;-16436
01.03.18;WA92;Musikinstrumente;52764;50865;1899
01.03.18;WA93;Waffen und Munition;40472;21249;19223
01.03.18;WA94;Möbel, Beleuchtungskörper usw.;1341415;1614741;-273326
01.03.18;WA95;Spielzeug, Spiele usw., Sportgeräte;339959;511666;-171707
01.03.18;WA96;Verschiedene Waren;340313;243258;97055
01.03.18;WA97;Kunstgegenstände, Sammlungsstücke;76648;57811;18837
01.03.18;WA98;Vollständige Fabrikationsanlagen;118147;4143;114004
01.03.18;WA99;Zusammenstellungen verschiedener Waren;1379409;1001576;377833
01.03.19;WA01;Lebende Tiere;105558;130497;-24939
01.03.19;WA02;Fleisch;613089;552144;60945
01.03.19;WA03;Fische, Krebs- und Weichtiere;132945;336147;-203202
01.03.19;WA04;Milch, Milcherzeugnisse, Eier, Honig;817376;690291;127085
01.03.19;WA05;Andere Waren tierischen Ursprungs;82593;79023;3570
01.03.19;WA06;Pflanzen, Waren des Blumenhandels;108527;320399;-211872
01.03.19;WA07;Gemüse, Pflanzen für Ernährung;115020;624680;-509660
01.03.19;WA08;Geniessbare Früchte und Nüsse;150516;746855;-596339
01.03.19;WA09;Kaffee, Tee, Mate, Gewürze;221934;285769;-63835
01.03.19;WA10;Getreide;153205;269906;-116701
01.03.19;WA11;Müllereierzeugnisse, Malz usw.;138668;52728;85940
01.03.19;WA12;Ölsamen usw., Heilpflanzen usw.;165617;457456;-291839
01.03.19;WA13;Schellack, Gummen, Harz, Pflanzensaft;64777;47825;16952
01.03.19;WA14;Flechtstoffe usw. pflanzlichen Ursprungs;846;4221;-3375
01.03.19;WA15;Tierische und pflanzliche Fette, Öle, Wachs;216823;293948;-77125
01.03.19;WA16;Zubereitungen von Fleisch, Fisch usw.;244175;228130;16045
01.03.19;WA17;Zucker und Zuckerwaren;174865;133353;41512
01.03.19;WA18;Kakao und Zubereitungen aus Kakao;450764;368682;82082
01.03.19;WA19;Zubereitungen aus Getreide usw., Backwaren;552975;348380;204595
01.03.19;WA20;Zubereitungen von Gemüse, Früchten usw.;252525;401861;-149336
01.03.19;WA21;Verschiedene Lebensmittelzubereitungen;536573;312123;224450
01.03.19;WA22;Getränke, alkoholhaltige Flüssigkeiten, Essig;476923;628595;-151672
01.03.19;WA23;Rückstände der Lebensmittelindustrie, Futter;351236;321285;29951
01.03.19;WA24;Tabak;316496;211349;105147
01.03.19;WA25;Salz, Schwefel, Steine, Erden usw.;170901;160148;10753
01.03.19;WA26;Erze, Schlacken, Aschen;42920;670727;-627807
01.03.19;WA27;Mineralische Brennstoffe usw.;2930683;8427000;-5496317
01.03.19;WA28;Anorganische chemische Erzeugnisse;859159;508519;350640
01.03.19;WA29;Organische chemische Erzeugnisse;2242999;2440741;-197742
01.03.19;WA30;Pharmazeutische Erzeugnisse;6411394;4616604;1794790
01.03.19;WA31;Düngemittel;251437;101396;150041
01.03.19;WA32;Gerb- und Farbstoffe, Farben, Lacke usw.;1039818;526076;513742
01.03.19;WA33;Etherische Öle, Riech-, Schönheitsmittel;920911;635060;285851
01.03.19;WA34;Seifen, Waschmittel usw.;681809;360326;321483
01.03.19;WA35;Eiweissstoffe, Klebstoffe, Enzyme;304443;192578;111865
01.03.19;WA36;Sprengstoffe, pyrotechnische Artikel usw.;29478;12602;16876
01.03.19;WA37;Photochemische Erzeugnisse;110145;78204;31941
01.03.19;WA38;Verschiedene Erzeugnisse der Chemischen Industrie;2194619;1324670;869949
01.03.19;WA39;Kunststoffe und Waren daraus;5346176;3551746;1794430
01.03.19;WA40;Kautschuk und Waren daraus;1332232;1195729;136503
01.03.19;WA41;Häute, Felle, Leder;69319;51785;17534
01.03.19;WA42;Lederwaren, Sattlerwaren;209400;345255;-135855
01.03.19;WA43;Pelzfelle, künstliches Pelzwerk;11601;12220;-619
01.03.19;WA44;Holz, Holzwaren, Holzkohle;741743;705911;35832
01.03.19;WA45;Kork, Korkwaren;2740;10253;-7513
01.03.19;WA46;Flechtwaren, Korbmacherwaren;4928;9544;-4616
01.03.19;WA47;Halbstoffe aus Holz usw., Papierabfall;111762;327148;-215386
01.03.19;WA48;Papier, Pappe und Waren daraus;1626782;1079735;547047
01.03.19;WA49;Bücher, Zeitungen, Bilddrucke usw.;358225;219299;138926
01.03.19;WA50;Seide;3147;2860;287
01.03.19;WA51;Wolle, feine und grobe Tierhaare;44432;55721;-11289
01.03.19;WA52;Baumwolle;62990;65459;-2469
01.03.19;WA53;Andere pflanzliche Spinnstoffe, Papiergarn;3248;5886;-2638
01.03.19;WA54;Synthetisches oder künstliches Filament;162961;129662;33299
01.03.19;WA55;Synthetische oder künstliche Spinnfaser;143152;128392;14760
01.03.19;WA56;Watte, Filz, Vliesstoff usw., Tauwerk;225362;129243;96119
01.03.19;WA57;Teppiche, Fussbodenbelag aus Spinnstoff;44199;89922;-45723
01.03.19;WA58;Spezialgewebe, Spitzen, Tapisserien;46047;23247;22800
01.03.19;WA59;Getränkte, bestrichene usw. Gewebe;210786;100934;109852
01.03.19;WA60;Gewirke und Gestricke;68813;40854;27959
01.03.19;WA61;Bekleidung usw. aus Gewirken, Gestricken;834576;1321171;-486595
01.03.19;WA62;Andere Bekleidung, Bekleidungszubehör;1025239;1489116;-463877
01.03.19;WA63;Andere Konfektion, Spinnstoffwaren usw.;227312;311569;-84257
01.03.19;WA64;Schuhe, Gamaschen, ähnliche Waren;756809;1001185;-244376
01.03.19;WA65;Kopfbedeckungen und Teile davon;43651;57149;-13498
01.03.19;WA66;Schirme, Gehstöcke usw., Peitschen;7584;26396;-18812
01.03.19;WA67;Zugerichtete Federn, Daunen, künstliche Blumen;13341;16756;-3415
01.03.19;WA68;Waren aus Steinen, Gips, Zement usw.;425402;303892;121510
01.03.19;WA69;Keramische Waren;336269;249980;86289
01.03.19;WA70;Glas und Glaswaren;588233;438161;150072
01.03.19;WA71;Perlen, Edelsteine, Edelmetalle;1307367;1356572;-49205
01.03.19;WA72;Eisen und Stahl;2238193;2373022;-134829
01.03.19;WA73;Waren aus Eisen oder Stahl;2584172;1884022;700150
01.03.19;WA74;Kupfer und Waren daraus;940375;900894;39481
01.03.19;WA75;Nickel und Waren daraus;123409;154452;-31043
01.03.19;WA76;Aluminium und Waren daraus;1190294;1400746;-210452
01.03.19;WA78;Blei und Waren daraus;33680;37944;-4264
01.03.19;WA79;Zink und Waren daraus;65729;128022;-62293
01.03.19;WA80;Zinn und Waren daraus;8329;44524;-36195
01.03.19;WA81;Andere unedle Metalle, Cermets usw.;141191;166356;-25165
01.03.19;WA82;Werkzeuge, Schneidwaren, Essbestecke;765574;454041;311533
01.03.19;WA83;Verschiedene Waren aus unedlen Metallen;656420;422887;233533
01.03.19;WA84;Maschinen, Apparate, mechanische Geräte;21104890;12897745;8207145
01.03.19;WA85;Elektrotechnische Erzeugnisse;12111801;11461383;650418
01.03.19;WA86;Schienenfahrzeuge;321065;271527;49538
01.03.19;WA87;Kraftfahrzeuge, Landfahrzeuge;19903286;10982049;8921237
01.03.19;WA88;Luftfahrzeuge, Raumfahrzeuge;3144267;1515643;1628624
01.03.19;WA89;Wasserfahrzeuge;1787302;910366;876936
01.03.19;WA90;Optische, photografische usw. Erzeugnisse;6254328;3399043;2855285
01.03.19;WA91;Uhrmacherwaren;130901;142453;-11552
01.03.19;WA92;Musikinstrumente;57675;51546;6129
01.03.19;WA93;Waffen und Munition;42541;21152;21389
01.03.19;WA94;Möbel, Beleuchtungskörper usw.;1355582;1640534;-284952
01.03.19;WA95;Spielzeug, Spiele usw., Sportgeräte;336481;486683;-150202
01.03.19;WA96;Verschiedene Waren;338347;232165;106182
01.03.19;WA97;Kunstgegenstände, Sammlungsstücke;74938;41516;33422
01.03.19;WA98;Vollständige Fabrikationsanlagen;137942;6;137936
01.03.19;WA99;Zusammenstellungen verschiedener Waren;1339841;1068426;271415
01.03.20;WA01;Lebende Tiere;111564;179073;-67509
01.03.20;WA02;Fleisch;715820;591724;124096
01.03.20;WA03;Fische, Krebs- und Weichtiere;113718;350499;-236781
01.03.20;WA04;Milch, Milcherzeugnisse, Eier, Honig;838787;736461;102326
01.03.20;WA05;Andere Waren tierischen Ursprungs;87078;76586;10492
01.03.20;WA06;Pflanzen, Waren des Blumenhandels;103226;275873;-172647
01.03.20;WA07;Gemüse, Pflanzen für Ernährung;119055;718978;-599923
01.03.20;WA08;Geniessbare Früchte und Nüsse;170362;952280;-781918
01.03.20;WA09;Kaffee, Tee, Mate, Gewürze;258580;360270;-101690
01.03.20;WA10;Getreide;396913;287856;109057
01.03.20;WA11;Müllereierzeugnisse, Malz usw.;149795;58343;91452
01.03.20;WA12;Ölsamen usw., Heilpflanzen usw.;201787;426676;-224889
01.03.20;WA13;Schellack, Gummen, Harz, Pflanzensaft;70860;60453;10407
01.03.20;WA14;Flechtstoffe usw. pflanzlichen Ursprungs;657;4027;-3370
01.03.20;WA15;Tierische und pflanzliche Fette, Öle, Wachs;227313;329751;-102438
01.03.20;WA16;Zubereitungen von Fleisch, Fisch usw.;253424;277187;-23763
01.03.20;WA17;Zucker und Zuckerwaren;190387;142490;47897
01.03.20;WA18;Kakao und Zubereitungen aus Kakao;399308;383548;15760
01.03.20;WA19;Zubereitungen aus Getreide usw., Backwaren;605868;410543;195325
01.03.20;WA20;Zubereitungen von Gemüse, Früchten usw.;280187;483148;-202961
01.03.20;WA21;Verschiedene Lebensmittelzubereitungen;554144;335135;219009
01.03.20;WA22;Getränke, alkoholhaltige Flüssigkeiten, Essig;448056;599858;-151802
01.03.20;WA23;Rückstände der Lebensmittelindustrie, Futter;438643;338194;100449
01.03.20;WA24;Tabak;232236;234031;-1795
01.03.20;WA25;Salz, Schwefel, Steine, Erden usw.;165059;155260;9799
01.03.20;WA26;Erze, Schlacken, Aschen;35626;842711;-807085
01.03.20;WA27;Mineralische Brennstoffe usw.;2316962;6715546;-4398584
01.03.20;WA28;Anorganische chemische Erzeugnisse;1048337;563327;485010
01.03.20;WA29;Organische chemische Erzeugnisse;2288686;3188545;-899859
01.03.20;WA30;Pharmazeutische Erzeugnisse;8259806;5646179;2613627
01.03.20;WA31;Düngemittel;214379;83633;130746
01.03.20;WA32;Gerb- und Farbstoffe, Farben, Lacke usw.;1037300;516608;520692
01.03.20;WA33;Etherische Öle, Riech-, Schönheitsmittel;808826;556227;252599
01.03.20;WA34;Seifen, Waschmittel usw.;695327;364276;331051
01.03.20;WA35;Eiweissstoffe, Klebstoffe, Enzyme;336037;197441;138596
01.03.20;WA36;Sprengstoffe, pyrotechnische Artikel usw.;27019;12609;14410
01.03.20;WA37;Photochemische Erzeugnisse;113299;72702;40597
01.03.20;WA38;Verschiedene Erzeugnisse der Chemischen Industrie;2155545;1327156;828389
01.03.20;WA39;Kunststoffe und Waren daraus;5306457;3400559;1905898
01.03.20;WA40;Kautschuk und Waren daraus;1122977;1093728;29249
01.03.20;WA41;Häute, Felle, Leder;56427;47624;8803
01.03.20;WA42;Lederwaren, Sattlerwaren;171450;291020;-119570
01.03.20;WA43;Pelzfelle, künstliches Pelzwerk;2480;4311;-1831
01.03.20;WA44;Holz, Holzwaren, Holzkohle;695557;661125;34432
01.03.20;WA45;Kork, Korkwaren;2416;11120;-8704
01.03.20;WA46;Flechtwaren, Korbmacherwaren;4041;11551;-7510
01.03.20;WA47;Halbstoffe aus Holz usw., Papierabfall;72921;244575;-171654
01.03.20;WA48;Papier, Pappe und Waren daraus;1523542;1048674;474868
01.03.20;WA49;Bücher, Zeitungen, Bilddrucke usw.;287168;200336;86832
01.03.20;WA50;Seide;2014;2733;-719
01.03.20;WA51;Wolle, feine und grobe Tierhaare;36613;44308;-7695
01.03.20;WA52;Baumwolle;55074;62538;-7464
01.03.20;WA53;Andere pflanzliche Spinnstoffe, Papiergarn;2400;5790;-3390
01.03.20;WA54;Synthetisches oder künstliches Filament;143020;129037;13983
01.03.20;WA55;Synthetische oder künstliche Spinnfaser;140890;114368;26522
01.03.20;WA56;Watte, Filz, Vliesstoff usw., Tauwerk;216041;140052;75989
01.03.20;WA57;Teppiche, Fussbodenbelag aus Spinnstoff;38766;82811;-44045
01.03.20;WA58;Spezialgewebe, Spitzen, Tapisserien;38929;19189;19740
01.03.20;WA59;Getränkte, bestrichene usw. Gewebe;210947;101987;108960
01.03.20;WA60;Gewirke und Gestricke;60265;43414;16851
01.03.20;WA61;Bekleidung usw. aus Gewirken, Gestricken;688005;1344886;-656881
01.03.20;WA62;Andere Bekleidung, Bekleidungszubehör;810192;1438318;-628126
01.03.20;WA63;Andere Konfektion, Spinnstoffwaren usw.;217923;396004;-178081
01.03.20;WA64;Schuhe, Gamaschen, ähnliche Waren;596978;906206;-309228
01.03.20;WA65;Kopfbedeckungen und Teile davon;34118;55047;-20929
01.03.20;WA66;Schirme, Gehstöcke usw., Peitschen;6361;25436;-19075
01.03.20;WA67;Zugerichtete Federn, Daunen, künstliche Blumen;10172;14395;-4223
01.03.20;WA68;Waren aus Steinen, Gips, Zement usw.;418578;284261;134317
01.03.20;WA69;Keramische Waren;289387;215300;74087
01.03.20;WA70;Glas und Glaswaren;517049;398350;118699
01.03.20;WA71;Perlen, Edelsteine, Edelmetalle;1628326;3065919;-1437593
01.03.20;WA72;Eisen und Stahl;1843308;1824479;18829
01.03.20;WA73;Waren aus Eisen oder Stahl;2260221;1717233;542988
01.03.20;WA74;Kupfer und Waren daraus;912514;733766;178748
01.03.20;WA75;Nickel und Waren daraus;120926;117892;3034
01.03.20;WA76;Aluminium und Waren daraus;1216993;1216677;316
01.03.20;WA78;Blei und Waren daraus;28875;42102;-13227
01.03.20;WA79;Zink und Waren daraus;55739;106895;-51156
01.03.20;WA80;Zinn und Waren daraus;8424;28169;-19745
01.03.20;WA81;Andere unedle Metalle, Cermets usw.;125916;145724;-19808
01.03.20;WA82;Werkzeuge, Schneidwaren, Essbestecke;688463;411579;276884
01.03.20;WA83;Verschiedene Waren aus unedlen Metallen;578108;388501;189607
01.03.20;WA84;Maschinen, Apparate, mechanische Geräte;19308921;11742523;7566398
01.03.20;WA85;Elektrotechnische Erzeugnisse;11521599;10835278;686321
01.03.20;WA86;Schienenfahrzeuge;329670;260307;69363
01.03.20;WA87;Kraftfahrzeuge, Landfahrzeuge;15746843;9116806;6630037
01.03.20;WA88;Luftfahrzeuge, Raumfahrzeuge;2204279;1272824;931455
01.03.20;WA89;Wasserfahrzeuge;1123190;573420;549770
01.03.20;WA90;Optische, photografische usw. Erzeugnisse;5955458;3384012;2571446
01.03.20;WA91;Uhrmacherwaren;86315;118183;-31868
01.03.20;WA92;Musikinstrumente;47402;57682;-10280
01.03.20;WA93;Waffen und Munition;34985;19895;15090
01.03.20;WA94;Möbel, Beleuchtungskörper usw.;1183576;1439135;-255559
01.03.20;WA95;Spielzeug, Spiele usw., Sportgeräte;336899;491686;-154787
01.03.20;WA96;Verschiedene Waren;357305;235271;122034
01.03.20;WA97;Kunstgegenstände, Sammlungsstücke;64168;90845;-26677
01.03.20;WA98;Vollständige Fabrikationsanlagen;118399;6;118393
01.03.20;WA99;Zusammenstellungen verschiedener Waren;1134828;990834;143994
01.03.21;WA01;Lebende Tiere;94380;117695;-23315
01.03.21;WA02;Fleisch;589330;540938;48392
01.03.21;WA03;Fische, Krebs- und Weichtiere;103463;331373;-227910
01.03.21;WA04;Milch, Milcherzeugnisse, Eier, Honig;896113;774813;121300
01.03.21;WA05;Andere Waren tierischen Ursprungs;85337;85696;-359
01.03.21;WA06;Pflanzen, Waren des Blumenhandels;121295;417157;-295862
01.03.21;WA07;Gemüse, Pflanzen für Ernährung;110472;799871;-689399
01.03.21;WA08;Geniessbare Früchte und Nüsse;191891;915912;-724021
01.03.21;WA09;Kaffee, Tee, Mate, Gewürze;245358;346835;-101477
01.03.21;WA10;Getreide;295859;298418;-2559
01.03.21;WA11;Müllereierzeugnisse, Malz usw.;157574;65896;91678
01.03.21;WA12;Ölsamen usw., Heilpflanzen usw.;190650;598885;-408235
01.03.21;WA13;Schellack, Gummen, Harz, Pflanzensaft;67123;63315;3808
01.03.21;WA14;Flechtstoffe usw. pflanzlichen Ursprungs;1259;3179;-1920
01.03.21;WA15;Tierische und pflanzliche Fette, Öle, Wachs;307269;312344;-5075
01.03.21;WA16;Zubereitungen von Fleisch, Fisch usw.;252409;262366;-9957
01.03.21;WA17;Zucker und Zuckerwaren;219688;137311;82377
01.03.21;WA18;Kakao und Zubereitungen aus Kakao;436855;388309;48546
01.03.21;WA19;Zubereitungen aus Getreide usw., Backwaren;614262;420140;194122
01.03.21;WA20;Zubereitungen von Gemüse, Früchten usw.;256208;456572;-200364
01.03.21;WA21;Verschiedene Lebensmittelzubereitungen;591017;377560;213457
01.03.21;WA22;Getränke, alkoholhaltige Flüssigkeiten, Essig;504141;669742;-165601
01.03.21;WA23;Rückstände der Lebensmittelindustrie, Futter;510228;402087;108141
01.03.21;WA24;Tabak;228139;277394;-49255
01.03.21;WA25;Salz, Schwefel, Steine, Erden usw.;192833;158711;34122
01.03.21;WA26;Erze, Schlacken, Aschen;38291;1122891;-1084600
01.03.21;WA27;Mineralische Brennstoffe usw.;1897171;6700615;-4803444
01.03.21;WA28;Anorganische chemische Erzeugnisse;1372804;564207;808597
01.03.21;WA29;Organische chemische Erzeugnisse;2441204;3244468;-803264
01.03.21;WA30;Pharmazeutische Erzeugnisse;8689773;6189353;2500420
01.03.21;WA31;Düngemittel;223660;120478;103182
01.03.21;WA32;Gerb- und Farbstoffe, Farben, Lacke usw.;1079042;545011;534031
01.03.21;WA33;Etherische Öle, Riech-, Schönheitsmittel;864127;586197;277930
01.03.21;WA34;Seifen, Waschmittel usw.;742421;368142;374279
01.03.21;WA35;Eiweissstoffe, Klebstoffe, Enzyme;384704;208326;176378
01.03.21;WA36;Sprengstoffe, pyrotechnische Artikel usw.;27835;15356;12479
01.03.21;WA37;Photochemische Erzeugnisse;96946;49976;46970
01.03.21;WA38;Verschiedene Erzeugnisse der Chemischen Industrie;2549422;1743995;805427
01.03.21;WA39;Kunststoffe und Waren daraus;6260825;3928694;2332131
01.03.21;WA40;Kautschuk und Waren daraus;1449306;1445055;4251
01.03.21;WA41;Häute, Felle, Leder;62308;46398;15910
01.03.21;WA42;Lederwaren, Sattlerwaren;215126;328681;-113555
01.03.21;WA43;Pelzfelle, künstliches Pelzwerk;5610;6990;-1380
01.03.21;WA44;Holz, Holzwaren, Holzkohle;955903;823149;132754
01.03.21;WA45;Kork, Korkwaren;2380;11760;-9380
01.03.21;WA46;Flechtwaren, Korbmacherwaren;6232;15541;-9309
01.03.21;WA47;Halbstoffe aus Holz usw., Papierabfall;89633;293572;-203939
01.03.21;WA48;Papier, Pappe und Waren daraus;1617176;1008963;608213
01.03.21;WA49;Bücher, Zeitungen, Bilddrucke usw.;357355;257382;99973
01.03.21;WA50;Seide;2386;2469;-83
01.03.21;WA51;Wolle, feine und grobe Tierhaare;35092;37710;-2618
01.03.21;WA52;Baumwolle;54773;54117;656
01.03.21;WA53;Andere pflanzliche Spinnstoffe, Papiergarn;3281;6322;-3041
01.03.21;WA54;Synthetisches oder künstliches Filament;143038;119046;23992
01.03.21;WA55;Synthetische oder künstliche Spinnfaser;153451;124480;28971
01.03.21;WA56;Watte, Filz, Vliesstoff usw., Tauwerk;245004;159400;85604
01.03.21;WA57;Teppiche, Fussbodenbelag aus Spinnstoff;49907;97014;-47107
01.03.21;WA58;Spezialgewebe, Spitzen, Tapisserien;45271;20565;24706
01.03.21;WA59;Getränkte, bestrichene usw. Gewebe;229229;110939;118290
01.03.21;WA60;Gewirke und Gestricke;66063;43931;22132
01.03.21;WA61;Bekleidung usw. aus Gewirken, Gestricken;945892;1539048;-593156
01.03.21;WA62;Andere Bekleidung, Bekleidungszubehör;999520;1495375;-495855
01.03.21;WA63;Andere Konfektion, Spinnstoffwaren usw.;328559;521657;-193098
01.03.21;WA64;Schuhe, Gamaschen, ähnliche Waren;799118;1061592;-262474
01.03.21;WA65;Kopfbedeckungen und Teile davon;50159;71403;-21244
01.03.21;WA66;Schirme, Gehstöcke usw., Peitschen;9675;43139;-33464
01.03.21;WA67;Zugerichtete Federn, Daunen, künstliche Blumen;12308;18021;-5713
01.03.21;WA68;Waren aus Steinen, Gips, Zement usw.;477315;320773;156542
01.03.21;WA69;Keramische Waren;342626;295875;46751
01.03.21;WA70;Glas und Glaswaren;618127;471899;146228
01.03.21;WA71;Perlen, Edelsteine, Edelmetalle;1999452;3235361;-1235909
01.03.21;WA72;Eisen und Stahl;2373029;2372655;374
01.03.21;WA73;Waren aus Eisen oder Stahl;2686896;2129762;557134
01.03.21;WA74;Kupfer und Waren daraus;1315885;987756;328129
01.03.21;WA75;Nickel und Waren daraus;100616;134080;-33464
01.03.21;WA76;Aluminium und Waren daraus;1409137;1471904;-62767
01.03.21;WA78;Blei und Waren daraus;44742;42286;2456
01.03.21;WA79;Zink und Waren daraus;71699;123691;-51992
01.03.21;WA80;Zinn und Waren daraus;11189;33853;-22664
01.03.21;WA81;Andere unedle Metalle, Cermets usw.;125297;122742;2555
01.03.21;WA82;Werkzeuge, Schneidwaren, Essbestecke;799308;522539;276769
01.03.21;WA83;Verschiedene Waren aus unedlen Metallen;737653;487033;250620
01.03.21;WA84;Maschinen, Apparate, mechanische Geräte;21707928;13878881;7829047
01.03.21;WA85;Elektrotechnische Erzeugnisse;13694808;13166645;528163
01.03.21;WA86;Schienenfahrzeuge;322024;313183;8841
01.03.21;WA87;Kraftfahrzeuge, Landfahrzeuge;22495939;11930883;10565056
01.03.21;WA88;Luftfahrzeuge, Raumfahrzeuge;2274397;942208;1332189
01.03.21;WA89;Wasserfahrzeuge;316393;125777;190616
01.03.21;WA90;Optische, photografische usw. Erzeugnisse;6541810;3863050;2678760
01.03.21;WA91;Uhrmacherwaren;126815;173794;-46979
01.03.21;WA92;Musikinstrumente;59060;65178;-6118
01.03.21;WA93;Waffen und Munition;59587;22059;37528
01.03.21;WA94;Möbel, Beleuchtungskörper usw.;1537795;1949434;-411639
01.03.21;WA95;Spielzeug, Spiele usw., Sportgeräte;414426;713996;-299570
01.03.21;WA96;Verschiedene Waren;365673;273031;92642
01.03.21;WA97;Kunstgegenstände, Sammlungsstücke;91219;56064;35155
01.03.21;WA98;Vollständige Fabrikationsanlagen;31577;NULL;#WERT!
01.03.21;WA99;Zusammenstellungen verschiedener Waren;1341994;1078441;263553
01.03.22;WA01;Lebende Tiere;118180;134971;-16791
01.03.22;WA02;Fleisch;620523;682383;-61860
01.03.22;WA03;Fische, Krebs- und Weichtiere;134869;383108;-248239
01.03.22;WA04;Milch, Milcherzeugnisse, Eier, Honig;1060793;955964;104829
01.03.22;WA05;Andere Waren tierischen Ursprungs;88869;111398;-22529
01.03.22;WA06;Pflanzen, Waren des Blumenhandels;131205;411011;-279806
01.03.22;WA07;Gemüse, Pflanzen für Ernährung;125222;813052;-687830
01.03.22;WA08;Geniessbare Früchte und Nüsse;182735;946637;-763902
01.03.22;WA09;Kaffee, Tee, Mate, Gewürze;349430;553418;-203988
01.03.22;WA10;Getreide;357765;431124;-73359
01.03.22;WA11;Müllereierzeugnisse, Malz usw.;187417;80206;107211
01.03.22;WA12;Ölsamen usw., Heilpflanzen usw.;216304;839481;-623177
01.03.22;WA13;Schellack, Gummen, Harz, Pflanzensaft;72032;66744;5288
01.03.22;WA14;Flechtstoffe usw. pflanzlichen Ursprungs;1162;4563;-3401
01.03.22;WA15;Tierische und pflanzliche Fette, Öle, Wachs;424904;529724;-104820
01.03.22;WA16;Zubereitungen von Fleisch, Fisch usw.;301167;311885;-10718
01.03.22;WA17;Zucker und Zuckerwaren;269517;170094;99423
01.03.22;WA18;Kakao und Zubereitungen aus Kakao;507773;428831;78942
01.03.22;WA19;Zubereitungen aus Getreide usw., Backwaren;685657;491496;194161
01.03.22;WA20;Zubereitungen von Gemüse, Früchten usw.;283722;517745;-234023
01.03.22;WA21;Verschiedene Lebensmittelzubereitungen;683260;426504;256756
01.03.22;WA22;Getränke, alkoholhaltige Flüssigkeiten, Essig;593716;798158;-204442
01.03.22;WA23;Rückstände der Lebensmittelindustrie, Futter;601271;510890;90381
01.03.22;WA24;Tabak;233675;258409;-24734
01.03.22;WA25;Salz, Schwefel, Steine, Erden usw.;220601;186033;34568
01.03.22;WA26;Erze, Schlacken, Aschen;95435;1117609;-1022174
01.03.22;WA27;Mineralische Brennstoffe usw.;5540948;16012423;-10471475
01.03.22;WA28;Anorganische chemische Erzeugnisse;1573819;881933;691886
01.03.22;WA29;Organische chemische Erzeugnisse;3190778;6490263;-3299485
01.03.22;WA30;Pharmazeutische Erzeugnisse;11069056;6596542;4472514
01.03.22;WA31;Düngemittel;429977;226353;203624
01.03.22;WA32;Gerb- und Farbstoffe, Farben, Lacke usw.;1254403;661121;593282
01.03.22;WA33;Etherische Öle, Riech-, Schönheitsmittel;1033751;685965;347786
01.03.22;WA34;Seifen, Waschmittel usw.;839653;477338;362315
01.03.22;WA35;Eiweissstoffe, Klebstoffe, Enzyme;428816;279299;149517
01.03.22;WA36;Sprengstoffe, pyrotechnische Artikel usw.;19730;14697;5033
01.03.22;WA37;Photochemische Erzeugnisse;94767;60541;34226
01.03.22;WA38;Verschiedene Erzeugnisse der Chemischen Industrie;3153271;2144553;1008718
01.03.22;WA39;Kunststoffe und Waren daraus;7481148;5119872;2361276
01.03.22;WA40;Kautschuk und Waren daraus;1514687;1480451;34236
01.03.22;WA41;Häute, Felle, Leder;68695;55964;12731
01.03.22;WA42;Lederwaren, Sattlerwaren;239979;406667;-166688
01.03.22;WA43;Pelzfelle, künstliches Pelzwerk;9057;10828;-1771
01.03.22;WA44;Holz, Holzwaren, Holzkohle;1295530;1144076;151454
01.03.22;WA45;Kork, Korkwaren;2999;10483;-7484
01.03.22;WA46;Flechtwaren, Korbmacherwaren;7317;20906;-13589
01.03.22;WA47;Halbstoffe aus Holz usw., Papierabfall;132314;432140;-299826
01.03.22;WA48;Papier, Pappe und Waren daraus;2160316;1330801;829515
01.03.22;WA49;Bücher, Zeitungen, Bilddrucke usw.;333865;261149;72716
01.03.22;WA50;Seide;1783;3022;-1239
01.03.22;WA51;Wolle, feine und grobe Tierhaare;51583;53708;-2125
01.03.22;WA52;Baumwolle;65798;85350;-19552
01.03.22;WA53;Andere pflanzliche Spinnstoffe, Papiergarn;4347;7835;-3488
01.03.22;WA54;Synthetisches oder künstliches Filament;171989;152194;19795
01.03.22;WA55;Synthetische oder künstliche Spinnfaser;139384;144400;-5016
01.03.22;WA56;Watte, Filz, Vliesstoff usw., Tauwerk;264723;172938;91785
01.03.22;WA57;Teppiche, Fussbodenbelag aus Spinnstoff;50571;115174;-64603
01.03.22;WA58;Spezialgewebe, Spitzen, Tapisserien;49654;28045;21609
01.03.22;WA59;Getränkte, bestrichene usw. Gewebe;241481;116717;124764
01.03.22;WA60;Gewirke und Gestricke;72688;53141;19547
01.03.22;WA61;Bekleidung usw. aus Gewirken, Gestricken;1049898;1955046;-905148
01.03.22;WA62;Andere Bekleidung, Bekleidungszubehör;1057590;1794020;-736430
01.03.22;WA63;Andere Konfektion, Spinnstoffwaren usw.;304574;527092;-222518
01.03.22;WA64;Schuhe, Gamaschen, ähnliche Waren;859307;1264661;-405354
01.03.22;WA65;Kopfbedeckungen und Teile davon;68329;84400;-16071
01.03.22;WA66;Schirme, Gehstöcke usw., Peitschen;12457;47918;-35461
01.03.22;WA67;Zugerichtete Federn, Daunen, künstliche Blumen;16581;27302;-10721
01.03.22;WA68;Waren aus Steinen, Gips, Zement usw.;526193;368240;157953
01.03.22;WA69;Keramische Waren;383751;344144;39607
01.03.22;WA70;Glas und Glaswaren;710867;511696;199171
01.03.22;WA71;Perlen, Edelsteine, Edelmetalle;2219864;4645969;-2426105
01.03.22;WA72;Eisen und Stahl;3717146;3751426;-34280
01.03.22;WA73;Waren aus Eisen oder Stahl;3147607;2780006;367601
01.03.22;WA74;Kupfer und Waren daraus;1542697;1693659;-150962
01.03.22;WA75;Nickel und Waren daraus;169677;316225;-146548
01.03.22;WA76;Aluminium und Waren daraus;1906968;2560308;-653340
01.03.22;WA78;Blei und Waren daraus;30814;87117;-56303
01.03.22;WA79;Zink und Waren daraus;98626;189629;-91003
01.03.22;WA80;Zinn und Waren daraus;19011;83993;-64982
01.03.22;WA81;Andere unedle Metalle, Cermets usw.;176241;260377;-84136
01.03.22;WA82;Werkzeuge, Schneidwaren, Essbestecke;856681;589596;267085
01.03.22;WA83;Verschiedene Waren aus unedlen Metallen;798529;560253;238276
01.03.22;WA84;Maschinen, Apparate, mechanische Geräte;21923937;14875316;7048621
01.03.22;WA85;Elektrotechnische Erzeugnisse;14788179;15478525;-690346
01.03.22;WA86;Schienenfahrzeuge;294047;311545;-17498
01.03.22;WA87;Kraftfahrzeuge, Landfahrzeuge;19913298;11237254;8676044
01.03.22;WA88;Luftfahrzeuge, Raumfahrzeuge;2138710;821524;1317186
01.03.22;WA89;Wasserfahrzeuge;1530292;167053;1363239
01.03.22;WA90;Optische, photografische usw. Erzeugnisse;6881788;4044018;2837770
01.03.22;WA91;Uhrmacherwaren;156724;216039;-59315
01.03.22;WA92;Musikinstrumente;84721;75182;9539
01.03.22;WA93;Waffen und Munition;67977;27532;40445
01.03.22;WA94;Möbel, Beleuchtungskörper usw.;1662593;2228294;-565701
01.03.22;WA95;Spielzeug, Spiele usw., Sportgeräte;472253;774083;-301830
01.03.22;WA96;Verschiedene Waren;396922;333053;63869
01.03.22;WA97;Kunstgegenstände, Sammlungsstücke;79611;52247;27364
01.03.22;WA98;Vollständige Fabrikationsanlagen;36024;NULL;#WERT!
01.03.22;WA99;Zusammenstellungen verschiedener Waren;1358763;930648;428115
01.03.23;WA01;Lebende Tiere;126502;165516;-39014
01.03.23;WA02;Fleisch;684090;722033;-37943
01.03.23;WA03;Fische, Krebs- und Weichtiere;136840;412764;-275924
01.03.23;WA04;Milch, Milcherzeugnisse, Eier, Honig;1201592;1098058;103534
01.03.23;WA05;Andere Waren tierischen Ursprungs;93715;114508;-20793
01.03.23;WA06;Pflanzen, Waren des Blumenhandels;119675;376475;-256800
01.03.23;WA07;Gemüse, Pflanzen für Ernährung;158269;943817;-785548
01.03.23;WA08;Geniessbare Früchte und Nüsse;190986;982975;-791989
01.03.23;WA09;Kaffee, Tee, Mate, Gewürze;342412;474105;-131693
01.03.23;WA10;Getreide;331013;417394;-86381
01.03.23;WA11;Müllereierzeugnisse, Malz usw.;245316;104164;141152
01.03.23;WA12;Ölsamen usw., Heilpflanzen usw.;247715;730802;-483087
01.03.23;WA13;Schellack, Gummen, Harz, Pflanzensaft;71169;69273;1896
01.03.23;WA14;Flechtstoffe usw. pflanzlichen Ursprungs;1200;4703;-3503
01.03.23;WA15;Tierische und pflanzliche Fette, Öle, Wachs;415447;498520;-83073
01.03.23;WA16;Zubereitungen von Fleisch, Fisch usw.;335762;338711;-2949
01.03.23;WA17;Zucker und Zuckerwaren;329631;239289;90342
01.03.23;WA18;Kakao und Zubereitungen aus Kakao;582100;485696;96404
01.03.23;WA19;Zubereitungen aus Getreide usw., Backwaren;853021;596339;256682
01.03.23;WA20;Zubereitungen von Gemüse, Früchten usw.;309061;589954;-280893
01.03.23;WA21;Verschiedene Lebensmittelzubereitungen;781418;573473;207945
01.03.23;WA22;Getränke, alkoholhaltige Flüssigkeiten, Essig;671800;812613;-140813
01.03.23;WA23;Rückstände der Lebensmittelindustrie, Futter;653902;496302;157600
01.03.23;WA24;Tabak;281378;465473;-184095
01.03.23;WA25;Salz, Schwefel, Steine, Erden usw.;232872;198403;34469
01.03.23;WA26;Erze, Schlacken, Aschen;67429;1149296;-1081867
01.03.23;WA27;Mineralische Brennstoffe usw.;3198687;10961782;-7763095
01.03.23;WA28;Anorganische chemische Erzeugnisse;1417130;859282;557848
01.03.23;WA29;Organische chemische Erzeugnisse;2742436;3325051;-582615
01.03.23;WA30;Pharmazeutische Erzeugnisse;10244281;6515065;3729216
01.03.23;WA31;Düngemittel;356317;181120;175197
01.03.23;WA32;Gerb- und Farbstoffe, Farben, Lacke usw.;1126059;558666;567393
01.03.23;WA33;Etherische Öle, Riech-, Schönheitsmittel;1175835;771625;404210
01.03.23;WA34;Seifen, Waschmittel usw.;855512;500917;354595
01.03.23;WA35;Eiweissstoffe, Klebstoffe, Enzyme;446368;281735;164633
01.03.23;WA36;Sprengstoffe, pyrotechnische Artikel usw.;38424;16291;22133
01.03.23;WA37;Photochemische Erzeugnisse;91221;46703;44518
01.03.23;WA38;Verschiedene Erzeugnisse der Chemischen Industrie;3330749;2063058;1267691
01.03.23;WA39;Kunststoffe und Waren daraus;6720036;4483980;2236056
01.03.23;WA40;Kautschuk und Waren daraus;1657137;1547429;109708
01.03.23;WA41;Häute, Felle, Leder;55288;47794;7494
01.03.23;WA42;Lederwaren, Sattlerwaren;264504;380632;-116128
01.03.23;WA43;Pelzfelle, künstliches Pelzwerk;3904;4233;-329
01.03.23;WA44;Holz, Holzwaren, Holzkohle;1050002;876919;173083
01.03.23;WA45;Kork, Korkwaren;2604;8201;-5597
01.03.23;WA46;Flechtwaren, Korbmacherwaren;7279;13442;-6163
01.03.23;WA47;Halbstoffe aus Holz usw., Papierabfall;127476;368165;-240689
01.03.23;WA48;Papier, Pappe und Waren daraus;1938165;1274685;663480
01.03.23;WA49;Bücher, Zeitungen, Bilddrucke usw.;324727;252747;71980
01.03.23;WA50;Seide;2678;3092;-414
01.03.23;WA51;Wolle, feine und grobe Tierhaare;45375;50238;-4863
01.03.23;WA52;Baumwolle;66028;65924;104
01.03.23;WA53;Andere pflanzliche Spinnstoffe, Papiergarn;3685;5836;-2151
01.03.23;WA54;Synthetisches oder künstliches Filament;152860;137432;15428
01.03.23;WA55;Synthetische oder künstliche Spinnfaser;148293;132398;15895
01.03.23;WA56;Watte, Filz, Vliesstoff usw., Tauwerk;249550;170603;78947
01.03.23;WA57;Teppiche, Fussbodenbelag aus Spinnstoff;54679;101526;-46847
01.03.23;WA58;Spezialgewebe, Spitzen, Tapisserien;51703;25544;26159
01.03.23;WA59;Getränkte, bestrichene usw. Gewebe;263516;132600;130916
01.03.23;WA60;Gewirke und Gestricke;67938;48098;19840
01.03.23;WA61;Bekleidung usw. aus Gewirken, Gestricken;1135193;1763956;-628763
01.03.23;WA62;Andere Bekleidung, Bekleidungszubehör;1211218;1765499;-554281
01.03.23;WA63;Andere Konfektion, Spinnstoffwaren usw.;295765;379857;-84092
01.03.23;WA64;Schuhe, Gamaschen, ähnliche Waren;988368;1140188;-151820
01.03.23;WA65;Kopfbedeckungen und Teile davon;70673;81416;-10743
01.03.23;WA66;Schirme, Gehstöcke usw., Peitschen;8766;25292;-16526
01.03.23;WA67;Zugerichtete Federn, Daunen, künstliche Blumen;15526;17776;-2250
01.03.23;WA68;Waren aus Steinen, Gips, Zement usw.;526030;344341;181689
01.03.23;WA69;Keramische Waren;392544;294627;97917
01.03.23;WA70;Glas und Glaswaren;779916;571004;208912
01.03.23;WA71;Perlen, Edelsteine, Edelmetalle;2074030;2105146;-31116
01.03.23;WA72;Eisen und Stahl;2998644;2974598;24046
01.03.23;WA73;Waren aus Eisen oder Stahl;3422629;2717533;705096
01.03.23;WA74;Kupfer und Waren daraus;1443791;1113349;330442
01.03.23;WA75;Nickel und Waren daraus;220569;260614;-40045
01.03.23;WA76;Aluminium und Waren daraus;1789994;2077408;-287414
01.03.23;WA78;Blei und Waren daraus;33847;72664;-38817
01.03.23;WA79;Zink und Waren daraus;74061;173265;-99204
01.03.23;WA80;Zinn und Waren daraus;13456;42767;-29311
01.03.23;WA81;Andere unedle Metalle, Cermets usw.;184799;201744;-16945
01.03.23;WA82;Werkzeuge, Schneidwaren, Essbestecke;922578;525697;396881
01.03.23;WA83;Verschiedene Waren aus unedlen Metallen;794921;505432;289489
01.03.23;WA84;Maschinen, Apparate, mechanische Geräte;25095983;15552857;9543126
01.03.23;WA85;Elektrotechnische Erzeugnisse;16801376;18495544;-1694168
01.03.23;WA86;Schienenfahrzeuge;275543;319760;-44217
01.03.23;WA87;Kraftfahrzeuge, Landfahrzeuge;25903402;14394137;11509265
01.03.23;WA88;Luftfahrzeuge, Raumfahrzeuge;3037650;1241508;1796142
01.03.23;WA89;Wasserfahrzeuge;842876;804781;38095
01.03.23;WA90;Optische, photografische usw. Erzeugnisse;7688742;4307700;3381042
01.03.23;WA91;Uhrmacherwaren;157209;230493;-73284
01.03.23;WA92;Musikinstrumente;91859;63225;28634
01.03.23;WA93;Waffen und Munition;64437;35357;29080
01.03.23;WA94;Möbel, Beleuchtungskörper usw.;1667516;1997829;-330313
01.03.23;WA95;Spielzeug, Spiele usw., Sportgeräte;472228;725582;-253354
01.03.23;WA96;Verschiedene Waren;400396;303599;96797
01.03.23;WA97;Kunstgegenstände, Sammlungsstücke;69226;69245;-19
01.03.23;WA98;Vollständige Fabrikationsanlagen;89319;NULL;#WERT!
01.03.23;WA99;Zusammenstellungen verschiedener Waren;2071754;1055522;1016232
01.03.24;WA01;Lebende Tiere;128775;152385;-23610
01.03.24;WA02;Fleisch;642004;666472;-24468
01.03.24;WA03;Fische, Krebs- und Weichtiere;103871;380248;-276377
01.03.24;WA04;Milch, Milcherzeugnisse, Eier, Honig;1048471;982747;65724
01.03.24;WA05;Andere Waren tierischen Ursprungs;74320;90040;-15720
01.03.24;WA06;Pflanzen, Waren des Blumenhandels;122264;383071;-260807
01.03.24;WA07;Gemüse, Pflanzen für Ernährung;153133;831437;-678304
01.03.24;WA08;Geniessbare Früchte und Nüsse;174945;1057518;-882573
01.03.24;WA09;Kaffee, Tee, Mate, Gewürze;311234;448037;-136803
01.03.24;WA10;Getreide;249057;384267;-135210
01.03.24;WA11;Müllereierzeugnisse, Malz usw.;212537;89153;123384
01.03.24;WA12;Ölsamen usw., Heilpflanzen usw.;250801;619142;-368341
01.03.24;WA13;Schellack, Gummen, Harz, Pflanzensaft;69630;57549;12081
01.03.24;WA14;Flechtstoffe usw. pflanzlichen Ursprungs;1203;4042;-2839
01.03.24;WA15;Tierische und pflanzliche Fette, Öle, Wachs;288002;418102;-130100
01.03.24;WA16;Zubereitungen von Fleisch, Fisch usw.;297921;317388;-19467
01.03.24;WA17;Zucker und Zuckerwaren;284420;205991;78429
01.03.24;WA18;Kakao und Zubereitungen aus Kakao;606304;623577;-17273
01.03.24;WA19;Zubereitungen aus Getreide usw., Backwaren;787875;582328;205547
01.03.24;WA20;Zubereitungen von Gemüse, Früchten usw.;304726;562646;-257920
01.03.24;WA21;Verschiedene Lebensmittelzubereitungen;764225;489518;274707
01.03.24;WA22;Getränke, alkoholhaltige Flüssigkeiten, Essig;587027;725745;-138718
01.03.24;WA23;Rückstände der Lebensmittelindustrie, Futter;560663;469653;91010
01.03.24;WA24;Tabak;269200;488444;-219244
01.03.24;WA25;Salz, Schwefel, Steine, Erden usw.;210077;173190;36887
01.03.24;WA26;Erze, Schlacken, Aschen;73952;978937;-904985
01.03.24;WA27;Mineralische Brennstoffe usw.;2980825;9442588;-6461763
01.03.24;WA28;Anorganische chemische Erzeugnisse;1100941;720812;380129
01.03.24;WA29;Organische chemische Erzeugnisse;2349799;3302481;-952682
01.03.24;WA30;Pharmazeutische Erzeugnisse;10139555;6578675;3560880
01.03.24;WA31;Düngemittel;282905;173456;109449
01.03.24;WA32;Gerb- und Farbstoffe, Farben, Lacke usw.;1030121;465475;564646
01.03.24;WA33;Etherische Öle, Riech-, Schönheitsmittel;1042348;727268;315080
01.03.24;WA34;Seifen, Waschmittel usw.;760061;447052;313009
01.03.24;WA35;Eiweissstoffe, Klebstoffe, Enzyme;396685;236850;159835
01.03.24;WA36;Sprengstoffe, pyrotechnische Artikel usw.;34635;19020;15615
01.03.24;WA37;Photochemische Erzeugnisse;83341;52605;30736
01.03.24;WA38;Verschiedene Erzeugnisse der Chemischen Industrie;2895437;1732263;1163174
01.03.24;WA39;Kunststoffe und Waren daraus;5997607;3922693;2074914
01.03.24;WA40;Kautschuk und Waren daraus;1459651;1365139;94512
01.03.24;WA41;Häute, Felle, Leder;56991;47183;9808
01.03.24;WA42;Lederwaren, Sattlerwaren;249039;375965;-126926
01.03.24;WA43;Pelzfelle, künstliches Pelzwerk;2966;3235;-269
01.03.24;WA44;Holz, Holzwaren, Holzkohle;842691;683913;158778
01.03.24;WA45;Kork, Korkwaren;2082;8271;-6189
01.03.24;WA46;Flechtwaren, Korbmacherwaren;5931;13155;-7224
01.03.24;WA47;Halbstoffe aus Holz usw., Papierabfall;120837;338775;-217938
01.03.24;WA48;Papier, Pappe und Waren daraus;1669839;1079326;590513
01.03.24;WA49;Bücher, Zeitungen, Bilddrucke usw.;265198;232212;32986
01.03.24;WA50;Seide;1528;5754;-4226
01.03.24;WA51;Wolle, feine und grobe Tierhaare;34061;38792;-4731
01.03.24;WA52;Baumwolle;48283;49476;-1193
01.03.24;WA53;Andere pflanzliche Spinnstoffe, Papiergarn;2897;5467;-2570
01.03.24;WA54;Synthetisches oder künstliches Filament;137427;117363;20064
01.03.24;WA55;Synthetische oder künstliche Spinnfaser;123279;108888;14391
01.03.24;WA56;Watte, Filz, Vliesstoff usw., Tauwerk;228265;143659;84606
01.03.24;WA57;Teppiche, Fussbodenbelag aus Spinnstoff;51268;97150;-45882
01.03.24;WA58;Spezialgewebe, Spitzen, Tapisserien;45520;22045;23475
01.03.24;WA59;Getränkte, bestrichene usw. Gewebe;230751;108158;122593
01.03.24;WA60;Gewirke und Gestricke;58948;41094;17854
01.03.24;WA61;Bekleidung usw. aus Gewirken, Gestricken;1016028;1572804;-556776
01.03.24;WA62;Andere Bekleidung, Bekleidungszubehör;1124343;1605339;-480996
01.03.24;WA63;Andere Konfektion, Spinnstoffwaren usw.;256908;352624;-95716
01.03.24;WA64;Schuhe, Gamaschen, ähnliche Waren;961486;1098666;-137180
01.03.24;WA65;Kopfbedeckungen und Teile davon;64167;80068;-15901
01.03.24;WA66;Schirme, Gehstöcke usw., Peitschen;10270;25989;-15719
01.03.24;WA67;Zugerichtete Federn, Daunen, künstliche Blumen;14717;21319;-6602
01.03.24;WA68;Waren aus Steinen, Gips, Zement usw.;486229;309871;176358
01.03.24;WA69;Keramische Waren;337058;254596;82462
01.03.24;WA70;Glas und Glaswaren;632895;465589;167306
01.03.24;WA71;Perlen, Edelsteine, Edelmetalle;1957153;1486337;470816
01.03.24;WA72;Eisen und Stahl;2560426;2277344;283082
01.03.24;WA73;Waren aus Eisen oder Stahl;2812310;2163098;649212
01.03.24;WA74;Kupfer und Waren daraus;1175064;1113463;61601
01.03.24;WA75;Nickel und Waren daraus;165018;177542;-12524
01.03.24;WA76;Aluminium und Waren daraus;1474568;1607476;-132908
01.03.24;WA78;Blei und Waren daraus;55857;52624;3233
01.03.24;WA79;Zink und Waren daraus;61395;103928;-42533
01.03.24;WA80;Zinn und Waren daraus;10771;33829;-23058
01.03.24;WA81;Andere unedle Metalle, Cermets usw.;143645;188914;-45269
01.03.24;WA82;Werkzeuge, Schneidwaren, Essbestecke;825076;487910;337166
01.03.24;WA83;Verschiedene Waren aus unedlen Metallen;720853;481548;239305
01.03.24;WA84;Maschinen, Apparate, mechanische Geräte;21975830;13605932;8369898
01.03.24;WA85;Elektrotechnische Erzeugnisse;14166939;15574670;-1407731
01.03.24;WA86;Schienenfahrzeuge;316750;296019;20731
01.03.24;WA87;Kraftfahrzeuge, Landfahrzeuge;23907684;12282264;11625420
01.03.24;WA88;Luftfahrzeuge, Raumfahrzeuge;3010662;1035139;1975523
01.03.24;WA89;Wasserfahrzeuge;102432;837890;-735458
01.03.24;WA90;Optische, photografische usw. Erzeugnisse;6818831;3871849;2946982
01.03.24;WA91;Uhrmacherwaren;150552;200389;-49837
01.03.24;WA92;Musikinstrumente;80140;52232;27908
01.03.24;WA93;Waffen und Munition;69494;25174;44320
01.03.24;WA94;Möbel, Beleuchtungskörper usw.;1419026;1917777;-498751
01.03.24;WA95;Spielzeug, Spiele usw., Sportgeräte;360596;558658;-198062
01.03.24;WA96;Verschiedene Waren;355104;292450;62654
01.03.24;WA97;Kunstgegenstände, Sammlungsstücke;82619;99928;-17309
01.03.24;WA98;Vollständige Fabrikationsanlagen;90874;NULL;#WERT!
01.03.24;WA99;Zusammenstellungen verschiedener Waren;1218762;978841;239921
01.03.25;WA01;Lebende Tiere;NULL;NULL;#WERT!
01.03.25;WA02;Fleisch;NULL;NULL;#WERT!
01.03.25;WA03;Fische, Krebs- und Weichtiere;NULL;NULL;#WERT!
01.03.25;WA04;Milch, Milcherzeugnisse, Eier, Honig;NULL;NULL;#WERT!
01.03.25;WA05;Andere Waren tierischen Ursprungs;NULL;NULL;#WERT!
01.03.25;WA06;Pflanzen, Waren des Blumenhandels;NULL;NULL;#WERT!
01.03.25;WA07;Gemüse, Pflanzen für Ernährung;NULL;NULL;#WERT!
01.03.25;WA08;Geniessbare Früchte und Nüsse;NULL;NULL;#WERT!
01.03.25;WA09;Kaffee, Tee, Mate, Gewürze;NULL;NULL;#WERT!
01.03.25;WA10;Getreide;NULL;NULL;#WERT!
01.03.25;WA11;Müllereierzeugnisse, Malz usw.;NULL;NULL;#WERT!
01.03.25;WA12;Ölsamen usw., Heilpflanzen usw.;NULL;NULL;#WERT!
01.03.25;WA13;Schellack, Gummen, Harz, Pflanzensaft;NULL;NULL;#WERT!
01.03.25;WA14;Flechtstoffe usw. pflanzlichen Ursprungs;NULL;NULL;#WERT!
01.03.25;WA15;Tierische und pflanzliche Fette, Öle, Wachs;NULL;NULL;#WERT!
01.03.25;WA16;Zubereitungen von Fleisch, Fisch usw.;NULL;NULL;#WERT!
01.03.25;WA17;Zucker und Zuckerwaren;NULL;NULL;#WERT!
01.03.25;WA18;Kakao und Zubereitungen aus Kakao;NULL;NULL;#WERT!
01.03.25;WA19;Zubereitungen aus Getreide usw., Backwaren;NULL;NULL;#WERT!
01.03.25;WA20;Zubereitungen von Gemüse, Früchten usw.;NULL;NULL;#WERT!
01.03.25;WA21;Verschiedene Lebensmittelzubereitungen;NULL;NULL;#WERT!
01.03.25;WA22;Getränke, alkoholhaltige Flüssigkeiten, Essig;NULL;NULL;#WERT!
01.03.25;WA23;Rückstände der Lebensmittelindustrie, Futter;NULL;NULL;#WERT!
01.03.25;WA24;Tabak;NULL;NULL;#WERT!
01.03.25;WA25;Salz, Schwefel, Steine, Erden usw.;NULL;NULL;#WERT!
01.03.25;WA26;Erze, Schlacken, Aschen;NULL;NULL;#WERT!
01.03.25;WA27;Mineralische Brennstoffe usw.;NULL;NULL;#WERT!
01.03.25;WA28;Anorganische chemische Erzeugnisse;NULL;NULL;#WERT!
01.03.25;WA29;Organische chemische Erzeugnisse;NULL;NULL;#WERT!
01.03.25;WA30;Pharmazeutische Erzeugnisse;NULL;NULL;#WERT!
01.03.25;WA31;Düngemittel;NULL;NULL;#WERT!
01.03.25;WA32;Gerb- und Farbstoffe, Farben, Lacke usw.;NULL;NULL;#WERT!
01.03.25;WA33;Etherische Öle, Riech-, Schönheitsmittel;NULL;NULL;#WERT!
01.03.25;WA34;Seifen, Waschmittel usw.;NULL;NULL;#WERT!
01.03.25;WA35;Eiweissstoffe, Klebstoffe, Enzyme;NULL;NULL;#WERT!
01.03.25;WA36;Sprengstoffe, pyrotechnische Artikel usw.;NULL;NULL;#WERT!
01.03.25;WA37;Photochemische Erzeugnisse;NULL;NULL;#WERT!
01.03.25;WA38;Verschiedene Erzeugnisse der Chemischen Industrie;NULL;NULL;#WERT!
01.03.25;WA39;Kunststoffe und Waren daraus;NULL;NULL;#WERT!
01.03.25;WA40;Kautschuk und Waren daraus;NULL;NULL;#WERT!
01.03.25;WA41;Häute, Felle, Leder;NULL;NULL;#WERT!
01.03.25;WA42;Lederwaren, Sattlerwaren;NULL;NULL;#WERT!
01.03.25;WA43;Pelzfelle, künstliches Pelzwerk;NULL;NULL;#WERT!
01.03.25;WA44;Holz, Holzwaren, Holzkohle;NULL;NULL;#WERT!
01.03.25;WA45;Kork, Korkwaren;NULL;NULL;#WERT!
01.03.25;WA46;Flechtwaren, Korbmacherwaren;NULL;NULL;#WERT!
01.03.25;WA47;Halbstoffe aus Holz usw., Papierabfall;NULL;NULL;#WERT!
01.03.25;WA48;Papier, Pappe und Waren daraus;NULL;NULL;#WERT!
01.03.25;WA49;Bücher, Zeitungen, Bilddrucke usw.;NULL;NULL;#WERT!
01.03.25;WA50;Seide;NULL;NULL;#WERT!
01.03.25;WA51;Wolle, feine und grobe Tierhaare;NULL;NULL;#WERT!
01.03.25;WA52;Baumwolle;NULL;NULL;#WERT!
01.03.25;WA53;Andere pflanzliche Spinnstoffe, Papiergarn;NULL;NULL;#WERT!
01.03.25;WA54;Synthetisches oder künstliches Filament;NULL;NULL;#WERT!
01.03.25;WA55;Synthetische oder künstliche Spinnfaser;NULL;NULL;#WERT!
01.03.25;WA56;Watte, Filz, Vliesstoff usw., Tauwerk;NULL;NULL;#WERT!
01.03.25;WA57;Teppiche, Fussbodenbelag aus Spinnstoff;NULL;NULL;#WERT!
01.03.25;WA58;Spezialgewebe, Spitzen, Tapisserien;NULL;NULL;#WERT!
01.03.25;WA59;Getränkte, bestrichene usw. Gewebe;NULL;NULL;#WERT!
01.03.25;WA60;Gewirke und Gestricke;NULL;NULL;#WERT!
01.03.25;WA61;Bekleidung usw. aus Gewirken, Gestricken;NULL;NULL;#WERT!
01.03.25;WA62;Andere Bekleidung, Bekleidungszubehör;NULL;NULL;#WERT!
01.03.25;WA63;Andere Konfektion, Spinnstoffwaren usw.;NULL;NULL;#WERT!
01.03.25;WA64;Schuhe, Gamaschen, ähnliche Waren;NULL;NULL;#WERT!
01.03.25;WA65;Kopfbedeckungen und Teile davon;NULL;NULL;#WERT!
01.03.25;WA66;Schirme, Gehstöcke usw., Peitschen;NULL;NULL;#WERT!
01.03.25;WA67;Zugerichtete Federn, Daunen, künstliche Blumen;NULL;NULL;#WERT!
01.03.25;WA68;Waren aus Steinen, Gips, Zement usw.;NULL;NULL;#WERT!
01.03.25;WA69;Keramische Waren;NULL;NULL;#WERT!
01.03.25;WA70;Glas und Glaswaren;NULL;NULL;#WERT!
01.03.25;WA71;Perlen, Edelsteine, Edelmetalle;NULL;NULL;#WERT!
01.03.25;WA72;Eisen und Stahl;NULL;NULL;#WERT!
01.03.25;WA73;Waren aus Eisen oder Stahl;NULL;NULL;#WERT!
01.03.25;WA74;Kupfer und Waren daraus;NULL;NULL;#WERT!
01.03.25;WA75;Nickel und Waren daraus;NULL;NULL;#WERT!
01.03.25;WA76;Aluminium und Waren daraus;NULL;NULL;#WERT!
01.03.25;WA78;Blei und Waren daraus;NULL;NULL;#WERT!
01.03.25;WA79;Zink und Waren daraus;NULL;NULL;#WERT!
01.03.25;WA80;Zinn und Waren daraus;NULL;NULL;#WERT!
01.03.25;WA81;Andere unedle Metalle, Cermets usw.;NULL;NULL;#WERT!
01.03.25;WA82;Werkzeuge, Schneidwaren, Essbestecke;NULL;NULL;#WERT!
01.03.25;WA83;Verschiedene Waren aus unedlen Metallen;NULL;NULL;#WERT!
01.03.25;WA84;Maschinen, Apparate, mechanische Geräte;NULL;NULL;#WERT!
01.03.25;WA85;Elektrotechnische Erzeugnisse;NULL;NULL;#WERT!
01.03.25;WA86;Schienenfahrzeuge;NULL;NULL;#WERT!
01.03.25;WA87;Kraftfahrzeuge, Landfahrzeuge;NULL;NULL;#WERT!
01.03.25;WA88;Luftfahrzeuge, Raumfahrzeuge;NULL;NULL;#WERT!
01.03.25;WA89;Wasserfahrzeuge;NULL;NULL;#WERT!
01.03.25;WA90;Optische, photografische usw. Erzeugnisse;NULL;NULL;#WERT!
01.03.25;WA91;Uhrmacherwaren;NULL;NULL;#WERT!
01.03.25;WA92;Musikinstrumente;NULL;NULL;#WERT!
01.03.25;WA93;Waffen und Munition;NULL;NULL;#WERT!
01.03.25;WA94;Möbel, Beleuchtungskörper usw.;NULL;NULL;#WERT!
01.03.25;WA95;Spielzeug, Spiele usw., Sportgeräte;NULL;NULL;#WERT!
01.03.25;WA96;Verschiedene Waren;NULL;NULL;#WERT!
01.03.25;WA97;Kunstgegenstände, Sammlungsstücke;NULL;NULL;#WERT!
01.03.25;WA98;Vollständige Fabrikationsanlagen;NULL;NULL;#WERT!
01.03.25;WA99;Zusammenstellungen verschiedener Waren;NULL;NULL;#WERT!
01.04.08;WA01;Lebende Tiere;78801;121281;-42480
01.04.08;WA02;Fleisch;509505;395430;114075
01.04.08;WA03;Fische, Krebs- und Weichtiere;76631;193399;-116768
01.04.08;WA04;Milch, Milcherzeugnisse, Eier, Honig;535296;427861;107435
01.04.08;WA05;Andere Waren tierischen Ursprungs;43931;53032;-9101
01.04.08;WA06;Pflanzen, Waren des Blumenhandels;64828;242236;-177408
01.04.08;WA07;Gemüse, Pflanzen für Ernährung;71035;455339;-384304
01.04.08;WA08;Geniessbare Früchte und Nüsse;108888;504787;-395899
01.04.08;WA09;Kaffee, Tee, Mate, Gewürze;144471;255994;-111523
01.04.08;WA10;Getreide;283424;232637;50787
01.04.08;WA11;Müllereierzeugnisse, Malz usw.;89631;40841;48790
01.04.08;WA12;Ölsamen usw., Heilpflanzen usw.;89705;277283;-187578
01.04.08;WA13;Schellack, Gummen, Harz, Pflanzensaft;42168;30173;11995
01.04.08;WA14;Flechtstoffe usw. pflanzlichen Ursprungs;672;2008;-1336
01.04.08;WA15;Tierische und pflanzliche Fette, Öle, Wachs;199225;293169;-93944
01.04.08;WA16;Zubereitungen von Fleisch, Fisch usw.;193667;169154;24513
01.04.08;WA17;Zucker und Zuckerwaren;104243;122923;-18680
01.04.08;WA18;Kakao und Zubereitungen aus Kakao;146521;150803;-4282
01.04.08;WA19;Zubereitungen aus Getreide usw., Backwaren;344074;195474;148600
01.04.08;WA20;Zubereitungen von Gemüse, Früchten usw.;184315;315709;-131394
01.04.08;WA21;Verschiedene Lebensmittelzubereitungen;297678;223058;74620
01.04.08;WA22;Getränke, alkoholhaltige Flüssigkeiten, Essig;352702;429793;-77091
01.04.08;WA23;Rückstände der Lebensmittelindustrie, Futter;213684;236352;-22668
01.04.08;WA24;Tabak;257993;118594;139399
01.04.08;WA25;Salz, Schwefel, Steine, Erden usw.;178296;137352;40944
01.04.08;WA26;Erze, Schlacken, Aschen;22145;523010;-500865
01.04.08;WA27;Mineralische Brennstoffe usw.;2364102;9471184;-7107082
01.04.08;WA28;Anorganische chemische Erzeugnisse;669347;424985;244362
01.04.08;WA29;Organische chemische Erzeugnisse;1971080;1988101;-17021
01.04.08;WA30;Pharmazeutische Erzeugnisse;3636763;2618605;1018158
01.04.08;WA31;Düngemittel;215505;118538;96967
01.04.08;WA32;Gerb- und Farbstoffe, Farben, Lacke usw.;765660;325756;439904
01.04.08;WA33;Etherische Öle, Riech-, Schönheitsmittel;559044;359019;200025
01.04.08;WA34;Seifen, Waschmittel usw.;448206;233796;214410
01.04.08;WA35;Eiweissstoffe, Klebstoffe, Enzyme;165701;136670;29031
01.04.08;WA36;Sprengstoffe, pyrotechnische Artikel usw.;17946;13708;4238
01.04.08;WA37;Photochemische Erzeugnisse;103617;77892;25725
01.04.08;WA38;Verschiedene Erzeugnisse der Chemischen Industrie;1342988;922486;420502
01.04.08;WA39;Kunststoffe und Waren daraus;4089208;2456624;1632584
01.04.08;WA40;Kautschuk und Waren daraus;922139;894803;27336
01.04.08;WA41;Häute, Felle, Leder;80129;77718;2411
01.04.08;WA42;Lederwaren, Sattlerwaren;99620;167473;-67853
01.04.08;WA43;Pelzfelle, künstliches Pelzwerk;14539;12394;2145
01.04.08;WA44;Holz, Holzwaren, Holzkohle;696305;524294;172011
01.04.08;WA45;Kork, Korkwaren;3796;10094;-6298
01.04.08;WA46;Flechtwaren, Korbmacherwaren;3594;9667;-6073
01.04.08;WA47;Halbstoffe aus Holz usw., Papierabfall;91882;282107;-190225
01.04.08;WA48;Papier, Pappe und Waren daraus;1582415;1018357;564058
01.04.08;WA49;Bücher, Zeitungen, Bilddrucke usw.;381508;153497;228011
01.04.08;WA50;Seide;6956;6486;470
01.04.08;WA51;Wolle, feine und grobe Tierhaare;82269;75319;6950
01.04.08;WA52;Baumwolle;94714;85718;8996
01.04.08;WA53;Andere pflanzliche Spinnstoffe, Papiergarn;4419;5957;-1538
01.04.08;WA54;Synthetisches oder künstliches Filament;218899;140101;78798
01.04.08;WA55;Synthetische oder künstliche Spinnfaser;151195;123923;27272
01.04.08;WA56;Watte, Filz, Vliesstoff usw., Tauwerk;169373;104954;64419
01.04.08;WA57;Teppiche, Fussbodenbelag aus Spinnstoff;42516;79632;-37116
01.04.08;WA58;Spezialgewebe, Spitzen, Tapisserien;53512;29010;24502
01.04.08;WA59;Getränkte, bestrichene usw. Gewebe;163734;111738;51996
01.04.08;WA60;Gewirke und Gestricke;84025;45158;38867
01.04.08;WA61;Bekleidung usw. aus Gewirken, Gestricken;381625;736804;-355179
01.04.08;WA62;Andere Bekleidung, Bekleidungszubehör;542980;882107;-339127
01.04.08;WA63;Andere Konfektion, Spinnstoffwaren usw.;131312;218866;-87554
01.04.08;WA64;Schuhe, Gamaschen, ähnliche Waren;242614;355582;-112968
01.04.08;WA65;Kopfbedeckungen und Teile davon;17527;23767;-6240
01.04.08;WA66;Schirme, Gehstöcke usw., Peitschen;6421;18576;-12155
01.04.08;WA67;Zugerichtete Federn, Daunen, künstliche Blumen;5933;7562;-1629
01.04.08;WA68;Waren aus Steinen, Gips, Zement usw.;300510;183368;117142
01.04.08;WA69;Keramische Waren;273383;193029;80354
01.04.08;WA70;Glas und Glaswaren;449361;358617;90744
01.04.08;WA71;Perlen, Edelsteine, Edelmetalle;790376;940133;-149757
01.04.08;WA72;Eisen und Stahl;2543588;2544883;-1295
01.04.08;WA73;Waren aus Eisen oder Stahl;2298902;1456935;841967
01.04.08;WA74;Kupfer und Waren daraus;1079825;887072;192753
01.04.08;WA75;Nickel und Waren daraus;117332;161464;-44132
01.04.08;WA76;Aluminium und Waren daraus;1161198;1099980;61218
01.04.08;WA78;Blei und Waren daraus;38785;21584;17201
01.04.08;WA79;Zink und Waren daraus;55902;86849;-30947
01.04.08;WA80;Zinn und Waren daraus;8358;29492;-21134
01.04.08;WA81;Andere unedle Metalle, Cermets usw.;99131;130159;-31028
01.04.08;WA82;Werkzeuge, Schneidwaren, Essbestecke;534535;349028;185507
01.04.08;WA83;Verschiedene Waren aus unedlen Metallen;567715;316375;251340
01.04.08;WA84;Maschinen, Apparate, mechanische Geräte;16338541;9129618;7208923
01.04.08;WA85;Elektrotechnische Erzeugnisse;9030351;7302399;1727952
01.04.08;WA86;Schienenfahrzeuge;315239;154527;160712
01.04.08;WA87;Kraftfahrzeuge, Landfahrzeuge;15832406;6338160;9494246
01.04.08;WA88;Luftfahrzeuge, Raumfahrzeuge;1744961;1691861;53100
01.04.08;WA89;Wasserfahrzeuge;751140;130737;620403
01.04.08;WA90;Optische, photografische usw. Erzeugnisse;3392893;1820765;1572128
01.04.08;WA91;Uhrmacherwaren;68177;92613;-24436
01.04.08;WA92;Musikinstrumente;35471;27076;8395
01.04.08;WA93;Waffen und Munition;28910;13820;15090
01.04.08;WA94;Möbel, Beleuchtungskörper usw.;1061338;1020839;40499
01.04.08;WA95;Spielzeug, Spiele usw., Sportgeräte;503518;583518;-80000
01.04.08;WA96;Verschiedene Waren;183040;94676;88364
01.04.08;WA97;Kunstgegenstände, Sammlungsstücke;45764;31585;14179
01.04.08;WA98;Vollständige Fabrikationsanlagen;330850;4864;325986
01.04.08;WA99;Zusammenstellungen verschiedener Waren;1510452;1022844;487608
01.04.09;WA01;Lebende Tiere;91209;124642;-33433
01.04.09;WA02;Fleisch;472455;408248;64207
01.04.09;WA03;Fische, Krebs- und Weichtiere;79259;210137;-130878
01.04.09;WA04;Milch, Milcherzeugnisse, Eier, Honig;513231;465982;47249
01.04.09;WA05;Andere Waren tierischen Ursprungs;50804;47977;2827
01.04.09;WA06;Pflanzen, Waren des Blumenhandels;93269;324225;-230956
01.04.09;WA07;Gemüse, Pflanzen für Ernährung;73971;501988;-428017
01.04.09;WA08;Geniessbare Früchte und Nüsse;98041;461986;-363945
01.04.09;WA09;Kaffee, Tee, Mate, Gewürze;129118;208451;-79333
01.04.09;WA10;Getreide;181865;193857;-11992
01.04.09;WA11;Müllereierzeugnisse, Malz usw.;75816;37678;38138
01.04.09;WA12;Ölsamen usw., Heilpflanzen usw.;78156;277833;-199677
01.04.09;WA13;Schellack, Gummen, Harz, Pflanzensaft;45023;30022;15001
01.04.09;WA14;Flechtstoffe usw. pflanzlichen Ursprungs;1197;2407;-1210
01.04.09;WA15;Tierische und pflanzliche Fette, Öle, Wachs;109681;187198;-77517
01.04.09;WA16;Zubereitungen von Fleisch, Fisch usw.;175746;157275;18471
01.04.09;WA17;Zucker und Zuckerwaren;113537;109196;4341
01.04.09;WA18;Kakao und Zubereitungen aus Kakao;154033;187529;-33496
01.04.09;WA19;Zubereitungen aus Getreide usw., Backwaren;336120;196956;139164
01.04.09;WA20;Zubereitungen von Gemüse, Früchten usw.;160226;334958;-174732
01.04.09;WA21;Verschiedene Lebensmittelzubereitungen;290865;217148;73717
01.04.09;WA22;Getränke, alkoholhaltige Flüssigkeiten, Essig;358457;429655;-71198
01.04.09;WA23;Rückstände der Lebensmittelindustrie, Futter;199423;199518;-95
01.04.09;WA24;Tabak;233146;139533;93613
01.04.09;WA25;Salz, Schwefel, Steine, Erden usw.;164498;108633;55865
01.04.09;WA26;Erze, Schlacken, Aschen;19453;305141;-285688
01.04.09;WA27;Mineralische Brennstoffe usw.;1347593;5745381;-4397788
01.04.09;WA28;Anorganische chemische Erzeugnisse;493895;390361;103534
01.04.09;WA29;Organische chemische Erzeugnisse;2120409;1534810;585599
01.04.09;WA30;Pharmazeutische Erzeugnisse;3563549;2733757;829792
01.04.09;WA31;Düngemittel;187002;78975;108027
01.04.09;WA32;Gerb- und Farbstoffe, Farben, Lacke usw.;576710;248086;328624
01.04.09;WA33;Etherische Öle, Riech-, Schönheitsmittel;508517;290642;217875
01.04.09;WA34;Seifen, Waschmittel usw.;367295;174657;192638
01.04.09;WA35;Eiweissstoffe, Klebstoffe, Enzyme;162281;125676;36605
01.04.09;WA36;Sprengstoffe, pyrotechnische Artikel usw.;13759;11664;2095
01.04.09;WA37;Photochemische Erzeugnisse;68605;59633;8972
01.04.09;WA38;Verschiedene Erzeugnisse der Chemischen Industrie;1074023;729652;344371
01.04.09;WA39;Kunststoffe und Waren daraus;2980671;1706076;1274595
01.04.09;WA40;Kautschuk und Waren daraus;701273;653338;47935
01.04.09;WA41;Häute, Felle, Leder;50086;47606;2480
01.04.09;WA42;Lederwaren, Sattlerwaren;88407;164164;-75757
01.04.09;WA43;Pelzfelle, künstliches Pelzwerk;10444;10760;-316
01.04.09;WA44;Holz, Holzwaren, Holzkohle;496668;401053;95615
01.04.09;WA45;Kork, Korkwaren;2675;9675;-7000
01.04.09;WA46;Flechtwaren, Korbmacherwaren;3638;9695;-6057
01.04.09;WA47;Halbstoffe aus Holz usw., Papierabfall;60638;183270;-122632
01.04.09;WA48;Papier, Pappe und Waren daraus;1235534;834968;400566
01.04.09;WA49;Bücher, Zeitungen, Bilddrucke usw.;354867;182533;172334
01.04.09;WA50;Seide;5826;5566;260
01.04.09;WA51;Wolle, feine und grobe Tierhaare;50519;52132;-1613
01.04.09;WA52;Baumwolle;71527;67761;3766
01.04.09;WA53;Andere pflanzliche Spinnstoffe, Papiergarn;2702;4663;-1961
01.04.09;WA54;Synthetisches oder künstliches Filament;144997;96529;48468
01.04.09;WA55;Synthetische oder künstliche Spinnfaser;128532;85398;43134
01.04.09;WA56;Watte, Filz, Vliesstoff usw., Tauwerk;127218;87006;40212
01.04.09;WA57;Teppiche, Fussbodenbelag aus Spinnstoff;37006;82505;-45499
01.04.09;WA58;Spezialgewebe, Spitzen, Tapisserien;38044;24979;13065
01.04.09;WA59;Getränkte, bestrichene usw. Gewebe;113222;81457;31765
01.04.09;WA60;Gewirke und Gestricke;62911;32672;30239
01.04.09;WA61;Bekleidung usw. aus Gewirken, Gestricken;367736;754204;-386468
01.04.09;WA62;Andere Bekleidung, Bekleidungszubehör;484463;849321;-364858
01.04.09;WA63;Andere Konfektion, Spinnstoffwaren usw.;137566;211059;-73493
01.04.09;WA64;Schuhe, Gamaschen, ähnliche Waren;200717;356439;-155722
01.04.09;WA65;Kopfbedeckungen und Teile davon;16951;23324;-6373
01.04.09;WA66;Schirme, Gehstöcke usw., Peitschen;15708;19165;-3457
01.04.09;WA67;Zugerichtete Federn, Daunen, künstliche Blumen;4481;7720;-3239
01.04.09;WA68;Waren aus Steinen, Gips, Zement usw.;235385;155964;79421
01.04.09;WA69;Keramische Waren;218232;148740;69492
01.04.09;WA70;Glas und Glaswaren;356398;233549;122849
01.04.09;WA71;Perlen, Edelsteine, Edelmetalle;617775;1011146;-393371
01.04.09;WA72;Eisen und Stahl;1203138;1088250;114888
01.04.09;WA73;Waren aus Eisen oder Stahl;1722035;1010322;711713
01.04.09;WA74;Kupfer und Waren daraus;550606;358927;191679
01.04.09;WA75;Nickel und Waren daraus;46590;55857;-9267
01.04.09;WA76;Aluminium und Waren daraus;751758;639601;112157
01.04.09;WA78;Blei und Waren daraus;21189;10675;10514
01.04.09;WA79;Zink und Waren daraus;34283;42080;-7797
01.04.09;WA80;Zinn und Waren daraus;4637;12960;-8323
01.04.09;WA81;Andere unedle Metalle, Cermets usw.;46307;78365;-32058
01.04.09;WA82;Werkzeuge, Schneidwaren, Essbestecke;366712;229967;136745
01.04.09;WA83;Verschiedene Waren aus unedlen Metallen;401798;235797;166001
01.04.09;WA84;Maschinen, Apparate, mechanische Geräte;12131143;6576285;5554858
01.04.09;WA85;Elektrotechnische Erzeugnisse;6221518;5537917;683601
01.04.09;WA86;Schienenfahrzeuge;321510;166850;154660
01.04.09;WA87;Kraftfahrzeuge, Landfahrzeuge;8511893;5182936;3328957
01.04.09;WA88;Luftfahrzeuge, Raumfahrzeuge;1884845;1574152;310693
01.04.09;WA89;Wasserfahrzeuge;52824;561960;-509136
01.04.09;WA90;Optische, photografische usw. Erzeugnisse;2807046;1691493;1115553
01.04.09;WA91;Uhrmacherwaren;72001;86138;-14137
01.04.09;WA92;Musikinstrumente;29396;33349;-3953
01.04.09;WA93;Waffen und Munition;31143;11079;20064
01.04.09;WA94;Möbel, Beleuchtungskörper usw.;882168;945353;-63185
01.04.09;WA95;Spielzeug, Spiele usw., Sportgeräte;420118;480479;-60361
01.04.09;WA96;Verschiedene Waren;131380;95846;35534
01.04.09;WA97;Kunstgegenstände, Sammlungsstücke;57307;17593;39714
01.04.09;WA98;Vollständige Fabrikationsanlagen;378379;2834;375545
01.04.09;WA99;Zusammenstellungen verschiedener Waren;1114508;1022295;92213
01.04.10;WA01;Lebende Tiere;85752;127088;-41336
01.04.10;WA02;Fleisch;494029;356950;137079
01.04.10;WA03;Fische, Krebs- und Weichtiere;82780;207634;-124854
01.04.10;WA04;Milch, Milcherzeugnisse, Eier, Honig;548096;431357;116739
01.04.10;WA05;Andere Waren tierischen Ursprungs;46508;49424;-2916
01.04.10;WA06;Pflanzen, Waren des Blumenhandels;93143;314654;-221511
01.04.10;WA07;Gemüse, Pflanzen für Ernährung;76437;542609;-466172
01.04.10;WA08;Geniessbare Früchte und Nüsse;99875;449820;-349945
01.04.10;WA09;Kaffee, Tee, Mate, Gewürze;135777;229418;-93641
01.04.10;WA10;Getreide;155032;102686;52346
01.04.10;WA11;Müllereierzeugnisse, Malz usw.;68073;30995;37078
01.04.10;WA12;Ölsamen usw., Heilpflanzen usw.;64572;202619;-138047
01.04.10;WA13;Schellack, Gummen, Harz, Pflanzensaft;45851;29181;16670
01.04.10;WA14;Flechtstoffe usw. pflanzlichen Ursprungs;976;1894;-918
01.04.10;WA15;Tierische und pflanzliche Fette, Öle, Wachs;132617;222048;-89431
01.04.10;WA16;Zubereitungen von Fleisch, Fisch usw.;169808;155281;14527
01.04.10;WA17;Zucker und Zuckerwaren;120968;103440;17528
01.04.10;WA18;Kakao und Zubereitungen aus Kakao;193687;215019;-21332
01.04.10;WA19;Zubereitungen aus Getreide usw., Backwaren;322896;191877;131019
01.04.10;WA20;Zubereitungen von Gemüse, Früchten usw.;151935;287745;-135810
01.04.10;WA21;Verschiedene Lebensmittelzubereitungen;311071;224624;86447
01.04.10;WA22;Getränke, alkoholhaltige Flüssigkeiten, Essig;366781;410041;-43260
01.04.10;WA23;Rückstände der Lebensmittelindustrie, Futter;202987;217014;-14027
01.04.10;WA24;Tabak;272576;144359;128217
01.04.10;WA25;Salz, Schwefel, Steine, Erden usw.;155097;144205;10892
01.04.10;WA26;Erze, Schlacken, Aschen;28010;590786;-562776
01.04.10;WA27;Mineralische Brennstoffe usw.;1680328;7555925;-5875597
01.04.10;WA28;Anorganische chemische Erzeugnisse;626194;669453;-43259
01.04.10;WA29;Organische chemische Erzeugnisse;2013369;1742220;271149
01.04.10;WA30;Pharmazeutische Erzeugnisse;3707720;2967477;740243
01.04.10;WA31;Düngemittel;168232;75492;92740
01.04.10;WA32;Gerb- und Farbstoffe, Farben, Lacke usw.;713023;321696;391327
01.04.10;WA33;Etherische Öle, Riech-, Schönheitsmittel;592099;319002;273097
01.04.10;WA34;Seifen, Waschmittel usw.;415793;220267;195526
01.04.10;WA35;Eiweissstoffe, Klebstoffe, Enzyme;177886;123692;54194
01.04.10;WA36;Sprengstoffe, pyrotechnische Artikel usw.;15827;14991;836
01.04.10;WA37;Photochemische Erzeugnisse;94918;65468;29450
01.04.10;WA38;Verschiedene Erzeugnisse der Chemischen Industrie;1301396;779582;521814
01.04.10;WA39;Kunststoffe und Waren daraus;3692803;2196792;1496011
01.04.10;WA40;Kautschuk und Waren daraus;923401;883791;39610
01.04.10;WA41;Häute, Felle, Leder;59491;66639;-7148
01.04.10;WA42;Lederwaren, Sattlerwaren;88804;157502;-68698
01.04.10;WA43;Pelzfelle, künstliches Pelzwerk;14466;8260;6206
01.04.10;WA44;Holz, Holzwaren, Holzkohle;530786;484729;46057
01.04.10;WA45;Kork, Korkwaren;2133;6872;-4739
01.04.10;WA46;Flechtwaren, Korbmacherwaren;3179;9417;-6238
01.04.10;WA47;Halbstoffe aus Holz usw., Papierabfall;84989;298975;-213986
01.04.10;WA48;Papier, Pappe und Waren daraus;1402553;917272;485281
01.04.10;WA49;Bücher, Zeitungen, Bilddrucke usw.;328297;161578;166719
01.04.10;WA50;Seide;5704;6070;-366
01.04.10;WA51;Wolle, feine und grobe Tierhaare;47943;64214;-16271
01.04.10;WA52;Baumwolle;78781;74775;4006
01.04.10;WA53;Andere pflanzliche Spinnstoffe, Papiergarn;2740;4544;-1804
01.04.10;WA54;Synthetisches oder künstliches Filament;159435;112872;46563
01.04.10;WA55;Synthetische oder künstliche Spinnfaser;154698;117118;37580
01.04.10;WA56;Watte, Filz, Vliesstoff usw., Tauwerk;155803;87367;68436
01.04.10;WA57;Teppiche, Fussbodenbelag aus Spinnstoff;40425;77281;-36856
01.04.10;WA58;Spezialgewebe, Spitzen, Tapisserien;38814;26190;12624
01.04.10;WA59;Getränkte, bestrichene usw. Gewebe;141874;73033;68841
01.04.10;WA60;Gewirke und Gestricke;67929;36315;31614
01.04.10;WA61;Bekleidung usw. aus Gewirken, Gestricken;382149;750808;-368659
01.04.10;WA62;Andere Bekleidung, Bekleidungszubehör;465112;794383;-329271
01.04.10;WA63;Andere Konfektion, Spinnstoffwaren usw.;142782;219312;-76530
01.04.10;WA64;Schuhe, Gamaschen, ähnliche Waren;182918;368964;-186046
01.04.10;WA65;Kopfbedeckungen und Teile davon;17846;26451;-8605
01.04.10;WA66;Schirme, Gehstöcke usw., Peitschen;18920;17281;1639
01.04.10;WA67;Zugerichtete Federn, Daunen, künstliche Blumen;4392;7502;-3110
01.04.10;WA68;Waren aus Steinen, Gips, Zement usw.;262296;174565;87731
01.04.10;WA69;Keramische Waren;223596;158836;64760
01.04.10;WA70;Glas und Glaswaren;398512;300504;98008
01.04.10;WA71;Perlen, Edelsteine, Edelmetalle;833330;938437;-105107
01.04.10;WA72;Eisen und Stahl;1958290;1730004;228286
01.04.10;WA73;Waren aus Eisen oder Stahl;1748138;1093857;654281
01.04.10;WA74;Kupfer und Waren daraus;837223;736270;100953
01.04.10;WA75;Nickel und Waren daraus;61497;148139;-86642
01.04.10;WA76;Aluminium und Waren daraus;815509;922860;-107351
01.04.10;WA78;Blei und Waren daraus;36748;26547;10201
01.04.10;WA79;Zink und Waren daraus;49320;85636;-36316
01.04.10;WA80;Zinn und Waren daraus;6509;21004;-14495
01.04.10;WA81;Andere unedle Metalle, Cermets usw.;76780;86653;-9873
01.04.10;WA82;Werkzeuge, Schneidwaren, Essbestecke;437834;255703;182131
01.04.10;WA83;Verschiedene Waren aus unedlen Metallen;480482;264622;215860
01.04.10;WA84;Maschinen, Apparate, mechanische Geräte;13104602;7469326;5635276
01.04.10;WA85;Elektrotechnische Erzeugnisse;7465637;7257282;208355
01.04.10;WA86;Schienenfahrzeuge;403332;148272;255060
01.04.10;WA87;Kraftfahrzeuge, Landfahrzeuge;12296528;4899576;7396952
01.04.10;WA88;Luftfahrzeuge, Raumfahrzeuge;1770230;1228468;541762
01.04.10;WA89;Wasserfahrzeuge;639228;1031534;-392306
01.04.10;WA90;Optische, photografische usw. Erzeugnisse;3172032;1782166;1389866
01.04.10;WA91;Uhrmacherwaren;82513;82721;-208
01.04.10;WA92;Musikinstrumente;35178;34562;616
01.04.10;WA93;Waffen und Munition;33724;12205;21519
01.04.10;WA94;Möbel, Beleuchtungskörper usw.;874581;987244;-112663
01.04.10;WA95;Spielzeug, Spiele usw., Sportgeräte;326635;361380;-34745
01.04.10;WA96;Verschiedene Waren;153628;97301;56327
01.04.10;WA97;Kunstgegenstände, Sammlungsstücke;63704;30091;33613
01.04.10;WA98;Vollständige Fabrikationsanlagen;402360;1829;400531
01.04.10;WA99;Zusammenstellungen verschiedener Waren;963357;927230;36127
01.04.11;WA01;Lebende Tiere;110962;136670;-25708
01.04.11;WA02;Fleisch;576588;463592;112996
01.04.11;WA03;Fische, Krebs- und Weichtiere;98896;254181;-155285
01.04.11;WA04;Milch, Milcherzeugnisse, Eier, Honig;652079;521771;130308
01.04.11;WA05;Andere Waren tierischen Ursprungs;54309;55190;-881
01.04.11;WA06;Pflanzen, Waren des Blumenhandels;112961;354222;-241261
01.04.11;WA07;Gemüse, Pflanzen für Ernährung;101366;533451;-432085
01.04.11;WA08;Geniessbare Früchte und Nüsse;109991;521597;-411606
01.04.11;WA09;Kaffee, Tee, Mate, Gewürze;193659;373463;-179804
01.04.11;WA10;Getreide;267418;170767;96651
01.04.11;WA11;Müllereierzeugnisse, Malz usw.;80417;41418;38999
01.04.11;WA12;Ölsamen usw., Heilpflanzen usw.;70111;291883;-221772
01.04.11;WA13;Schellack, Gummen, Harz, Pflanzensaft;36833;28938;7895
01.04.11;WA14;Flechtstoffe usw. pflanzlichen Ursprungs;1076;2506;-1430
01.04.11;WA15;Tierische und pflanzliche Fette, Öle, Wachs;208612;313943;-105331
01.04.11;WA16;Zubereitungen von Fleisch, Fisch usw.;200210;165930;34280
01.04.11;WA17;Zucker und Zuckerwaren;108641;103564;5077
01.04.11;WA18;Kakao und Zubereitungen aus Kakao;239898;265849;-25951
01.04.11;WA19;Zubereitungen aus Getreide usw., Backwaren;362342;216847;145495
01.04.11;WA20;Zubereitungen von Gemüse, Früchten usw.;170020;347531;-177511
01.04.11;WA21;Verschiedene Lebensmittelzubereitungen;349186;174894;174292
01.04.11;WA22;Getränke, alkoholhaltige Flüssigkeiten, Essig;386102;467725;-81623
01.04.11;WA23;Rückstände der Lebensmittelindustrie, Futter;210782;231642;-20860
01.04.11;WA24;Tabak;302134;148062;154072
01.04.11;WA25;Salz, Schwefel, Steine, Erden usw.;183955;162886;21069
01.04.11;WA26;Erze, Schlacken, Aschen;24612;808020;-783408
01.04.11;WA27;Mineralische Brennstoffe usw.;1941929;10944336;-9002407
01.04.11;WA28;Anorganische chemische Erzeugnisse;723693;656186;67507
01.04.11;WA29;Organische chemische Erzeugnisse;1795794;1868668;-72874
01.04.11;WA30;Pharmazeutische Erzeugnisse;4029648;2699855;1329793
01.04.11;WA31;Düngemittel;210721;103016;107705
01.04.11;WA32;Gerb- und Farbstoffe, Farben, Lacke usw.;788212;431966;356246
01.04.11;WA33;Etherische Öle, Riech-, Schönheitsmittel;583164;321828;261336
01.04.11;WA34;Seifen, Waschmittel usw.;463929;227709;236220
01.04.11;WA35;Eiweissstoffe, Klebstoffe, Enzyme;205213;140879;64334
01.04.11;WA36;Sprengstoffe, pyrotechnische Artikel usw.;17916;16176;1740
01.04.11;WA37;Photochemische Erzeugnisse;83057;63956;19101
01.04.11;WA38;Verschiedene Erzeugnisse der Chemischen Industrie;1565648;1004897;560751
01.04.11;WA39;Kunststoffe und Waren daraus;4161272;2675800;1485472
01.04.11;WA40;Kautschuk und Waren daraus;1127330;1135293;-7963
01.04.11;WA41;Häute, Felle, Leder;94081;79857;14224
01.04.11;WA42;Lederwaren, Sattlerwaren;100640;190797;-90157
01.04.11;WA43;Pelzfelle, künstliches Pelzwerk;12548;12854;-306
01.04.11;WA44;Holz, Holzwaren, Holzkohle;575991;571361;4630
01.04.11;WA45;Kork, Korkwaren;2737;11240;-8503
01.04.11;WA46;Flechtwaren, Korbmacherwaren;3140;9720;-6580
01.04.11;WA47;Halbstoffe aus Holz usw., Papierabfall;105727;335774;-230047
01.04.11;WA48;Papier, Pappe und Waren daraus;1532997;988370;544627
01.04.11;WA49;Bücher, Zeitungen, Bilddrucke usw.;333383;162476;170907
01.04.11;WA50;Seide;6180;7302;-1122
01.04.11;WA51;Wolle, feine und grobe Tierhaare;64711;75365;-10654
01.04.11;WA52;Baumwolle;100943;114698;-13755
01.04.11;WA53;Andere pflanzliche Spinnstoffe, Papiergarn;3403;6293;-2890
01.04.11;WA54;Synthetisches oder künstliches Filament;177733;127022;50711
01.04.11;WA55;Synthetische oder künstliche Spinnfaser;167800;143572;24228
01.04.11;WA56;Watte, Filz, Vliesstoff usw., Tauwerk;180468;107060;73408
01.04.11;WA57;Teppiche, Fussbodenbelag aus Spinnstoff;40937;94796;-53859
01.04.11;WA58;Spezialgewebe, Spitzen, Tapisserien;44410;29219;15191
01.04.11;WA59;Getränkte, bestrichene usw. Gewebe;160602;99513;61089
01.04.11;WA60;Gewirke und Gestricke;86846;44377;42469
01.04.11;WA61;Bekleidung usw. aus Gewirken, Gestricken;429463;854653;-425190
01.04.11;WA62;Andere Bekleidung, Bekleidungszubehör;528053;965456;-437403
01.04.11;WA63;Andere Konfektion, Spinnstoffwaren usw.;155312;276489;-121177
01.04.11;WA64;Schuhe, Gamaschen, ähnliche Waren;233109;425550;-192441
01.04.11;WA65;Kopfbedeckungen und Teile davon;19791;25732;-5941
01.04.11;WA66;Schirme, Gehstöcke usw., Peitschen;8257;17884;-9627
01.04.11;WA67;Zugerichtete Federn, Daunen, künstliche Blumen;5473;8681;-3208
01.04.11;WA68;Waren aus Steinen, Gips, Zement usw.;309260;202194;107066
01.04.11;WA69;Keramische Waren;231621;181979;49642
01.04.11;WA70;Glas und Glaswaren;425799;334560;91239
01.04.11;WA71;Perlen, Edelsteine, Edelmetalle;942972;1016273;-73301
01.04.11;WA72;Eisen und Stahl;2175301;2443776;-268475
01.04.11;WA73;Waren aus Eisen oder Stahl;2107543;1494860;612683
01.04.11;WA74;Kupfer und Waren daraus;1057885;1044969;12916
01.04.11;WA75;Nickel und Waren daraus;75003;209649;-134646
01.04.11;WA76;Aluminium und Waren daraus;1036831;1195419;-158588
01.04.11;WA78;Blei und Waren daraus;39756;30494;9262
01.04.11;WA79;Zink und Waren daraus;58399;105141;-46742
01.04.11;WA80;Zinn und Waren daraus;12864;52377;-39513
01.04.11;WA81;Andere unedle Metalle, Cermets usw.;103819;134824;-31005
01.04.11;WA82;Werkzeuge, Schneidwaren, Essbestecke;525732;324787;200945
01.04.11;WA83;Verschiedene Waren aus unedlen Metallen;533313;304574;228739
01.04.11;WA84;Maschinen, Apparate, mechanische Geräte;15180246;8927132;6253114
01.04.11;WA85;Elektrotechnische Erzeugnisse;8406067;7948511;457556
01.04.11;WA86;Schienenfahrzeuge;289473;133163;156310
01.04.11;WA87;Kraftfahrzeuge, Landfahrzeuge;14101582;5883348;8218234
01.04.11;WA88;Luftfahrzeuge, Raumfahrzeuge;1708086;944345;763741
01.04.11;WA89;Wasserfahrzeuge;284870;735548;-450678
01.04.11;WA90;Optische, photografische usw. Erzeugnisse;3643058;2030246;1612812
01.04.11;WA91;Uhrmacherwaren;112248;124201;-11953
01.04.11;WA92;Musikinstrumente;34634;34733;-99
01.04.11;WA93;Waffen und Munition;32896;12505;20391
01.04.11;WA94;Möbel, Beleuchtungskörper usw.;1047053;1113158;-66105
01.04.11;WA95;Spielzeug, Spiele usw., Sportgeräte;294597;422431;-127834
01.04.11;WA96;Verschiedene Waren;162098;113801;48297
01.04.11;WA97;Kunstgegenstände, Sammlungsstücke;60045;37207;22838
01.04.11;WA98;Vollständige Fabrikationsanlagen;234069;432;233637
01.04.11;WA99;Zusammenstellungen verschiedener Waren;1197398;904817;292581
01.04.12;WA01;Lebende Tiere;104908;144292;-39384
01.04.12;WA02;Fleisch;547981;437277;110704
01.04.12;WA03;Fische, Krebs- und Weichtiere;96472;205748;-109276
01.04.12;WA04;Milch, Milcherzeugnisse, Eier, Honig;623036;469376;153660
01.04.12;WA05;Andere Waren tierischen Ursprungs;52915;72996;-20081
01.04.12;WA06;Pflanzen, Waren des Blumenhandels;101342;334159;-232817
01.04.12;WA07;Gemüse, Pflanzen für Ernährung;73169;491156;-417987
01.04.12;WA08;Geniessbare Früchte und Nüsse;94915;489002;-394087
01.04.12;WA09;Kaffee, Tee, Mate, Gewürze;171579;391347;-219768
01.04.12;WA10;Getreide;226597;187718;38879
01.04.12;WA11;Müllereierzeugnisse, Malz usw.;85681;39576;46105
01.04.12;WA12;Ölsamen usw., Heilpflanzen usw.;63971;434137;-370166
01.04.12;WA13;Schellack, Gummen, Harz, Pflanzensaft;40106;38027;2079
01.04.12;WA14;Flechtstoffe usw. pflanzlichen Ursprungs;1278;2820;-1542
01.04.12;WA15;Tierische und pflanzliche Fette, Öle, Wachs;211054;241850;-30796
01.04.12;WA16;Zubereitungen von Fleisch, Fisch usw.;212162;177073;35089
01.04.12;WA17;Zucker und Zuckerwaren;126778;129071;-2293
01.04.12;WA18;Kakao und Zubereitungen aus Kakao;180996;182948;-1952
01.04.12;WA19;Zubereitungen aus Getreide usw., Backwaren;370746;199782;170964
01.04.12;WA20;Zubereitungen von Gemüse, Früchten usw.;176462;347606;-171144
01.04.12;WA21;Verschiedene Lebensmittelzubereitungen;312383;170737;141646
01.04.12;WA22;Getränke, alkoholhaltige Flüssigkeiten, Essig;381402;484394;-102992
01.04.12;WA23;Rückstände der Lebensmittelindustrie, Futter;236996;234560;2436
01.04.12;WA24;Tabak;332092;150503;181589
01.04.12;WA25;Salz, Schwefel, Steine, Erden usw.;174443;154749;19694
01.04.12;WA26;Erze, Schlacken, Aschen;25703;647586;-621883
01.04.12;WA27;Mineralische Brennstoffe usw.;2393507;10427527;-8034020
01.04.12;WA28;Anorganische chemische Erzeugnisse;732235;628697;103538
01.04.12;WA29;Organische chemische Erzeugnisse;1936085;2087097;-151012
01.04.12;WA30;Pharmazeutische Erzeugnisse;4082144;2466133;1616011
01.04.12;WA31;Düngemittel;253998;142154;111844
01.04.12;WA32;Gerb- und Farbstoffe, Farben, Lacke usw.;830503;435967;394536
01.04.12;WA33;Etherische Öle, Riech-, Schönheitsmittel;631913;354473;277440
01.04.12;WA34;Seifen, Waschmittel usw.;471877;230746;241131
01.04.12;WA35;Eiweissstoffe, Klebstoffe, Enzyme;223090;147277;75813
01.04.12;WA36;Sprengstoffe, pyrotechnische Artikel usw.;11791;14872;-3081
01.04.12;WA37;Photochemische Erzeugnisse;78951;59767;19184
01.04.12;WA38;Verschiedene Erzeugnisse der Chemischen Industrie;1478954;934297;544657
01.04.12;WA39;Kunststoffe und Waren daraus;4176301;2640702;1535599
01.04.12;WA40;Kautschuk und Waren daraus;1129038;1115091;13947
01.04.12;WA41;Häute, Felle, Leder;79599;72467;7132
01.04.12;WA42;Lederwaren, Sattlerwaren;110927;205239;-94312
01.04.12;WA43;Pelzfelle, künstliches Pelzwerk;12691;13681;-990
01.04.12;WA44;Holz, Holzwaren, Holzkohle;524381;537286;-12905
01.04.12;WA45;Kork, Korkwaren;2673;6826;-4153
01.04.12;WA46;Flechtwaren, Korbmacherwaren;3121;9286;-6165
01.04.12;WA47;Halbstoffe aus Holz usw., Papierabfall;90062;289411;-199349
01.04.12;WA48;Papier, Pappe und Waren daraus;1326567;898073;428494
01.04.12;WA49;Bücher, Zeitungen, Bilddrucke usw.;313395;153371;160024
01.04.12;WA50;Seide;5394;5708;-314
01.04.12;WA51;Wolle, feine und grobe Tierhaare;60513;76748;-16235
01.04.12;WA52;Baumwolle;80774;80561;213
01.04.12;WA53;Andere pflanzliche Spinnstoffe, Papiergarn;3439;5125;-1686
01.04.12;WA54;Synthetisches oder künstliches Filament;156311;114645;41666
01.04.12;WA55;Synthetische oder künstliche Spinnfaser;160053;126616;33437
01.04.12;WA56;Watte, Filz, Vliesstoff usw., Tauwerk;171547;95987;75560
01.04.12;WA57;Teppiche, Fussbodenbelag aus Spinnstoff;41310;74651;-33341
01.04.12;WA58;Spezialgewebe, Spitzen, Tapisserien;38027;26605;11422
01.04.12;WA59;Getränkte, bestrichene usw. Gewebe;157687;94306;63381
01.04.12;WA60;Gewirke und Gestricke;75440;43123;32317
01.04.12;WA61;Bekleidung usw. aus Gewirken, Gestricken;423661;809678;-386017
01.04.12;WA62;Andere Bekleidung, Bekleidungszubehör;494783;892948;-398165
01.04.12;WA63;Andere Konfektion, Spinnstoffwaren usw.;166595;241903;-75308
01.04.12;WA64;Schuhe, Gamaschen, ähnliche Waren;218626;430349;-211723
01.04.12;WA65;Kopfbedeckungen und Teile davon;19049;27432;-8383
01.04.12;WA66;Schirme, Gehstöcke usw., Peitschen;8258;16647;-8389
01.04.12;WA67;Zugerichtete Federn, Daunen, künstliche Blumen;6033;8952;-2919
01.04.12;WA68;Waren aus Steinen, Gips, Zement usw.;293840;211946;81894
01.04.12;WA69;Keramische Waren;240925;185459;55466
01.04.12;WA70;Glas und Glaswaren;397158;314268;82890
01.04.12;WA71;Perlen, Edelsteine, Edelmetalle;1186263;1100372;85891
01.04.12;WA72;Eisen und Stahl;2134950;2089970;44980
01.04.12;WA73;Waren aus Eisen oder Stahl;2075553;1377821;697732
01.04.12;WA74;Kupfer und Waren daraus;838029;881707;-43678
01.04.12;WA75;Nickel und Waren daraus;98392;128000;-29608
01.04.12;WA76;Aluminium und Waren daraus;969733;1101561;-131828
01.04.12;WA78;Blei und Waren daraus;30835;23366;7469
01.04.12;WA79;Zink und Waren daraus;50364;95654;-45290
01.04.12;WA80;Zinn und Waren daraus;9567;30484;-20917
01.04.12;WA81;Andere unedle Metalle, Cermets usw.;119049;133123;-14074
01.04.12;WA82;Werkzeuge, Schneidwaren, Essbestecke;565562;332465;233097
01.04.12;WA83;Verschiedene Waren aus unedlen Metallen;523628;292642;230986
01.04.12;WA84;Maschinen, Apparate, mechanische Geräte;15471251;9004891;6466360
01.04.12;WA85;Elektrotechnische Erzeugnisse;8424061;7880267;543794
01.04.12;WA86;Schienenfahrzeuge;326091;117648;208443
01.04.12;WA87;Kraftfahrzeuge, Landfahrzeuge;14959011;5995215;8963796
01.04.12;WA88;Luftfahrzeuge, Raumfahrzeuge;2292296;1974707;317589
01.04.12;WA89;Wasserfahrzeuge;211341;281406;-70065
01.04.12;WA90;Optische, photografische usw. Erzeugnisse;3841146;2162805;1678341
01.04.12;WA91;Uhrmacherwaren;92127;170478;-78351
01.04.12;WA92;Musikinstrumente;38322;35492;2830
01.04.12;WA93;Waffen und Munition;33916;19194;14722
01.04.12;WA94;Möbel, Beleuchtungskörper usw.;1080983;1143576;-62593
01.04.12;WA95;Spielzeug, Spiele usw., Sportgeräte;303223;332696;-29473
01.04.12;WA96;Verschiedene Waren;269599;177208;92391
01.04.12;WA97;Kunstgegenstände, Sammlungsstücke;82024;17741;64283
01.04.12;WA98;Vollständige Fabrikationsanlagen;192453;2066;190387
01.04.12;WA99;Zusammenstellungen verschiedener Waren;1651143;850996;800147
01.04.13;WA01;Lebende Tiere;105907;179614;-73707
01.04.13;WA02;Fleisch;612374;477761;134613
01.04.13;WA03;Fische, Krebs- und Weichtiere;94258;230975;-136717
01.04.13;WA04;Milch, Milcherzeugnisse, Eier, Honig;738848;525955;212893
01.04.13;WA05;Andere Waren tierischen Ursprungs;72981;75830;-2849
01.04.13;WA06;Pflanzen, Waren des Blumenhandels;118729;316499;-197770
01.04.13;WA07;Gemüse, Pflanzen für Ernährung;105393;541596;-436203
01.04.13;WA08;Geniessbare Früchte und Nüsse;103173;596997;-493824
01.04.13;WA09;Kaffee, Tee, Mate, Gewürze;190504;356270;-165766
01.04.13;WA10;Getreide;271713;195726;75987
01.04.13;WA11;Müllereierzeugnisse, Malz usw.;105442;41436;64006
01.04.13;WA12;Ölsamen usw., Heilpflanzen usw.;67148;408610;-341462
01.04.13;WA13;Schellack, Gummen, Harz, Pflanzensaft;43996;43987;9
01.04.13;WA14;Flechtstoffe usw. pflanzlichen Ursprungs;667;2547;-1880
01.04.13;WA15;Tierische und pflanzliche Fette, Öle, Wachs;239767;339128;-99361
01.04.13;WA16;Zubereitungen von Fleisch, Fisch usw.;213130;188349;24781
01.04.13;WA17;Zucker und Zuckerwaren;147744;151962;-4218
01.04.13;WA18;Kakao und Zubereitungen aus Kakao;250355;240467;9888
01.04.13;WA19;Zubereitungen aus Getreide usw., Backwaren;390353;227943;162410
01.04.13;WA20;Zubereitungen von Gemüse, Früchten usw.;184697;335106;-150409
01.04.13;WA21;Verschiedene Lebensmittelzubereitungen;404901;217085;187816
01.04.13;WA22;Getränke, alkoholhaltige Flüssigkeiten, Essig;414213;515279;-101066
01.04.13;WA23;Rückstände der Lebensmittelindustrie, Futter;297833;288385;9448
01.04.13;WA24;Tabak;306396;155402;150994
01.04.13;WA25;Salz, Schwefel, Steine, Erden usw.;168651;166563;2088
01.04.13;WA26;Erze, Schlacken, Aschen;26384;781427;-755043
01.04.13;WA27;Mineralische Brennstoffe usw.;2129483;10324113;-8194630
01.04.13;WA28;Anorganische chemische Erzeugnisse;687246;414879;272367
01.04.13;WA29;Organische chemische Erzeugnisse;2057571;2363359;-305788
01.04.13;WA30;Pharmazeutische Erzeugnisse;4878210;2883651;1994559
01.04.13;WA31;Düngemittel;257841;141789;116052
01.04.13;WA32;Gerb- und Farbstoffe, Farben, Lacke usw.;914404;525748;388656
01.04.13;WA33;Etherische Öle, Riech-, Schönheitsmittel;687510;434765;252745
01.04.13;WA34;Seifen, Waschmittel usw.;538421;271345;267076
01.04.13;WA35;Eiweissstoffe, Klebstoffe, Enzyme;248589;167310;81279
01.04.13;WA36;Sprengstoffe, pyrotechnische Artikel usw.;13074;13039;35
01.04.13;WA37;Photochemische Erzeugnisse;100525;65616;34909
01.04.13;WA38;Verschiedene Erzeugnisse der Chemischen Industrie;1633779;974374;659405
01.04.13;WA39;Kunststoffe und Waren daraus;4462152;2748929;1713223
01.04.13;WA40;Kautschuk und Waren daraus;1203990;1180666;23324
01.04.13;WA41;Häute, Felle, Leder;93342;78326;15016
01.04.13;WA42;Lederwaren, Sattlerwaren;116995;209897;-92902
01.04.13;WA43;Pelzfelle, künstliches Pelzwerk;15232;15118;114
01.04.13;WA44;Holz, Holzwaren, Holzkohle;564770;538736;26034
01.04.13;WA45;Kork, Korkwaren;2892;7409;-4517
01.04.13;WA46;Flechtwaren, Korbmacherwaren;3693;7053;-3360
01.04.13;WA47;Halbstoffe aus Holz usw., Papierabfall;102294;316047;-213753
01.04.13;WA48;Papier, Pappe und Waren daraus;1408218;900487;507731
01.04.13;WA49;Bücher, Zeitungen, Bilddrucke usw.;339383;142437;196946
01.04.13;WA50;Seide;5986;6128;-142
01.04.13;WA51;Wolle, feine und grobe Tierhaare;55004;62049;-7045
01.04.13;WA52;Baumwolle;76835;83761;-6926
01.04.13;WA53;Andere pflanzliche Spinnstoffe, Papiergarn;2973;5220;-2247
01.04.13;WA54;Synthetisches oder künstliches Filament;162916;118603;44313
01.04.13;WA55;Synthetische oder künstliche Spinnfaser;169611;139385;30226
01.04.13;WA56;Watte, Filz, Vliesstoff usw., Tauwerk;185901;103439;82462
01.04.13;WA57;Teppiche, Fussbodenbelag aus Spinnstoff;42173;81786;-39613
01.04.13;WA58;Spezialgewebe, Spitzen, Tapisserien;41505;25112;16393
01.04.13;WA59;Getränkte, bestrichene usw. Gewebe;173557;95430;78127
01.04.13;WA60;Gewirke und Gestricke;74397;42622;31775
01.04.13;WA61;Bekleidung usw. aus Gewirken, Gestricken;442018;907379;-465361
01.04.13;WA62;Andere Bekleidung, Bekleidungszubehör;514295;963175;-448880
01.04.13;WA63;Andere Konfektion, Spinnstoffwaren usw.;180371;245549;-65178
01.04.13;WA64;Schuhe, Gamaschen, ähnliche Waren;246006;462043;-216037
01.04.13;WA65;Kopfbedeckungen und Teile davon;22261;28615;-6354
01.04.13;WA66;Schirme, Gehstöcke usw., Peitschen;7792;14388;-6596
01.04.13;WA67;Zugerichtete Federn, Daunen, künstliche Blumen;6316;7584;-1268
01.04.13;WA68;Waren aus Steinen, Gips, Zement usw.;320116;216697;103419
01.04.13;WA69;Keramische Waren;241657;183469;58188
01.04.13;WA70;Glas und Glaswaren;439460;332700;106760
01.04.13;WA71;Perlen, Edelsteine, Edelmetalle;1222488;1460562;-238074
01.04.13;WA72;Eisen und Stahl;1933366;2037056;-103690
01.04.13;WA73;Waren aus Eisen oder Stahl;2306492;1416916;889576
01.04.13;WA74;Kupfer und Waren daraus;906412;823345;83067
01.04.13;WA75;Nickel und Waren daraus;88945;125898;-36953
01.04.13;WA76;Aluminium und Waren daraus;1056818;1098557;-41739
01.04.13;WA78;Blei und Waren daraus;32230;30846;1384
01.04.13;WA79;Zink und Waren daraus;50393;85837;-35444
01.04.13;WA80;Zinn und Waren daraus;9609;42685;-33076
01.04.13;WA81;Andere unedle Metalle, Cermets usw.;104795;134593;-29798
01.04.13;WA82;Werkzeuge, Schneidwaren, Essbestecke;585128;326514;258614
01.04.13;WA83;Verschiedene Waren aus unedlen Metallen;556706;314127;242579
01.04.13;WA84;Maschinen, Apparate, mechanische Geräte;16457331;9479695;6977636
01.04.13;WA85;Elektrotechnische Erzeugnisse;9002091;8202190;799901
01.04.13;WA86;Schienenfahrzeuge;368762;200036;168726
01.04.13;WA87;Kraftfahrzeuge, Landfahrzeuge;16523718;6557827;9965891
01.04.13;WA88;Luftfahrzeuge, Raumfahrzeuge;2310209;1450718;859491
01.04.13;WA89;Wasserfahrzeuge;521226;166222;355004
01.04.13;WA90;Optische, photografische usw. Erzeugnisse;4209804;2341421;1868383
01.04.13;WA91;Uhrmacherwaren;140208;177606;-37398
01.04.13;WA92;Musikinstrumente;39204;33510;5694
01.04.13;WA93;Waffen und Munition;43933;20840;23093
01.04.13;WA94;Möbel, Beleuchtungskörper usw.;1118645;1160807;-42162
01.04.13;WA95;Spielzeug, Spiele usw., Sportgeräte;227961;276749;-48788
01.04.13;WA96;Verschiedene Waren;292218;177149;115069
01.04.13;WA97;Kunstgegenstände, Sammlungsstücke;48880;32208;16672
01.04.13;WA98;Vollständige Fabrikationsanlagen;255884;1047;254837
01.04.13;WA99;Zusammenstellungen verschiedener Waren;1563889;793171;770718
01.04.14;WA01;Lebende Tiere;125789;179973;-54184
01.04.14;WA02;Fleisch;630965;528992;101973
01.04.14;WA03;Fische, Krebs- und Weichtiere;90928;290369;-199441
01.04.14;WA04;Milch, Milcherzeugnisse, Eier, Honig;829194;594414;234780
01.04.14;WA05;Andere Waren tierischen Ursprungs;72084;67102;4982
01.04.14;WA06;Pflanzen, Waren des Blumenhandels;122094;344212;-222118
01.04.14;WA07;Gemüse, Pflanzen für Ernährung;82628;552273;-469645
01.04.14;WA08;Geniessbare Früchte und Nüsse;116575;621984;-505409
01.04.14;WA09;Kaffee, Tee, Mate, Gewürze;165913;336914;-171001
01.04.14;WA10;Getreide;303292;243570;59722
01.04.14;WA11;Müllereierzeugnisse, Malz usw.;105836;43922;61914
01.04.14;WA12;Ölsamen usw., Heilpflanzen usw.;76889;369691;-292802
01.04.14;WA13;Schellack, Gummen, Harz, Pflanzensaft;44034;35013;9021
01.04.14;WA14;Flechtstoffe usw. pflanzlichen Ursprungs;930;4467;-3537
01.04.14;WA15;Tierische und pflanzliche Fette, Öle, Wachs;196212;275195;-78983
01.04.14;WA16;Zubereitungen von Fleisch, Fisch usw.;227974;192959;35015
01.04.14;WA17;Zucker und Zuckerwaren;150373;124204;26169
01.04.14;WA18;Kakao und Zubereitungen aus Kakao;289740;250904;38836
01.04.14;WA19;Zubereitungen aus Getreide usw., Backwaren;422246;276212;146034
01.04.14;WA20;Zubereitungen von Gemüse, Früchten usw.;212107;351696;-139589
01.04.14;WA21;Verschiedene Lebensmittelzubereitungen;435953;240889;195064
01.04.14;WA22;Getränke, alkoholhaltige Flüssigkeiten, Essig;438798;527395;-88597
01.04.14;WA23;Rückstände der Lebensmittelindustrie, Futter;320998;274754;46244
01.04.14;WA24;Tabak;290344;141993;148351
01.04.14;WA25;Salz, Schwefel, Steine, Erden usw.;171040;151712;19328
01.04.14;WA26;Erze, Schlacken, Aschen;23903;621394;-597491
01.04.14;WA27;Mineralische Brennstoffe usw.;2161756;9248132;-7086376
01.04.14;WA28;Anorganische chemische Erzeugnisse;730226;531388;198838
01.04.14;WA29;Organische chemische Erzeugnisse;2060426;2188195;-127769
01.04.14;WA30;Pharmazeutische Erzeugnisse;4646665;2980656;1666009
01.04.14;WA31;Düngemittel;192656;141917;50739
01.04.14;WA32;Gerb- und Farbstoffe, Farben, Lacke usw.;904189;488649;415540
01.04.14;WA33;Etherische Öle, Riech-, Schönheitsmittel;675710;432288;243422
01.04.14;WA34;Seifen, Waschmittel usw.;539932;274746;265186
01.04.14;WA35;Eiweissstoffe, Klebstoffe, Enzyme;259935;168049;91886
01.04.14;WA36;Sprengstoffe, pyrotechnische Artikel usw.;14102;11642;2460
01.04.14;WA37;Photochemische Erzeugnisse;91950;62352;29598
01.04.14;WA38;Verschiedene Erzeugnisse der Chemischen Industrie;1643629;1015901;627728
01.04.14;WA39;Kunststoffe und Waren daraus;4601861;2890228;1711633
01.04.14;WA40;Kautschuk und Waren daraus;1191308;1132459;58849
01.04.14;WA41;Häute, Felle, Leder;91674;79618;12056
01.04.14;WA42;Lederwaren, Sattlerwaren;121452;229055;-107603
01.04.14;WA43;Pelzfelle, künstliches Pelzwerk;17208;13200;4008
01.04.14;WA44;Holz, Holzwaren, Holzkohle;597242;604951;-7709
01.04.14;WA45;Kork, Korkwaren;2869;9873;-7004
01.04.14;WA46;Flechtwaren, Korbmacherwaren;4034;8489;-4455
01.04.14;WA47;Halbstoffe aus Holz usw., Papierabfall;94493;271707;-177214
01.04.14;WA48;Papier, Pappe und Waren daraus;1422063;974272;447791
01.04.14;WA49;Bücher, Zeitungen, Bilddrucke usw.;321042;158761;162281
01.04.14;WA50;Seide;5738;7415;-1677
01.04.14;WA51;Wolle, feine und grobe Tierhaare;50710;57684;-6974
01.04.14;WA52;Baumwolle;85944;84361;1583
01.04.14;WA53;Andere pflanzliche Spinnstoffe, Papiergarn;2973;5584;-2611
01.04.14;WA54;Synthetisches oder künstliches Filament;165667;130637;35030
01.04.14;WA55;Synthetische oder künstliche Spinnfaser;165896;135246;30650
01.04.14;WA56;Watte, Filz, Vliesstoff usw., Tauwerk;202698;112103;90595
01.04.14;WA57;Teppiche, Fussbodenbelag aus Spinnstoff;42073;73577;-31504
01.04.14;WA58;Spezialgewebe, Spitzen, Tapisserien;43235;24722;18513
01.04.14;WA59;Getränkte, bestrichene usw. Gewebe;173848;92407;81441
01.04.14;WA60;Gewirke und Gestricke;76561;44681;31880
01.04.14;WA61;Bekleidung usw. aus Gewirken, Gestricken;461499;949338;-487839
01.04.14;WA62;Andere Bekleidung, Bekleidungszubehör;526484;989468;-462984
01.04.14;WA63;Andere Konfektion, Spinnstoffwaren usw.;194081;273672;-79591
01.04.14;WA64;Schuhe, Gamaschen, ähnliche Waren;301712;546291;-244579
01.04.14;WA65;Kopfbedeckungen und Teile davon;27312;33549;-6237
01.04.14;WA66;Schirme, Gehstöcke usw., Peitschen;7338;15439;-8101
01.04.14;WA67;Zugerichtete Federn, Daunen, künstliche Blumen;7163;8281;-1118
01.04.14;WA68;Waren aus Steinen, Gips, Zement usw.;339576;236740;102836
01.04.14;WA69;Keramische Waren;243729;193791;49938
01.04.14;WA70;Glas und Glaswaren;481575;364100;117475
01.04.14;WA71;Perlen, Edelsteine, Edelmetalle;860737;1140761;-280024
01.04.14;WA72;Eisen und Stahl;1902092;1913145;-11053
01.04.14;WA73;Waren aus Eisen oder Stahl;2153106;1492694;660412
01.04.14;WA74;Kupfer und Waren daraus;869047;832001;37046
01.04.14;WA75;Nickel und Waren daraus;87367;109190;-21823
01.04.14;WA76;Aluminium und Waren daraus;1074119;1101432;-27313
01.04.14;WA78;Blei und Waren daraus;37652;28866;8786
01.04.14;WA79;Zink und Waren daraus;51266;97052;-45786
01.04.14;WA80;Zinn und Waren daraus;11517;36791;-25274
01.04.14;WA81;Andere unedle Metalle, Cermets usw.;112432;123627;-11195
01.04.14;WA82;Werkzeuge, Schneidwaren, Essbestecke;624978;344645;280333
01.04.14;WA83;Verschiedene Waren aus unedlen Metallen;574831;333923;240908
01.04.14;WA84;Maschinen, Apparate, mechanische Geräte;16114246;9178193;6936053
01.04.14;WA85;Elektrotechnische Erzeugnisse;8961367;8190890;770477
01.04.14;WA86;Schienenfahrzeuge;320301;175212;145089
01.04.14;WA87;Kraftfahrzeuge, Landfahrzeuge;16868631;6805238;10063393
01.04.14;WA88;Luftfahrzeuge, Raumfahrzeuge;2347340;1923791;423549
01.04.14;WA89;Wasserfahrzeuge;93799;159948;-66149
01.04.14;WA90;Optische, photografische usw. Erzeugnisse;4195211;2361448;1833763
01.04.14;WA91;Uhrmacherwaren;141397;165672;-24275
01.04.14;WA92;Musikinstrumente;42353;36898;5455
01.04.14;WA93;Waffen und Munition;38712;16632;22080
01.04.14;WA94;Möbel, Beleuchtungskörper usw.;1133503;1330096;-196593
01.04.14;WA95;Spielzeug, Spiele usw., Sportgeräte;228956;292888;-63932
01.04.14;WA96;Verschiedene Waren;301691;192441;109250
01.04.14;WA97;Kunstgegenstände, Sammlungsstücke;56762;51236;5526
01.04.14;WA98;Vollständige Fabrikationsanlagen;250991;4345;246646
01.04.14;WA99;Zusammenstellungen verschiedener Waren;1458868;1136177;322691
01.04.15;WA01;Lebende Tiere;127942;148134;-20192
01.04.15;WA02;Fleisch;551643;472105;79538
01.04.15;WA03;Fische, Krebs- und Weichtiere;109487;264710;-155223
01.04.15;WA04;Milch, Milcherzeugnisse, Eier, Honig;679819;526672;153147
01.04.15;WA05;Andere Waren tierischen Ursprungs;59030;61388;-2358
01.04.15;WA06;Pflanzen, Waren des Blumenhandels;118108;318903;-200795
01.04.15;WA07;Gemüse, Pflanzen für Ernährung;83634;609501;-525867
01.04.15;WA08;Geniessbare Früchte und Nüsse;140605;761418;-620813
01.04.15;WA09;Kaffee, Tee, Mate, Gewürze;212180;400133;-187953
01.04.15;WA10;Getreide;383482;214368;169114
01.04.15;WA11;Müllereierzeugnisse, Malz usw.;118502;42080;76422
01.04.15;WA12;Ölsamen usw., Heilpflanzen usw.;78860;380724;-301864
01.04.15;WA13;Schellack, Gummen, Harz, Pflanzensaft;48775;43471;5304
01.04.15;WA14;Flechtstoffe usw. pflanzlichen Ursprungs;809;2995;-2186
01.04.15;WA15;Tierische und pflanzliche Fette, Öle, Wachs;215537;273382;-57845
01.04.15;WA16;Zubereitungen von Fleisch, Fisch usw.;223878;201274;22604
01.04.15;WA17;Zucker und Zuckerwaren;134951;126788;8163
01.04.15;WA18;Kakao und Zubereitungen aus Kakao;273989;312808;-38819
01.04.15;WA19;Zubereitungen aus Getreide usw., Backwaren;426887;302421;124466
01.04.15;WA20;Zubereitungen von Gemüse, Früchten usw.;212510;373237;-160727
01.04.15;WA21;Verschiedene Lebensmittelzubereitungen;434629;255081;179548
01.04.15;WA22;Getränke, alkoholhaltige Flüssigkeiten, Essig;446546;557332;-110786
01.04.15;WA23;Rückstände der Lebensmittelindustrie, Futter;321084;282763;38321
01.04.15;WA24;Tabak;333454;162323;171131
01.04.15;WA25;Salz, Schwefel, Steine, Erden usw.;173886;166722;7164
01.04.15;WA26;Erze, Schlacken, Aschen;32138;557167;-525029
01.04.15;WA27;Mineralische Brennstoffe usw.;2270496;7801289;-5530793
01.04.15;WA28;Anorganische chemische Erzeugnisse;666957;561055;105902
01.04.15;WA29;Organische chemische Erzeugnisse;2092274;2528872;-436598
01.04.15;WA30;Pharmazeutische Erzeugnisse;5415141;3411631;2003510
01.04.15;WA31;Düngemittel;233414;116341;117073
01.04.15;WA32;Gerb- und Farbstoffe, Farben, Lacke usw.;950466;508354;442112
01.04.15;WA33;Etherische Öle, Riech-, Schönheitsmittel;690727;489595;201132
01.04.15;WA34;Seifen, Waschmittel usw.;558642;289798;268844
01.04.15;WA35;Eiweissstoffe, Klebstoffe, Enzyme;270749;179516;91233
01.04.15;WA36;Sprengstoffe, pyrotechnische Artikel usw.;13749;16049;-2300
01.04.15;WA37;Photochemische Erzeugnisse;104755;71043;33712
01.04.15;WA38;Verschiedene Erzeugnisse der Chemischen Industrie;1718927;1007019;711908
01.04.15;WA39;Kunststoffe und Waren daraus;4730873;2967251;1763622
01.04.15;WA40;Kautschuk und Waren daraus;1207517;1033645;173872
01.04.15;WA41;Häute, Felle, Leder;99001;78639;20362
01.04.15;WA42;Lederwaren, Sattlerwaren;152638;243305;-90667
01.04.15;WA43;Pelzfelle, künstliches Pelzwerk;10232;8522;1710
01.04.15;WA44;Holz, Holzwaren, Holzkohle;621888;622255;-367
01.04.15;WA45;Kork, Korkwaren;2394;5366;-2972
01.04.15;WA46;Flechtwaren, Korbmacherwaren;4326;10108;-5782
01.04.15;WA47;Halbstoffe aus Holz usw., Papierabfall;95215;317295;-222080
01.04.15;WA48;Papier, Pappe und Waren daraus;1457305;1010658;446647
01.04.15;WA49;Bücher, Zeitungen, Bilddrucke usw.;331911;175311;156600
01.04.15;WA50;Seide;6695;6168;527
01.04.15;WA51;Wolle, feine und grobe Tierhaare;46931;57015;-10084
01.04.15;WA52;Baumwolle;78684;80314;-1630
01.04.15;WA53;Andere pflanzliche Spinnstoffe, Papiergarn;3024;5034;-2010
01.04.15;WA54;Synthetisches oder künstliches Filament;167305;131379;35926
01.04.15;WA55;Synthetische oder künstliche Spinnfaser;165200;128595;36605
01.04.15;WA56;Watte, Filz, Vliesstoff usw., Tauwerk;194657;111211;83446
01.04.15;WA57;Teppiche, Fussbodenbelag aus Spinnstoff;38833;80309;-41476
01.04.15;WA58;Spezialgewebe, Spitzen, Tapisserien;40487;22389;18098
01.04.15;WA59;Getränkte, bestrichene usw. Gewebe;181654;91657;89997
01.04.15;WA60;Gewirke und Gestricke;74554;44547;30007
01.04.15;WA61;Bekleidung usw. aus Gewirken, Gestricken;479880;1030940;-551060
01.04.15;WA62;Andere Bekleidung, Bekleidungszubehör;539592;1047607;-508015
01.04.15;WA63;Andere Konfektion, Spinnstoffwaren usw.;205199;275376;-70177
01.04.15;WA64;Schuhe, Gamaschen, ähnliche Waren;312035;606257;-294222
01.04.15;WA65;Kopfbedeckungen und Teile davon;26989;30456;-3467
01.04.15;WA66;Schirme, Gehstöcke usw., Peitschen;7957;17766;-9809
01.04.15;WA67;Zugerichtete Federn, Daunen, künstliche Blumen;6571;7977;-1406
01.04.15;WA68;Waren aus Steinen, Gips, Zement usw.;347474;235494;111980
01.04.15;WA69;Keramische Waren;259817;204645;55172
01.04.15;WA70;Glas und Glaswaren;489729;377066;112663
01.04.15;WA71;Perlen, Edelsteine, Edelmetalle;997131;1287266;-290135
01.04.15;WA72;Eisen und Stahl;1896169;1958633;-62464
01.04.15;WA73;Waren aus Eisen oder Stahl;2199683;1506020;693663
01.04.15;WA74;Kupfer und Waren daraus;925902;819131;106771
01.04.15;WA75;Nickel und Waren daraus;100653;130603;-29950
01.04.15;WA76;Aluminium und Waren daraus;1197766;1310382;-112616
01.04.15;WA78;Blei und Waren daraus;28216;25025;3191
01.04.15;WA79;Zink und Waren daraus;52851;112999;-60148
01.04.15;WA80;Zinn und Waren daraus;9140;37826;-28686
01.04.15;WA81;Andere unedle Metalle, Cermets usw.;122057;137413;-15356
01.04.15;WA82;Werkzeuge, Schneidwaren, Essbestecke;645333;354380;290953
01.04.15;WA83;Verschiedene Waren aus unedlen Metallen;579226;339950;239276
01.04.15;WA84;Maschinen, Apparate, mechanische Geräte;16632020;10032596;6599424
01.04.15;WA85;Elektrotechnische Erzeugnisse;9516197;9129965;386232
01.04.15;WA86;Schienenfahrzeuge;233288;193013;40275
01.04.15;WA87;Kraftfahrzeuge, Landfahrzeuge;18514147;7677206;10836941
01.04.15;WA88;Luftfahrzeuge, Raumfahrzeuge;4486141;2127811;2358330
01.04.15;WA89;Wasserfahrzeuge;204350;42500;161850
01.04.15;WA90;Optische, photografische usw. Erzeugnisse;4482169;2741226;1740943
01.04.15;WA91;Uhrmacherwaren;180978;218318;-37340
01.04.15;WA92;Musikinstrumente;46776;42812;3964
01.04.15;WA93;Waffen und Munition;34227;15826;18401
01.04.15;WA94;Möbel, Beleuchtungskörper usw.;1215022;1336850;-121828
01.04.15;WA95;Spielzeug, Spiele usw., Sportgeräte;252847;322613;-69766
01.04.15;WA96;Verschiedene Waren;306053;182804;123249
01.04.15;WA97;Kunstgegenstände, Sammlungsstücke;45823;28520;17303
01.04.15;WA98;Vollständige Fabrikationsanlagen;202903;1750;201153
01.04.15;WA99;Zusammenstellungen verschiedener Waren;1710840;828977;881863
01.04.16;WA01;Lebende Tiere;122441;154375;-31934
01.04.16;WA02;Fleisch;583839;497559;86280
01.04.16;WA03;Fische, Krebs- und Weichtiere;118409;318427;-200018
01.04.16;WA04;Milch, Milcherzeugnisse, Eier, Honig;613877;553736;60141
01.04.16;WA05;Andere Waren tierischen Ursprungs;65246;63494;1752
01.04.16;WA06;Pflanzen, Waren des Blumenhandels;125941;318080;-192139
01.04.16;WA07;Gemüse, Pflanzen für Ernährung;110579;608943;-498364
01.04.16;WA08;Geniessbare Früchte und Nüsse;151996;753608;-601612
01.04.16;WA09;Kaffee, Tee, Mate, Gewürze;219405;349124;-129719
01.04.16;WA10;Getreide;294793;216747;78046
01.04.16;WA11;Müllereierzeugnisse, Malz usw.;121475;41958;79517
01.04.16;WA12;Ölsamen usw., Heilpflanzen usw.;92662;401547;-308885
01.04.16;WA13;Schellack, Gummen, Harz, Pflanzensaft;54918;46307;8611
01.04.16;WA14;Flechtstoffe usw. pflanzlichen Ursprungs;716;2958;-2242
01.04.16;WA15;Tierische und pflanzliche Fette, Öle, Wachs;222677;324786;-102109
01.04.16;WA16;Zubereitungen von Fleisch, Fisch usw.;228063;201840;26223
01.04.16;WA17;Zucker und Zuckerwaren;156865;128712;28153
01.04.16;WA18;Kakao und Zubereitungen aus Kakao;373394;413868;-40474
01.04.16;WA19;Zubereitungen aus Getreide usw., Backwaren;484444;328430;156014
01.04.16;WA20;Zubereitungen von Gemüse, Früchten usw.;227583;390071;-162488
01.04.16;WA21;Verschiedene Lebensmittelzubereitungen;469610;259837;209773
01.04.16;WA22;Getränke, alkoholhaltige Flüssigkeiten, Essig;487481;559314;-71833
01.04.16;WA23;Rückstände der Lebensmittelindustrie, Futter;322896;302669;20227
01.04.16;WA24;Tabak;390113;175254;214859
01.04.16;WA25;Salz, Schwefel, Steine, Erden usw.;182624;157832;24792
01.04.16;WA26;Erze, Schlacken, Aschen;27264;494189;-466925
01.04.16;WA27;Mineralische Brennstoffe usw.;1554412;5273743;-3719331
01.04.16;WA28;Anorganische chemische Erzeugnisse;715068;517924;197144
01.04.16;WA29;Organische chemische Erzeugnisse;1843611;2249522;-405911
01.04.16;WA30;Pharmazeutische Erzeugnisse;5484050;3405834;2078216
01.04.16;WA31;Düngemittel;198316;109261;89055
01.04.16;WA32;Gerb- und Farbstoffe, Farben, Lacke usw.;955134;484054;471080
01.04.16;WA33;Etherische Öle, Riech-, Schönheitsmittel;780914;512101;268813
01.04.16;WA34;Seifen, Waschmittel usw.;592284;292386;299898
01.04.16;WA35;Eiweissstoffe, Klebstoffe, Enzyme;256584;154178;102406
01.04.16;WA36;Sprengstoffe, pyrotechnische Artikel usw.;21985;11790;10195
01.04.16;WA37;Photochemische Erzeugnisse;100415;61499;38916
01.04.16;WA38;Verschiedene Erzeugnisse der Chemischen Industrie;1822806;1085185;737621
01.04.16;WA39;Kunststoffe und Waren daraus;4884896;3082726;1802170
01.04.16;WA40;Kautschuk und Waren daraus;1256495;1203845;52650
01.04.16;WA41;Häute, Felle, Leder;90147;75750;14397
01.04.16;WA42;Lederwaren, Sattlerwaren;157782;292692;-134910
01.04.16;WA43;Pelzfelle, künstliches Pelzwerk;7614;7462;152
01.04.16;WA44;Holz, Holzwaren, Holzkohle;638615;636874;1741
01.04.16;WA45;Kork, Korkwaren;2827;10246;-7419
01.04.16;WA46;Flechtwaren, Korbmacherwaren;5969;10632;-4663
01.04.16;WA47;Halbstoffe aus Holz usw., Papierabfall;99262;296323;-197061
01.04.16;WA48;Papier, Pappe und Waren daraus;1459728;1004819;454909
01.04.16;WA49;Bücher, Zeitungen, Bilddrucke usw.;339139;203575;135564
01.04.16;WA50;Seide;4000;3872;128
01.04.16;WA51;Wolle, feine und grobe Tierhaare;55706;62269;-6563
01.04.16;WA52;Baumwolle;76078;76295;-217
01.04.16;WA53;Andere pflanzliche Spinnstoffe, Papiergarn;3030;6260;-3230
01.04.16;WA54;Synthetisches oder künstliches Filament;160187;129451;30736
01.04.16;WA55;Synthetische oder künstliche Spinnfaser;148209;128242;19967
01.04.16;WA56;Watte, Filz, Vliesstoff usw., Tauwerk;207084;118521;88563
01.04.16;WA57;Teppiche, Fussbodenbelag aus Spinnstoff;47339;91520;-44181
01.04.16;WA58;Spezialgewebe, Spitzen, Tapisserien;43883;22876;21007
01.04.16;WA59;Getränkte, bestrichene usw. Gewebe;201516;96058;105458
01.04.16;WA60;Gewirke und Gestricke;76972;46510;30462
01.04.16;WA61;Bekleidung usw. aus Gewirken, Gestricken;526684;1070751;-544067
01.04.16;WA62;Andere Bekleidung, Bekleidungszubehör;599552;1117934;-518382
01.04.16;WA63;Andere Konfektion, Spinnstoffwaren usw.;220594;302691;-82097
01.04.16;WA64;Schuhe, Gamaschen, ähnliche Waren;380619;676805;-296186
01.04.16;WA65;Kopfbedeckungen und Teile davon;32519;34539;-2020
01.04.16;WA66;Schirme, Gehstöcke usw., Peitschen;13625;17895;-4270
01.04.16;WA67;Zugerichtete Federn, Daunen, künstliche Blumen;7925;10694;-2769
01.04.16;WA68;Waren aus Steinen, Gips, Zement usw.;392117;268392;123725
01.04.16;WA69;Keramische Waren;271559;240772;30787
01.04.16;WA70;Glas und Glaswaren;519525;413323;106202
01.04.16;WA71;Perlen, Edelsteine, Edelmetalle;895761;1147633;-251872
01.04.16;WA72;Eisen und Stahl;1701132;1713059;-11927
01.04.16;WA73;Waren aus Eisen oder Stahl;2241725;1628186;613539
01.04.16;WA74;Kupfer und Waren daraus;802510;712910;89600
01.04.16;WA75;Nickel und Waren daraus;72419;88944;-16525
01.04.16;WA76;Aluminium und Waren daraus;1193914;1281939;-88025
01.04.16;WA78;Blei und Waren daraus;34302;32637;1665
01.04.16;WA79;Zink und Waren daraus;47061;114138;-67077
01.04.16;WA80;Zinn und Waren daraus;7996;30810;-22814
01.04.16;WA81;Andere unedle Metalle, Cermets usw.;106828;135867;-29039
01.04.16;WA82;Werkzeuge, Schneidwaren, Essbestecke;695935;383838;312097
01.04.16;WA83;Verschiedene Waren aus unedlen Metallen;620867;375475;245392
01.04.16;WA84;Maschinen, Apparate, mechanische Geräte;17649992;10517690;7132302
01.04.16;WA85;Elektrotechnische Erzeugnisse;10202419;9470712;731707
01.04.16;WA86;Schienenfahrzeuge;343937;183533;160404
01.04.16;WA87;Kraftfahrzeuge, Landfahrzeuge;20447799;8744819;11702980
01.04.16;WA88;Luftfahrzeuge, Raumfahrzeuge;3747237;1597135;2150102
01.04.16;WA89;Wasserfahrzeuge;433637;435730;-2093
01.04.16;WA90;Optische, photografische usw. Erzeugnisse;4843959;2867236;1976723
01.04.16;WA91;Uhrmacherwaren;149016;163209;-14193
01.04.16;WA92;Musikinstrumente;48691;43937;4754
01.04.16;WA93;Waffen und Munition;43981;24197;19784
01.04.16;WA94;Möbel, Beleuchtungskörper usw.;1328808;1546505;-217697
01.04.16;WA95;Spielzeug, Spiele usw., Sportgeräte;282432;361393;-78961
01.04.16;WA96;Verschiedene Waren;334574;203015;131559
01.04.16;WA97;Kunstgegenstände, Sammlungsstücke;56455;42857;13598
01.04.16;WA98;Vollständige Fabrikationsanlagen;230496;185;230311
01.04.16;WA99;Zusammenstellungen verschiedener Waren;1872342;927332;945010
01.04.17;WA01;Lebende Tiere;116937;187054;-70117
01.04.17;WA02;Fleisch;631579;568109;63470
01.04.17;WA03;Fische, Krebs- und Weichtiere;142782;343244;-200462
01.04.17;WA04;Milch, Milcherzeugnisse, Eier, Honig;779362;670412;108950
01.04.17;WA05;Andere Waren tierischen Ursprungs;67909;73809;-5900
01.04.17;WA06;Pflanzen, Waren des Blumenhandels;118150;344618;-226468
01.04.17;WA07;Gemüse, Pflanzen für Ernährung;111781;653627;-541846
01.04.17;WA08;Geniessbare Früchte und Nüsse;148559;784423;-635864
01.04.17;WA09;Kaffee, Tee, Mate, Gewürze;239069;356752;-117683
01.04.17;WA10;Getreide;228266;193202;35064
01.04.17;WA11;Müllereierzeugnisse, Malz usw.;124307;43268;81039
01.04.17;WA12;Ölsamen usw., Heilpflanzen usw.;97165;425881;-328716
01.04.17;WA13;Schellack, Gummen, Harz, Pflanzensaft;54572;40019;14553
01.04.17;WA14;Flechtstoffe usw. pflanzlichen Ursprungs;643;4137;-3494
01.04.17;WA15;Tierische und pflanzliche Fette, Öle, Wachs;266220;315174;-48954
01.04.17;WA16;Zubereitungen von Fleisch, Fisch usw.;250135;235160;14975
01.04.17;WA17;Zucker und Zuckerwaren;164707;134541;30166
01.04.17;WA18;Kakao und Zubereitungen aus Kakao;343326;309231;34095
01.04.17;WA19;Zubereitungen aus Getreide usw., Backwaren;479663;376590;103073
01.04.17;WA20;Zubereitungen von Gemüse, Früchten usw.;237353;401168;-163815
01.04.17;WA21;Verschiedene Lebensmittelzubereitungen;450710;274647;176063
01.04.17;WA22;Getränke, alkoholhaltige Flüssigkeiten, Essig;463578;573255;-109677
01.04.17;WA23;Rückstände der Lebensmittelindustrie, Futter;326733;288321;38412
01.04.17;WA24;Tabak;352471;138871;213600
01.04.17;WA25;Salz, Schwefel, Steine, Erden usw.;166425;144317;22108
01.04.17;WA26;Erze, Schlacken, Aschen;40488;620440;-579952
01.04.17;WA27;Mineralische Brennstoffe usw.;1783210;6723803;-4940593
01.04.17;WA28;Anorganische chemische Erzeugnisse;717171;486976;230195
01.04.17;WA29;Organische chemische Erzeugnisse;2021758;2391914;-370156
01.04.17;WA30;Pharmazeutische Erzeugnisse;5586216;4034131;1552085
01.04.17;WA31;Düngemittel;178898;105156;73742
01.04.17;WA32;Gerb- und Farbstoffe, Farben, Lacke usw.;944064;498110;445954
01.04.17;WA33;Etherische Öle, Riech-, Schönheitsmittel;716786;554955;161831
01.04.17;WA34;Seifen, Waschmittel usw.;579115;286869;292246
01.04.17;WA35;Eiweissstoffe, Klebstoffe, Enzyme;271140;160698;110442
01.04.17;WA36;Sprengstoffe, pyrotechnische Artikel usw.;17630;13109;4521
01.04.17;WA37;Photochemische Erzeugnisse;95660;58030;37630
01.04.17;WA38;Verschiedene Erzeugnisse der Chemischen Industrie;1814280;1069842;744438
01.04.17;WA39;Kunststoffe und Waren daraus;4871446;3216126;1655320
01.04.17;WA40;Kautschuk und Waren daraus;1285600;1158401;127199
01.04.17;WA41;Häute, Felle, Leder;77551;65865;11686
01.04.17;WA42;Lederwaren, Sattlerwaren;176700;293823;-117123
01.04.17;WA43;Pelzfelle, künstliches Pelzwerk;8409;9297;-888
01.04.17;WA44;Holz, Holzwaren, Holzkohle;622359;659446;-37087
01.04.17;WA45;Kork, Korkwaren;2510;10925;-8415
01.04.17;WA46;Flechtwaren, Korbmacherwaren;4753;9426;-4673
01.04.17;WA47;Halbstoffe aus Holz usw., Papierabfall;91851;302450;-210599
01.04.17;WA48;Papier, Pappe und Waren daraus;1423297;987941;435356
01.04.17;WA49;Bücher, Zeitungen, Bilddrucke usw.;320066;189012;131054
01.04.17;WA50;Seide;3660;3601;59
01.04.17;WA51;Wolle, feine und grobe Tierhaare;47465;62210;-14745
01.04.17;WA52;Baumwolle;73403;81724;-8321
01.04.17;WA53;Andere pflanzliche Spinnstoffe, Papiergarn;2503;5336;-2833
01.04.17;WA54;Synthetisches oder künstliches Filament;154833;131546;23287
01.04.17;WA55;Synthetische oder künstliche Spinnfaser;149736;132881;16855
01.04.17;WA56;Watte, Filz, Vliesstoff usw., Tauwerk;203252;118381;84871
01.04.17;WA57;Teppiche, Fussbodenbelag aus Spinnstoff;42981;92722;-49741
01.04.17;WA58;Spezialgewebe, Spitzen, Tapisserien;43330;22527;20803
01.04.17;WA59;Getränkte, bestrichene usw. Gewebe;204676;93796;110880
01.04.17;WA60;Gewirke und Gestricke;79837;47719;32118
01.04.17;WA61;Bekleidung usw. aus Gewirken, Gestricken;596537;1148888;-552351
01.04.17;WA62;Andere Bekleidung, Bekleidungszubehör;667847;1192922;-525075
01.04.17;WA63;Andere Konfektion, Spinnstoffwaren usw.;191349;300074;-108725
01.04.17;WA64;Schuhe, Gamaschen, ähnliche Waren;463686;770278;-306592
01.04.17;WA65;Kopfbedeckungen und Teile davon;33934;42925;-8991
01.04.17;WA66;Schirme, Gehstöcke usw., Peitschen;8941;21402;-12461
01.04.17;WA67;Zugerichtete Federn, Daunen, künstliche Blumen;8864;10965;-2101
01.04.17;WA68;Waren aus Steinen, Gips, Zement usw.;382182;254527;127655
01.04.17;WA69;Keramische Waren;263431;235000;28431
01.04.17;WA70;Glas und Glaswaren;504624;409238;95386
01.04.17;WA71;Perlen, Edelsteine, Edelmetalle;1018178;1160251;-142073
01.04.17;WA72;Eisen und Stahl;1933502;2040681;-107179
01.04.17;WA73;Waren aus Eisen oder Stahl;2363673;1622510;741163
01.04.17;WA74;Kupfer und Waren daraus;924941;817598;107343
01.04.17;WA75;Nickel und Waren daraus;79078;106884;-27806
01.04.17;WA76;Aluminium und Waren daraus;1188208;1333746;-145538
01.04.17;WA78;Blei und Waren daraus;37930;45580;-7650
01.04.17;WA79;Zink und Waren daraus;64750;141189;-76439
01.04.17;WA80;Zinn und Waren daraus;8764;40370;-31606
01.04.17;WA81;Andere unedle Metalle, Cermets usw.;123387;159003;-35616
01.04.17;WA82;Werkzeuge, Schneidwaren, Essbestecke;664688;409870;254818
01.04.17;WA83;Verschiedene Waren aus unedlen Metallen;572536;353246;219290
01.04.17;WA84;Maschinen, Apparate, mechanische Geräte;17223388;10528580;6694808
01.04.17;WA85;Elektrotechnische Erzeugnisse;10296975;10052934;244041
01.04.17;WA86;Schienenfahrzeuge;345550;182678;162872
01.04.17;WA87;Kraftfahrzeuge, Landfahrzeuge;17678482;9070114;8608368
01.04.17;WA88;Luftfahrzeuge, Raumfahrzeuge;2657725;1107529;1550196
01.04.17;WA89;Wasserfahrzeuge;247809;438178;-190369
01.04.17;WA90;Optische, photografische usw. Erzeugnisse;4794730;2784891;2009839
01.04.17;WA91;Uhrmacherwaren;126245;157524;-31279
01.04.17;WA92;Musikinstrumente;45531;42115;3416
01.04.17;WA93;Waffen und Munition;44940;18457;26483
01.04.17;WA94;Möbel, Beleuchtungskörper usw.;1183869;1504933;-321064
01.04.17;WA95;Spielzeug, Spiele usw., Sportgeräte;291565;436145;-144580
01.04.17;WA96;Verschiedene Waren;329551;228003;101548
01.04.17;WA97;Kunstgegenstände, Sammlungsstücke;57252;44341;12911
01.04.17;WA98;Vollständige Fabrikationsanlagen;184422;NULL;#WERT!
01.04.17;WA99;Zusammenstellungen verschiedener Waren;2129166;991778;1137388
01.04.18;WA01;Lebende Tiere;121304;152459;-31155
01.04.18;WA02;Fleisch;591520;597454;-5934
01.04.18;WA03;Fische, Krebs- und Weichtiere;129180;302212;-173032
01.04.18;WA04;Milch, Milcherzeugnisse, Eier, Honig;729098;655893;73205
01.04.18;WA05;Andere Waren tierischen Ursprungs;73867;79391;-5524
01.04.18;WA06;Pflanzen, Waren des Blumenhandels;135672;340818;-205146
01.04.18;WA07;Gemüse, Pflanzen für Ernährung;92801;622653;-529852
01.04.18;WA08;Geniessbare Früchte und Nüsse;159729;841645;-681916
01.04.18;WA09;Kaffee, Tee, Mate, Gewürze;220360;345504;-125144
01.04.18;WA10;Getreide;149788;178062;-28274
01.04.18;WA11;Müllereierzeugnisse, Malz usw.;131835;50533;81302
01.04.18;WA12;Ölsamen usw., Heilpflanzen usw.;95712;374940;-279228
01.04.18;WA13;Schellack, Gummen, Harz, Pflanzensaft;59738;48858;10880
01.04.18;WA14;Flechtstoffe usw. pflanzlichen Ursprungs;853;3180;-2327
01.04.18;WA15;Tierische und pflanzliche Fette, Öle, Wachs;200340;293923;-93583
01.04.18;WA16;Zubereitungen von Fleisch, Fisch usw.;256132;230608;25524
01.04.18;WA17;Zucker und Zuckerwaren;174850;134575;40275
01.04.18;WA18;Kakao und Zubereitungen aus Kakao;349475;336135;13340
01.04.18;WA19;Zubereitungen aus Getreide usw., Backwaren;504102;354346;149756
01.04.18;WA20;Zubereitungen von Gemüse, Früchten usw.;261602;433331;-171729
01.04.18;WA21;Verschiedene Lebensmittelzubereitungen;484162;301834;182328
01.04.18;WA22;Getränke, alkoholhaltige Flüssigkeiten, Essig;491141;609428;-118287
01.04.18;WA23;Rückstände der Lebensmittelindustrie, Futter;331953;322434;9519
01.04.18;WA24;Tabak;252832;193409;59423
01.04.18;WA25;Salz, Schwefel, Steine, Erden usw.;171270;159173;12097
01.04.18;WA26;Erze, Schlacken, Aschen;46778;667825;-621047
01.04.18;WA27;Mineralische Brennstoffe usw.;2025219;7396299;-5371080
01.04.18;WA28;Anorganische chemische Erzeugnisse;772392;605806;166586
01.04.18;WA29;Organische chemische Erzeugnisse;2044028;3131025;-1086997
01.04.18;WA30;Pharmazeutische Erzeugnisse;6645892;4022841;2623051
01.04.18;WA31;Düngemittel;192351;68396;123955
01.04.18;WA32;Gerb- und Farbstoffe, Farben, Lacke usw.;982809;563877;418932
01.04.18;WA33;Etherische Öle, Riech-, Schönheitsmittel;790982;578643;212339
01.04.18;WA34;Seifen, Waschmittel usw.;642020;341580;300440
01.04.18;WA35;Eiweissstoffe, Klebstoffe, Enzyme;290497;173269;117228
01.04.18;WA36;Sprengstoffe, pyrotechnische Artikel usw.;22501;11330;11171
01.04.18;WA37;Photochemische Erzeugnisse;108877;91851;17026
01.04.18;WA38;Verschiedene Erzeugnisse der Chemischen Industrie;1941905;1167712;774193
01.04.18;WA39;Kunststoffe und Waren daraus;5245657;3507166;1738491
01.04.18;WA40;Kautschuk und Waren daraus;1317526;1255074;62452
01.04.18;WA41;Häute, Felle, Leder;85171;70177;14994
01.04.18;WA42;Lederwaren, Sattlerwaren;184670;313298;-128628
01.04.18;WA43;Pelzfelle, künstliches Pelzwerk;10919;11684;-765
01.04.18;WA44;Holz, Holzwaren, Holzkohle;705438;686549;18889
01.04.18;WA45;Kork, Korkwaren;3274;9924;-6650
01.04.18;WA46;Flechtwaren, Korbmacherwaren;3865;9891;-6026
01.04.18;WA47;Halbstoffe aus Holz usw., Papierabfall;93165;338826;-245661
01.04.18;WA48;Papier, Pappe und Waren daraus;1554636;1060861;493775
01.04.18;WA49;Bücher, Zeitungen, Bilddrucke usw.;345430;204869;140561
01.04.18;WA50;Seide;2805;4270;-1465
01.04.18;WA51;Wolle, feine und grobe Tierhaare;47849;66390;-18541
01.04.18;WA52;Baumwolle;70603;80912;-10309
01.04.18;WA53;Andere pflanzliche Spinnstoffe, Papiergarn;2860;4915;-2055
01.04.18;WA54;Synthetisches oder künstliches Filament;158719;136235;22484
01.04.18;WA55;Synthetische oder künstliche Spinnfaser;151889;136039;15850
01.04.18;WA56;Watte, Filz, Vliesstoff usw., Tauwerk;209571;129521;80050
01.04.18;WA57;Teppiche, Fussbodenbelag aus Spinnstoff;47102;83487;-36385
01.04.18;WA58;Spezialgewebe, Spitzen, Tapisserien;45169;22371;22798
01.04.18;WA59;Getränkte, bestrichene usw. Gewebe;223845;100406;123439
01.04.18;WA60;Gewirke und Gestricke;72402;44604;27798
01.04.18;WA61;Bekleidung usw. aus Gewirken, Gestricken;697899;1263409;-565510
01.04.18;WA62;Andere Bekleidung, Bekleidungszubehör;825598;1277501;-451903
01.04.18;WA63;Andere Konfektion, Spinnstoffwaren usw.;216392;316684;-100292
01.04.18;WA64;Schuhe, Gamaschen, ähnliche Waren;514927;871602;-356675
01.04.18;WA65;Kopfbedeckungen und Teile davon;39370;40716;-1346
01.04.18;WA66;Schirme, Gehstöcke usw., Peitschen;9720;20167;-10447
01.04.18;WA67;Zugerichtete Federn, Daunen, künstliche Blumen;10127;11349;-1222
01.04.18;WA68;Waren aus Steinen, Gips, Zement usw.;424860;292838;132022
01.04.18;WA69;Keramische Waren;283995;234546;49449
01.04.18;WA70;Glas und Glaswaren;582570;459683;122887
01.04.18;WA71;Perlen, Edelsteine, Edelmetalle;916241;1214104;-297863
01.04.18;WA72;Eisen und Stahl;2126899;2477183;-350284
01.04.18;WA73;Waren aus Eisen oder Stahl;2419215;1817743;601472
01.04.18;WA74;Kupfer und Waren daraus;931387;1024882;-93495
01.04.18;WA75;Nickel und Waren daraus;111689;128701;-17012
01.04.18;WA76;Aluminium und Waren daraus;1260249;1377047;-116798
01.04.18;WA78;Blei und Waren daraus;34320;55791;-21471
01.04.18;WA79;Zink und Waren daraus;61338;150308;-88970
01.04.18;WA80;Zinn und Waren daraus;10875;39745;-28870
01.04.18;WA81;Andere unedle Metalle, Cermets usw.;126564;178465;-51901
01.04.18;WA82;Werkzeuge, Schneidwaren, Essbestecke;724677;432539;292138
01.04.18;WA83;Verschiedene Waren aus unedlen Metallen;625747;391125;234622
01.04.18;WA84;Maschinen, Apparate, mechanische Geräte;19230110;11608857;7621253
01.04.18;WA85;Elektrotechnische Erzeugnisse;11188135;10874658;313477
01.04.18;WA86;Schienenfahrzeuge;395143;223893;171250
01.04.18;WA87;Kraftfahrzeuge, Landfahrzeuge;20302017;9937609;10364408
01.04.18;WA88;Luftfahrzeuge, Raumfahrzeuge;3092538;1318404;1774134
01.04.18;WA89;Wasserfahrzeuge;764224;216511;547713
01.04.18;WA90;Optische, photografische usw. Erzeugnisse;5371724;3051563;2320161
01.04.18;WA91;Uhrmacherwaren;125774;152146;-26372
01.04.18;WA92;Musikinstrumente;51690;53038;-1348
01.04.18;WA93;Waffen und Munition;41936;20884;21052
01.04.18;WA94;Möbel, Beleuchtungskörper usw.;1299211;1515442;-216231
01.04.18;WA95;Spielzeug, Spiele usw., Sportgeräte;360368;479447;-119079
01.04.18;WA96;Verschiedene Waren;346300;231221;115079
01.04.18;WA97;Kunstgegenstände, Sammlungsstücke;96023;43770;52253
01.04.18;WA98;Vollständige Fabrikationsanlagen;135358;102;135256
01.04.18;WA99;Zusammenstellungen verschiedener Waren;1330105;1003008;327097
01.04.19;WA01;Lebende Tiere;117747;157373;-39626
01.04.19;WA02;Fleisch;627404;577755;49649
01.04.19;WA03;Fische, Krebs- und Weichtiere;130321;347992;-217671
01.04.19;WA04;Milch, Milcherzeugnisse, Eier, Honig;752063;671746;80317
01.04.19;WA05;Andere Waren tierischen Ursprungs;78182;78371;-189
01.04.19;WA06;Pflanzen, Waren des Blumenhandels;134230;374119;-239889
01.04.19;WA07;Gemüse, Pflanzen für Ernährung;96830;645362;-548532
01.04.19;WA08;Geniessbare Früchte und Nüsse;160170;874014;-713844
01.04.19;WA09;Kaffee, Tee, Mate, Gewürze;222934;316671;-93737
01.04.19;WA10;Getreide;192066;220645;-28579
01.04.19;WA11;Müllereierzeugnisse, Malz usw.;142653;56694;85959
01.04.19;WA12;Ölsamen usw., Heilpflanzen usw.;85063;417042;-331979
01.04.19;WA13;Schellack, Gummen, Harz, Pflanzensaft;65477;56075;9402
01.04.19;WA14;Flechtstoffe usw. pflanzlichen Ursprungs;908;4358;-3450
01.04.19;WA15;Tierische und pflanzliche Fette, Öle, Wachs;194957;301063;-106106
01.04.19;WA16;Zubereitungen von Fleisch, Fisch usw.;267200;255516;11684
01.04.19;WA17;Zucker und Zuckerwaren;172990;131799;41191
01.04.19;WA18;Kakao und Zubereitungen aus Kakao;375637;344735;30902
01.04.19;WA19;Zubereitungen aus Getreide usw., Backwaren;535938;355854;180084
01.04.19;WA20;Zubereitungen von Gemüse, Früchten usw.;251124;405082;-153958
01.04.19;WA21;Verschiedene Lebensmittelzubereitungen;527611;307591;220020
01.04.19;WA22;Getränke, alkoholhaltige Flüssigkeiten, Essig;500941;621913;-120972
01.04.19;WA23;Rückstände der Lebensmittelindustrie, Futter;340175;307550;32625
01.04.19;WA24;Tabak;281635;249475;32160
01.04.19;WA25;Salz, Schwefel, Steine, Erden usw.;173173;159483;13690
01.04.19;WA26;Erze, Schlacken, Aschen;38116;680854;-642738
01.04.19;WA27;Mineralische Brennstoffe usw.;2534116;8229727;-5695611
01.04.19;WA28;Anorganische chemische Erzeugnisse;850676;612828;237848
01.04.19;WA29;Organische chemische Erzeugnisse;2069326;3470417;-1401091
01.04.19;WA30;Pharmazeutische Erzeugnisse;6317318;3890892;2426426
01.04.19;WA31;Düngemittel;191126;90908;100218
01.04.19;WA32;Gerb- und Farbstoffe, Farben, Lacke usw.;987333;489909;497424
01.04.19;WA33;Etherische Öle, Riech-, Schönheitsmittel;855582;605186;250396
01.04.19;WA34;Seifen, Waschmittel usw.;634826;352002;282824
01.04.19;WA35;Eiweissstoffe, Klebstoffe, Enzyme;273450;183638;89812
01.04.19;WA36;Sprengstoffe, pyrotechnische Artikel usw.;23394;11850;11544
01.04.19;WA37;Photochemische Erzeugnisse;105163;66909;38254
01.04.19;WA38;Verschiedene Erzeugnisse der Chemischen Industrie;1945322;1257617;687705
01.04.19;WA39;Kunststoffe und Waren daraus;5126793;3429750;1697043
01.04.19;WA40;Kautschuk und Waren daraus;1251039;1193258;57781
01.04.19;WA41;Häute, Felle, Leder;62847;58999;3848
01.04.19;WA42;Lederwaren, Sattlerwaren;187619;305330;-117711
01.04.19;WA43;Pelzfelle, künstliches Pelzwerk;5431;6149;-718
01.04.19;WA44;Holz, Holzwaren, Holzkohle;741782;686718;55064
01.04.19;WA45;Kork, Korkwaren;2554;9291;-6737
01.04.19;WA46;Flechtwaren, Korbmacherwaren;4369;9628;-5259
01.04.19;WA47;Halbstoffe aus Holz usw., Papierabfall;111028;309400;-198372
01.04.19;WA48;Papier, Pappe und Waren daraus;1484874;984610;500264
01.04.19;WA49;Bücher, Zeitungen, Bilddrucke usw.;325375;214697;110678
01.04.19;WA50;Seide;2012;2439;-427
01.04.19;WA51;Wolle, feine und grobe Tierhaare;43548;53569;-10021
01.04.19;WA52;Baumwolle;63104;68870;-5766
01.04.19;WA53;Andere pflanzliche Spinnstoffe, Papiergarn;2968;5383;-2415
01.04.19;WA54;Synthetisches oder künstliches Filament;153947;135623;18324
01.04.19;WA55;Synthetische oder künstliche Spinnfaser;142115;129982;12133
01.04.19;WA56;Watte, Filz, Vliesstoff usw., Tauwerk;210347;128419;81928
01.04.19;WA57;Teppiche, Fussbodenbelag aus Spinnstoff;42983;80084;-37101
01.04.19;WA58;Spezialgewebe, Spitzen, Tapisserien;46856;22664;24192
01.04.19;WA59;Getränkte, bestrichene usw. Gewebe;200450;93753;106697
01.04.19;WA60;Gewirke und Gestricke;66084;42191;23893
01.04.19;WA61;Bekleidung usw. aus Gewirken, Gestricken;725030;1250026;-524996
01.04.19;WA62;Andere Bekleidung, Bekleidungszubehör;892084;1324230;-432146
01.04.19;WA63;Andere Konfektion, Spinnstoffwaren usw.;223167;325533;-102366
01.04.19;WA64;Schuhe, Gamaschen, ähnliche Waren;571061;824314;-253253
01.04.19;WA65;Kopfbedeckungen und Teile davon;39097;52219;-13122
01.04.19;WA66;Schirme, Gehstöcke usw., Peitschen;9124;27596;-18472
01.04.19;WA67;Zugerichtete Federn, Daunen, künstliche Blumen;10794;12490;-1696
01.04.19;WA68;Waren aus Steinen, Gips, Zement usw.;407150;302503;104647
01.04.19;WA69;Keramische Waren;316312;236313;79999
01.04.19;WA70;Glas und Glaswaren;560664;450379;110285
01.04.19;WA71;Perlen, Edelsteine, Edelmetalle;1187382;1314950;-127568
01.04.19;WA72;Eisen und Stahl;1966880;2170310;-203430
01.04.19;WA73;Waren aus Eisen oder Stahl;2426252;1834593;591659
01.04.19;WA74;Kupfer und Waren daraus;912179;822024;90155
01.04.19;WA75;Nickel und Waren daraus;121384;140119;-18735
01.04.19;WA76;Aluminium und Waren daraus;1346732;1316126;30606
01.04.19;WA78;Blei und Waren daraus;35402;38684;-3282
01.04.19;WA79;Zink und Waren daraus;78445;131483;-53038
01.04.19;WA80;Zinn und Waren daraus;9950;37663;-27713
01.04.19;WA81;Andere unedle Metalle, Cermets usw.;133153;169227;-36074
01.04.19;WA82;Werkzeuge, Schneidwaren, Essbestecke;734347;456351;277996
01.04.19;WA83;Verschiedene Waren aus unedlen Metallen;620345;383424;236921
01.04.19;WA84;Maschinen, Apparate, mechanische Geräte;19437389;12327022;7110367
01.04.19;WA85;Elektrotechnische Erzeugnisse;11469860;11229619;240241
01.04.19;WA86;Schienenfahrzeuge;265857;251565;14292
01.04.19;WA87;Kraftfahrzeuge, Landfahrzeuge;18948094;10584109;8363985
01.04.19;WA88;Luftfahrzeuge, Raumfahrzeuge;3459481;1010048;2449433
01.04.19;WA89;Wasserfahrzeuge;143899;97684;46215
01.04.19;WA90;Optische, photografische usw. Erzeugnisse;5606487;3232551;2373936
01.04.19;WA91;Uhrmacherwaren;133290;158330;-25040
01.04.19;WA92;Musikinstrumente;56562;51845;4717
01.04.19;WA93;Waffen und Munition;37805;22832;14973
01.04.19;WA94;Möbel, Beleuchtungskörper usw.;1285827;1556887;-271060
01.04.19;WA95;Spielzeug, Spiele usw., Sportgeräte;333857;470097;-136240
01.04.19;WA96;Verschiedene Waren;328847;221456;107391
01.04.19;WA97;Kunstgegenstände, Sammlungsstücke;110415;32003;78412
01.04.19;WA98;Vollständige Fabrikationsanlagen;157109;683;156426
01.04.19;WA99;Zusammenstellungen verschiedener Waren;1342411;1120160;222251
01.04.20;WA01;Lebende Tiere;89475;159807;-70332
01.04.20;WA02;Fleisch;608492;512751;95741
01.04.20;WA03;Fische, Krebs- und Weichtiere;91997;257880;-165883
01.04.20;WA04;Milch, Milcherzeugnisse, Eier, Honig;713260;629553;83707
01.04.20;WA05;Andere Waren tierischen Ursprungs;74162;61715;12447
01.04.20;WA06;Pflanzen, Waren des Blumenhandels;117595;354710;-237115
01.04.20;WA07;Gemüse, Pflanzen für Ernährung;103974;718191;-614217
01.04.20;WA08;Geniessbare Früchte und Nüsse;164220;996276;-832056
01.04.20;WA09;Kaffee, Tee, Mate, Gewürze;228738;377330;-148592
01.04.20;WA10;Getreide;289736;266178;23558
01.04.20;WA11;Müllereierzeugnisse, Malz usw.;141121;58515;82606
01.04.20;WA12;Ölsamen usw., Heilpflanzen usw.;105788;414303;-308515
01.04.20;WA13;Schellack, Gummen, Harz, Pflanzensaft;61125;55894;5231
01.04.20;WA14;Flechtstoffe usw. pflanzlichen Ursprungs;782;3362;-2580
01.04.20;WA15;Tierische und pflanzliche Fette, Öle, Wachs;219849;296847;-76998
01.04.20;WA16;Zubereitungen von Fleisch, Fisch usw.;244210;247377;-3167
01.04.20;WA17;Zucker und Zuckerwaren;172722;126370;46352
01.04.20;WA18;Kakao und Zubereitungen aus Kakao;325419;318405;7014
01.04.20;WA19;Zubereitungen aus Getreide usw., Backwaren;540120;353605;186515
01.04.20;WA20;Zubereitungen von Gemüse, Früchten usw.;228647;471772;-243125
01.04.20;WA21;Verschiedene Lebensmittelzubereitungen;499394;310615;188779
01.04.20;WA22;Getränke, alkoholhaltige Flüssigkeiten, Essig;395800;529306;-133506
01.04.20;WA23;Rückstände der Lebensmittelindustrie, Futter;396483;320912;75571
01.04.20;WA24;Tabak;188670;225090;-36420
01.04.20;WA25;Salz, Schwefel, Steine, Erden usw.;139550;148738;-9188
01.04.20;WA26;Erze, Schlacken, Aschen;28785;580796;-552011
01.04.20;WA27;Mineralische Brennstoffe usw.;1367426;4200509;-2833083
01.04.20;WA28;Anorganische chemische Erzeugnisse;784859;463443;321416
01.04.20;WA29;Organische chemische Erzeugnisse;2007850;2859459;-851609
01.04.20;WA30;Pharmazeutische Erzeugnisse;7010543;4744820;2265723
01.04.20;WA31;Düngemittel;191320;107800;83520
01.04.20;WA32;Gerb- und Farbstoffe, Farben, Lacke usw.;785588;450218;335370
01.04.20;WA33;Etherische Öle, Riech-, Schönheitsmittel;666058;450059;215999
01.04.20;WA34;Seifen, Waschmittel usw.;615547;328639;286908
01.04.20;WA35;Eiweissstoffe, Klebstoffe, Enzyme;298697;190352;108345
01.04.20;WA36;Sprengstoffe, pyrotechnische Artikel usw.;10955;10245;710
01.04.20;WA37;Photochemische Erzeugnisse;75851;50932;24919
01.04.20;WA38;Verschiedene Erzeugnisse der Chemischen Industrie;1826791;1160079;666712
01.04.20;WA39;Kunststoffe und Waren daraus;4220929;2966566;1254363
01.04.20;WA40;Kautschuk und Waren daraus;773924;757364;16560
01.04.20;WA41;Häute, Felle, Leder;27766;26876;890
01.04.20;WA42;Lederwaren, Sattlerwaren;107412;189061;-81649
01.04.20;WA43;Pelzfelle, künstliches Pelzwerk;1309;2982;-1673
01.04.20;WA44;Holz, Holzwaren, Holzkohle;604773;596165;8608
01.04.20;WA45;Kork, Korkwaren;1919;8434;-6515
01.04.20;WA46;Flechtwaren, Korbmacherwaren;3248;10559;-7311
01.04.20;WA47;Halbstoffe aus Holz usw., Papierabfall;73031;251842;-178811
01.04.20;WA48;Papier, Pappe und Waren daraus;1334883;926887;407996
01.04.20;WA49;Bücher, Zeitungen, Bilddrucke usw.;249396;160445;88951
01.04.20;WA50;Seide;703;2487;-1784
01.04.20;WA51;Wolle, feine und grobe Tierhaare;15608;20106;-4498
01.04.20;WA52;Baumwolle;40906;55895;-14989
01.04.20;WA53;Andere pflanzliche Spinnstoffe, Papiergarn;1445;4631;-3186
01.04.20;WA54;Synthetisches oder künstliches Filament;91211;98614;-7403
01.04.20;WA55;Synthetische oder künstliche Spinnfaser;113502;93276;20226
01.04.20;WA56;Watte, Filz, Vliesstoff usw., Tauwerk;183528;125029;58499
01.04.20;WA57;Teppiche, Fussbodenbelag aus Spinnstoff;22138;60045;-37907
01.04.20;WA58;Spezialgewebe, Spitzen, Tapisserien;26908;15456;11452
01.04.20;WA59;Getränkte, bestrichene usw. Gewebe;139990;76595;63395
01.04.20;WA60;Gewirke und Gestricke;43008;32935;10073
01.04.20;WA61;Bekleidung usw. aus Gewirken, Gestricken;495362;908592;-413230
01.04.20;WA62;Andere Bekleidung, Bekleidungszubehör;518787;892572;-373785
01.04.20;WA63;Andere Konfektion, Spinnstoffwaren usw.;264447;1794175;-1529728
01.04.20;WA64;Schuhe, Gamaschen, ähnliche Waren;356334;577970;-221636
01.04.20;WA65;Kopfbedeckungen und Teile davon;28002;41403;-13401
01.04.20;WA66;Schirme, Gehstöcke usw., Peitschen;6280;27670;-21390
01.04.20;WA67;Zugerichtete Federn, Daunen, künstliche Blumen;6058;9826;-3768
01.04.20;WA68;Waren aus Steinen, Gips, Zement usw.;340027;248312;91715
01.04.20;WA69;Keramische Waren;197432;201774;-4342
01.04.20;WA70;Glas und Glaswaren;395680;271089;124591
01.04.20;WA71;Perlen, Edelsteine, Edelmetalle;1424552;2381562;-957010
01.04.20;WA72;Eisen und Stahl;1303625;1387477;-83852
01.04.20;WA73;Waren aus Eisen oder Stahl;1709486;1433575;275911
01.04.20;WA74;Kupfer und Waren daraus;719627;617459;102168
01.04.20;WA75;Nickel und Waren daraus;120891;122447;-1556
01.04.20;WA76;Aluminium und Waren daraus;891638;928224;-36586
01.04.20;WA78;Blei und Waren daraus;32679;23640;9039
01.04.20;WA79;Zink und Waren daraus;43216;96875;-53659
01.04.20;WA80;Zinn und Waren daraus;5717;25281;-19564
01.04.20;WA81;Andere unedle Metalle, Cermets usw.;98742;133297;-34555
01.04.20;WA82;Werkzeuge, Schneidwaren, Essbestecke;526771;349080;177691
01.04.20;WA83;Verschiedene Waren aus unedlen Metallen;422867;274748;148119
01.04.20;WA84;Maschinen, Apparate, mechanische Geräte;13737827;9602981;4134846
01.04.20;WA85;Elektrotechnische Erzeugnisse;8814626;8446940;367686
01.04.20;WA86;Schienenfahrzeuge;229061;271814;-42753
01.04.20;WA87;Kraftfahrzeuge, Landfahrzeuge;4852528;3870623;981905
01.04.20;WA88;Luftfahrzeuge, Raumfahrzeuge;856372;1651364;-794992
01.04.20;WA89;Wasserfahrzeuge;234998;67449;167549
01.04.20;WA90;Optische, photografische usw. Erzeugnisse;4470996;2530988;1940008
01.04.20;WA91;Uhrmacherwaren;60708;59930;778
01.04.20;WA92;Musikinstrumente;43008;47043;-4035
01.04.20;WA93;Waffen und Munition;28370;19020;9350
01.04.20;WA94;Möbel, Beleuchtungskörper usw.;837496;1053007;-215511
01.04.20;WA95;Spielzeug, Spiele usw., Sportgeräte;372687;512125;-139438
01.04.20;WA96;Verschiedene Waren;282026;205039;76987
01.04.20;WA97;Kunstgegenstände, Sammlungsstücke;27485;26313;1172
01.04.20;WA98;Vollständige Fabrikationsanlagen;98425;NULL;#WERT!
01.04.20;WA99;Zusammenstellungen verschiedener Waren;1175734;846036;329698
01.04.21;WA01;Lebende Tiere;90800;118275;-27475
01.04.21;WA02;Fleisch;492904;454916;37988
01.04.21;WA03;Fische, Krebs- und Weichtiere;94016;258917;-164901
01.04.21;WA04;Milch, Milcherzeugnisse, Eier, Honig;775538;681297;94241
01.04.21;WA05;Andere Waren tierischen Ursprungs;75892;74454;1438
01.04.21;WA06;Pflanzen, Waren des Blumenhandels;132406;426660;-294254
01.04.21;WA07;Gemüse, Pflanzen für Ernährung;99075;733523;-634448
01.04.21;WA08;Geniessbare Früchte und Nüsse;164861;954429;-789568
01.04.21;WA09;Kaffee, Tee, Mate, Gewürze;239622;366361;-126739
01.04.21;WA10;Getreide;221697;241873;-20176
01.04.21;WA11;Müllereierzeugnisse, Malz usw.;138650;58773;79877
01.04.21;WA12;Ölsamen usw., Heilpflanzen usw.;113285;477869;-364584
01.04.21;WA13;Schellack, Gummen, Harz, Pflanzensaft;58697;51580;7117
01.04.21;WA14;Flechtstoffe usw. pflanzlichen Ursprungs;1121;3349;-2228
01.04.21;WA15;Tierische und pflanzliche Fette, Öle, Wachs;303787;346064;-42277
01.04.21;WA16;Zubereitungen von Fleisch, Fisch usw.;228189;219953;8236
01.04.21;WA17;Zucker und Zuckerwaren;211768;129384;82384
01.04.21;WA18;Kakao und Zubereitungen aus Kakao;344370;307219;37151
01.04.21;WA19;Zubereitungen aus Getreide usw., Backwaren;523813;351119;172694
01.04.21;WA20;Zubereitungen von Gemüse, Früchten usw.;245394;408896;-163502
01.04.21;WA21;Verschiedene Lebensmittelzubereitungen;556497;349234;207263
01.04.21;WA22;Getränke, alkoholhaltige Flüssigkeiten, Essig;469292;631680;-162388
01.04.21;WA23;Rückstände der Lebensmittelindustrie, Futter;445894;339435;106459
01.04.21;WA24;Tabak;210996;253514;-42518
01.04.21;WA25;Salz, Schwefel, Steine, Erden usw.;167413;146710;20703
01.04.21;WA26;Erze, Schlacken, Aschen;89285;1002626;-913341
01.04.21;WA27;Mineralische Brennstoffe usw.;1760096;6464323;-4704227
01.04.21;WA28;Anorganische chemische Erzeugnisse;1230556;485324;745232
01.04.21;WA29;Organische chemische Erzeugnisse;2322946;2480691;-157745
01.04.21;WA30;Pharmazeutische Erzeugnisse;8130697;6033055;2097642
01.04.21;WA31;Düngemittel;186911;85292;101619
01.04.21;WA32;Gerb- und Farbstoffe, Farben, Lacke usw.;1018086;494163;523923
01.04.21;WA33;Etherische Öle, Riech-, Schönheitsmittel;778490;510606;267884
01.04.21;WA34;Seifen, Waschmittel usw.;667467;361797;305670
01.04.21;WA35;Eiweissstoffe, Klebstoffe, Enzyme;326363;203196;123167
01.04.21;WA36;Sprengstoffe, pyrotechnische Artikel usw.;22154;11405;10749
01.04.21;WA37;Photochemische Erzeugnisse;86408;53033;33375
01.04.21;WA38;Verschiedene Erzeugnisse der Chemischen Industrie;2319619;1864886;454733
01.04.21;WA39;Kunststoffe und Waren daraus;5695570;3791028;1904542
01.04.21;WA40;Kautschuk und Waren daraus;1270977;1361933;-90956
01.04.21;WA41;Häute, Felle, Leder;49756;40128;9628
01.04.21;WA42;Lederwaren, Sattlerwaren;184944;269235;-84291
01.04.21;WA43;Pelzfelle, künstliches Pelzwerk;2798;4040;-1242
01.04.21;WA44;Holz, Holzwaren, Holzkohle;914162;760465;153697
01.04.21;WA45;Kork, Korkwaren;2256;7818;-5562
01.04.21;WA46;Flechtwaren, Korbmacherwaren;5968;13396;-7428
01.04.21;WA47;Halbstoffe aus Holz usw., Papierabfall;91234;304277;-213043
01.04.21;WA48;Papier, Pappe und Waren daraus;1464993;881556;583437
01.04.21;WA49;Bücher, Zeitungen, Bilddrucke usw.;296179;235261;60918
01.04.21;WA50;Seide;1599;2091;-492
01.04.21;WA51;Wolle, feine und grobe Tierhaare;37199;37670;-471
01.04.21;WA52;Baumwolle;48037;53184;-5147
01.04.21;WA53;Andere pflanzliche Spinnstoffe, Papiergarn;3174;6847;-3673
01.04.21;WA54;Synthetisches oder künstliches Filament;114630;104235;10395
01.04.21;WA55;Synthetische oder künstliche Spinnfaser;135679;101398;34281
01.04.21;WA56;Watte, Filz, Vliesstoff usw., Tauwerk;216920;137548;79372
01.04.21;WA57;Teppiche, Fussbodenbelag aus Spinnstoff;45948;94353;-48405
01.04.21;WA58;Spezialgewebe, Spitzen, Tapisserien;38551;18267;20284
01.04.21;WA59;Getränkte, bestrichene usw. Gewebe;201217;93605;107612
01.04.21;WA60;Gewirke und Gestricke;58385;36194;22191
01.04.21;WA61;Bekleidung usw. aus Gewirken, Gestricken;801494;1384402;-582908
01.04.21;WA62;Andere Bekleidung, Bekleidungszubehör;809762;1250036;-440274
01.04.21;WA63;Andere Konfektion, Spinnstoffwaren usw.;282856;434434;-151578
01.04.21;WA64;Schuhe, Gamaschen, ähnliche Waren;604192;841848;-237656
01.04.21;WA65;Kopfbedeckungen und Teile davon;47418;60915;-13497
01.04.21;WA66;Schirme, Gehstöcke usw., Peitschen;11008;32442;-21434
01.04.21;WA67;Zugerichtete Federn, Daunen, künstliche Blumen;10080;12776;-2696
01.04.21;WA68;Waren aus Steinen, Gips, Zement usw.;435788;280082;155706
01.04.21;WA69;Keramische Waren;322317;275248;47069
01.04.21;WA70;Glas und Glaswaren;547540;409749;137791
01.04.21;WA71;Perlen, Edelsteine, Edelmetalle;2092690;3582060;-1489370
01.04.21;WA72;Eisen und Stahl;2266691;2152157;114534
01.04.21;WA73;Waren aus Eisen oder Stahl;2318865;1882106;436759
01.04.21;WA74;Kupfer und Waren daraus;1202764;1068293;134471
01.04.21;WA75;Nickel und Waren daraus;123039;154413;-31374
01.04.21;WA76;Aluminium und Waren daraus;1312869;1359908;-47039
01.04.21;WA78;Blei und Waren daraus;50761;32508;18253
01.04.21;WA79;Zink und Waren daraus;62663;110747;-48084
01.04.21;WA80;Zinn und Waren daraus;10997;45910;-34913
01.04.21;WA81;Andere unedle Metalle, Cermets usw.;102370;122340;-19970
01.04.21;WA82;Werkzeuge, Schneidwaren, Essbestecke;747515;449204;298311
01.04.21;WA83;Verschiedene Waren aus unedlen Metallen;636815;416342;220473
01.04.21;WA84;Maschinen, Apparate, mechanische Geräte;19225829;12142697;7083132
01.04.21;WA85;Elektrotechnische Erzeugnisse;11915411;12233784;-318373
01.04.21;WA86;Schienenfahrzeuge;268510;206969;61541
01.04.21;WA87;Kraftfahrzeuge, Landfahrzeuge;18630219;10043977;8586242
01.04.21;WA88;Luftfahrzeuge, Raumfahrzeuge;1644651;989535;655116
01.04.21;WA89;Wasserfahrzeuge;119036;116235;2801
01.04.21;WA90;Optische, photografische usw. Erzeugnisse;5702605;3465662;2236943
01.04.21;WA91;Uhrmacherwaren;114195;163074;-48879
01.04.21;WA92;Musikinstrumente;52058;56810;-4752
01.04.21;WA93;Waffen und Munition;48769;19337;29432
01.04.21;WA94;Möbel, Beleuchtungskörper usw.;1364649;1711483;-346834
01.04.21;WA95;Spielzeug, Spiele usw., Sportgeräte;409027;603211;-194184
01.04.21;WA96;Verschiedene Waren;326236;231039;95197
01.04.21;WA97;Kunstgegenstände, Sammlungsstücke;125384;49772;75612
01.04.21;WA98;Vollständige Fabrikationsanlagen;24264;NULL;#WERT!
01.04.21;WA99;Zusammenstellungen verschiedener Waren;1240364;1018188;222176
01.04.22;WA01;Lebende Tiere;91985;118426;-26441
01.04.22;WA02;Fleisch;586827;685555;-98728
01.04.22;WA03;Fische, Krebs- und Weichtiere;122126;333244;-211118
01.04.22;WA04;Milch, Milcherzeugnisse, Eier, Honig;973871;899519;74352
01.04.22;WA05;Andere Waren tierischen Ursprungs;82467;90504;-8037
01.04.22;WA06;Pflanzen, Waren des Blumenhandels;137877;423838;-285961
01.04.22;WA07;Gemüse, Pflanzen für Ernährung;116021;770740;-654719
01.04.22;WA08;Geniessbare Früchte und Nüsse;168857;940269;-771412
01.04.22;WA09;Kaffee, Tee, Mate, Gewürze;309396;514089;-204693
01.04.22;WA10;Getreide;281115;365230;-84115
01.04.22;WA11;Müllereierzeugnisse, Malz usw.;169251;76220;93031
01.04.22;WA12;Ölsamen usw., Heilpflanzen usw.;114843;777966;-663123
01.04.22;WA13;Schellack, Gummen, Harz, Pflanzensaft;57435;67431;-9996
01.04.22;WA14;Flechtstoffe usw. pflanzlichen Ursprungs;1677;4390;-2713
01.04.22;WA15;Tierische und pflanzliche Fette, Öle, Wachs;404357;489880;-85523
01.04.22;WA16;Zubereitungen von Fleisch, Fisch usw.;267749;291047;-23298
01.04.22;WA17;Zucker und Zuckerwaren;242368;148866;93502
01.04.22;WA18;Kakao und Zubereitungen aus Kakao;400123;337695;62428
01.04.22;WA19;Zubereitungen aus Getreide usw., Backwaren;592408;431554;160854
01.04.22;WA20;Zubereitungen von Gemüse, Früchten usw.;261331;437294;-175963
01.04.22;WA21;Verschiedene Lebensmittelzubereitungen;622212;390527;231685
01.04.22;WA22;Getränke, alkoholhaltige Flüssigkeiten, Essig;521589;735284;-213695
01.04.22;WA23;Rückstände der Lebensmittelindustrie, Futter;527979;444294;83685
01.04.22;WA24;Tabak;206701;230365;-23664
01.04.22;WA25;Salz, Schwefel, Steine, Erden usw.;205954;202772;3182
01.04.22;WA26;Erze, Schlacken, Aschen;68309;1079421;-1011112
01.04.22;WA27;Mineralische Brennstoffe usw.;4382831;16023105;-11640274
01.04.22;WA28;Anorganische chemische Erzeugnisse;1310386;898267;412119
01.04.22;WA29;Organische chemische Erzeugnisse;2847634;8259354;-5411720
01.04.22;WA30;Pharmazeutische Erzeugnisse;10268530;5280040;4988490
01.04.22;WA31;Düngemittel;414057;192582;221475
01.04.22;WA32;Gerb- und Farbstoffe, Farben, Lacke usw.;1029985;544676;485309
01.04.22;WA33;Etherische Öle, Riech-, Schönheitsmittel;875424;592626;282798
01.04.22;WA34;Seifen, Waschmittel usw.;732615;414162;318453
01.04.22;WA35;Eiweissstoffe, Klebstoffe, Enzyme;386255;254598;131657
01.04.22;WA36;Sprengstoffe, pyrotechnische Artikel usw.;28355;12686;15669
01.04.22;WA37;Photochemische Erzeugnisse;89203;57457;31746
01.04.22;WA38;Verschiedene Erzeugnisse der Chemischen Industrie;2533385;1905814;627571
01.04.22;WA39;Kunststoffe und Waren daraus;6496535;4570653;1925882
01.04.22;WA40;Kautschuk und Waren daraus;1330132;1339938;-9806
01.04.22;WA41;Häute, Felle, Leder;60761;45873;14888
01.04.22;WA42;Lederwaren, Sattlerwaren;213955;358980;-145025
01.04.22;WA43;Pelzfelle, künstliches Pelzwerk;2584;5995;-3411
01.04.22;WA44;Holz, Holzwaren, Holzkohle;1099439;1016185;83254
01.04.22;WA45;Kork, Korkwaren;2421;8524;-6103
01.04.22;WA46;Flechtwaren, Korbmacherwaren;6846;21641;-14795
01.04.22;WA47;Halbstoffe aus Holz usw., Papierabfall;120510;390054;-269544
01.04.22;WA48;Papier, Pappe und Waren daraus;1958852;1206048;752804
01.04.22;WA49;Bücher, Zeitungen, Bilddrucke usw.;287064;239045;48019
01.04.22;WA50;Seide;1520;1559;-39
01.04.22;WA51;Wolle, feine und grobe Tierhaare;42022;46621;-4599
01.04.22;WA52;Baumwolle;57344;73321;-15977
01.04.22;WA53;Andere pflanzliche Spinnstoffe, Papiergarn;3443;8250;-4807
01.04.22;WA54;Synthetisches oder künstliches Filament;144152;136831;7321
01.04.22;WA55;Synthetische oder künstliche Spinnfaser;131681;138392;-6711
01.04.22;WA56;Watte, Filz, Vliesstoff usw., Tauwerk;227061;155575;71486
01.04.22;WA57;Teppiche, Fussbodenbelag aus Spinnstoff;44851;97935;-53084
01.04.22;WA58;Spezialgewebe, Spitzen, Tapisserien;42960;23500;19460
01.04.22;WA59;Getränkte, bestrichene usw. Gewebe;212165;99679;112486
01.04.22;WA60;Gewirke und Gestricke;63043;41306;21737
01.04.22;WA61;Bekleidung usw. aus Gewirken, Gestricken;930853;1716487;-785634
01.04.22;WA62;Andere Bekleidung, Bekleidungszubehör;977806;1583132;-605326
01.04.22;WA63;Andere Konfektion, Spinnstoffwaren usw.;263846;439640;-175794
01.04.22;WA64;Schuhe, Gamaschen, ähnliche Waren;730105;1021587;-291482
01.04.22;WA65;Kopfbedeckungen und Teile davon;56556;77075;-20519
01.04.22;WA66;Schirme, Gehstöcke usw., Peitschen;12145;42971;-30826
01.04.22;WA67;Zugerichtete Federn, Daunen, künstliche Blumen;13719;20504;-6785
01.04.22;WA68;Waren aus Steinen, Gips, Zement usw.;445366;317784;127582
01.04.22;WA69;Keramische Waren;331941;300456;31485
01.04.22;WA70;Glas und Glaswaren;616584;442536;174048
01.04.22;WA71;Perlen, Edelsteine, Edelmetalle;1848581;3233931;-1385350
01.04.22;WA72;Eisen und Stahl;3312899;3328227;-15328
01.04.22;WA73;Waren aus Eisen oder Stahl;2613569;2430255;183314
01.04.22;WA74;Kupfer und Waren daraus;1364254;1325582;38672
01.04.22;WA75;Nickel und Waren daraus;149275;212510;-63235
01.04.22;WA76;Aluminium und Waren daraus;1703246;2103432;-400186
01.04.22;WA78;Blei und Waren daraus;27324;53477;-26153
01.04.22;WA79;Zink und Waren daraus;88155;166854;-78699
01.04.22;WA80;Zinn und Waren daraus;16757;76866;-60109
01.04.22;WA81;Andere unedle Metalle, Cermets usw.;142111;209593;-67482
01.04.22;WA82;Werkzeuge, Schneidwaren, Essbestecke;756389;507248;249141
01.04.22;WA83;Verschiedene Waren aus unedlen Metallen;673333;466010;207323
01.04.22;WA84;Maschinen, Apparate, mechanische Geräte;18571843;13036446;5535397
01.04.22;WA85;Elektrotechnische Erzeugnisse;12714886;13903540;-1188654
01.04.22;WA86;Schienenfahrzeuge;249166;221694;27472
01.04.22;WA87;Kraftfahrzeuge, Landfahrzeuge;17997007;9863067;8133940
01.04.22;WA88;Luftfahrzeuge, Raumfahrzeuge;2082860;820894;1261966
01.04.22;WA89;Wasserfahrzeuge;192987;196942;-3955
01.04.22;WA90;Optische, photografische usw. Erzeugnisse;5586945;3423310;2163635
01.04.22;WA91;Uhrmacherwaren;134727;214983;-80256
01.04.22;WA92;Musikinstrumente;73203;60844;12359
01.04.22;WA93;Waffen und Munition;55147;25886;29261
01.04.22;WA94;Möbel, Beleuchtungskörper usw.;1357700;1895907;-538207
01.04.22;WA95;Spielzeug, Spiele usw., Sportgeräte;391020;700174;-309154
01.04.22;WA96;Verschiedene Waren;337785;284055;53730
01.04.22;WA97;Kunstgegenstände, Sammlungsstücke;93720;41870;51850
01.04.22;WA98;Vollständige Fabrikationsanlagen;47102;NULL;#WERT!
01.04.22;WA99;Zusammenstellungen verschiedener Waren;1281297;839810;441487
01.04.23;WA01;Lebende Tiere;117081;141387;-24306
01.04.23;WA02;Fleisch;576203;602600;-26397
01.04.23;WA03;Fische, Krebs- und Weichtiere;112719;339155;-226436
01.04.23;WA04;Milch, Milcherzeugnisse, Eier, Honig;1003146;847203;155943
01.04.23;WA05;Andere Waren tierischen Ursprungs;78200;93479;-15279
01.04.23;WA06;Pflanzen, Waren des Blumenhandels;112599;351937;-239338
01.04.23;WA07;Gemüse, Pflanzen für Ernährung;124644;801187;-676543
01.04.23;WA08;Geniessbare Früchte und Nüsse;171964;893226;-721262
01.04.23;WA09;Kaffee, Tee, Mate, Gewürze;283251;408417;-125166
01.04.23;WA10;Getreide;312252;300837;11415
01.04.23;WA11;Müllereierzeugnisse, Malz usw.;190826;82366;108460
01.04.23;WA12;Ölsamen usw., Heilpflanzen usw.;133437;634856;-501419
01.04.23;WA13;Schellack, Gummen, Harz, Pflanzensaft;55470;53338;2132
01.04.23;WA14;Flechtstoffe usw. pflanzlichen Ursprungs;1075;4016;-2941
01.04.23;WA15;Tierische und pflanzliche Fette, Öle, Wachs;329236;411564;-82328
01.04.23;WA16;Zubereitungen von Fleisch, Fisch usw.;287267;285271;1996
01.04.23;WA17;Zucker und Zuckerwaren;269115;205466;63649
01.04.23;WA18;Kakao und Zubereitungen aus Kakao;431657;404083;27574
01.04.23;WA19;Zubereitungen aus Getreide usw., Backwaren;691308;500433;190875
01.04.23;WA20;Zubereitungen von Gemüse, Früchten usw.;267348;482306;-214958
01.04.23;WA21;Verschiedene Lebensmittelzubereitungen;684650;404060;280590
01.04.23;WA22;Getränke, alkoholhaltige Flüssigkeiten, Essig;538802;681881;-143079
01.04.23;WA23;Rückstände der Lebensmittelindustrie, Futter;565571;456969;108602
01.04.23;WA24;Tabak;222307;386763;-164456
01.04.23;WA25;Salz, Schwefel, Steine, Erden usw.;191453;161266;30187
01.04.23;WA26;Erze, Schlacken, Aschen;49992;850766;-800774
01.04.23;WA27;Mineralische Brennstoffe usw.;2624677;9625563;-7000886
01.04.23;WA28;Anorganische chemische Erzeugnisse;1082831;630774;452057
01.04.23;WA29;Organische chemische Erzeugnisse;2306654;3339393;-1032739
01.04.23;WA30;Pharmazeutische Erzeugnisse;7995931;4568900;3427031
01.04.23;WA31;Düngemittel;282030;133473;148557
01.04.23;WA32;Gerb- und Farbstoffe, Farben, Lacke usw.;899649;448501;451148
01.04.23;WA33;Etherische Öle, Riech-, Schönheitsmittel;934550;614779;319771
01.04.23;WA34;Seifen, Waschmittel usw.;676488;395772;280716
01.04.23;WA35;Eiweissstoffe, Klebstoffe, Enzyme;360298;216721;143577
01.04.23;WA36;Sprengstoffe, pyrotechnische Artikel usw.;29099;21034;8065
01.04.23;WA37;Photochemische Erzeugnisse;74375;42291;32084
01.04.23;WA38;Verschiedene Erzeugnisse der Chemischen Industrie;2567620;1599608;968012
01.04.23;WA39;Kunststoffe und Waren daraus;5396431;3760324;1636107
01.04.23;WA40;Kautschuk und Waren daraus;1308549;1251189;57360
01.04.23;WA41;Häute, Felle, Leder;46870;38547;8323
01.04.23;WA42;Lederwaren, Sattlerwaren;213646;322638;-108992
01.04.23;WA43;Pelzfelle, künstliches Pelzwerk;4579;5612;-1033
01.04.23;WA44;Holz, Holzwaren, Holzkohle;816496;708217;108279
01.04.23;WA45;Kork, Korkwaren;1838;6125;-4287
01.04.23;WA46;Flechtwaren, Korbmacherwaren;5790;11851;-6061
01.04.23;WA47;Halbstoffe aus Holz usw., Papierabfall;99066;304176;-205110
01.04.23;WA48;Papier, Pappe und Waren daraus;1575747;1054634;521113
01.04.23;WA49;Bücher, Zeitungen, Bilddrucke usw.;249042;242283;6759
01.04.23;WA50;Seide;1427;2746;-1319
01.04.23;WA51;Wolle, feine und grobe Tierhaare;37025;43147;-6122
01.04.23;WA52;Baumwolle;53171;59909;-6738
01.04.23;WA53;Andere pflanzliche Spinnstoffe, Papiergarn;2547;5046;-2499
01.04.23;WA54;Synthetisches oder künstliches Filament;132007;118553;13454
01.04.23;WA55;Synthetische oder künstliche Spinnfaser;120054;117403;2651
01.04.23;WA56;Watte, Filz, Vliesstoff usw., Tauwerk;202769;135863;66906
01.04.23;WA57;Teppiche, Fussbodenbelag aus Spinnstoff;46239;80908;-34669
01.04.23;WA58;Spezialgewebe, Spitzen, Tapisserien;42747;21630;21117
01.04.23;WA59;Getränkte, bestrichene usw. Gewebe;212478;110356;102122
01.04.23;WA60;Gewirke und Gestricke;58248;38292;19956
01.04.23;WA61;Bekleidung usw. aus Gewirken, Gestricken;884793;1299705;-414912
01.04.23;WA62;Andere Bekleidung, Bekleidungszubehör;956915;1280744;-323829
01.04.23;WA63;Andere Konfektion, Spinnstoffwaren usw.;245149;332688;-87539
01.04.23;WA64;Schuhe, Gamaschen, ähnliche Waren;753753;895054;-141301
01.04.23;WA65;Kopfbedeckungen und Teile davon;55942;65797;-9855
01.04.23;WA66;Schirme, Gehstöcke usw., Peitschen;9063;23858;-14795
01.04.23;WA67;Zugerichtete Federn, Daunen, künstliche Blumen;11870;16226;-4356
01.04.23;WA68;Waren aus Steinen, Gips, Zement usw.;430687;301047;129640
01.04.23;WA69;Keramische Waren;313603;234940;78663
01.04.23;WA70;Glas und Glaswaren;631537;462851;168686
01.04.23;WA71;Perlen, Edelsteine, Edelmetalle;1538660;1838133;-299473
01.04.23;WA72;Eisen und Stahl;2440190;2573416;-133226
01.04.23;WA73;Waren aus Eisen oder Stahl;2672026;2214737;457289
01.04.23;WA74;Kupfer und Waren daraus;1135455;953546;181909
01.04.23;WA75;Nickel und Waren daraus;169359;248859;-79500
01.04.23;WA76;Aluminium und Waren daraus;1496322;1724791;-228469
01.04.23;WA78;Blei und Waren daraus;32894;61501;-28607
01.04.23;WA79;Zink und Waren daraus;51582;137251;-85669
01.04.23;WA80;Zinn und Waren daraus;12654;35211;-22557
01.04.23;WA81;Andere unedle Metalle, Cermets usw.;144052;185883;-41831
01.04.23;WA82;Werkzeuge, Schneidwaren, Essbestecke;725988;459658;266330
01.04.23;WA83;Verschiedene Waren aus unedlen Metallen;637689;414499;223190
01.04.23;WA84;Maschinen, Apparate, mechanische Geräte;19479769;13059388;6420381
01.04.23;WA85;Elektrotechnische Erzeugnisse;13414782;15897178;-2482396
01.04.23;WA86;Schienenfahrzeuge;183956;219119;-35163
01.04.23;WA87;Kraftfahrzeuge, Landfahrzeuge;21439292;11122745;10316547
01.04.23;WA88;Luftfahrzeuge, Raumfahrzeuge;2450225;1231219;1219006
01.04.23;WA89;Wasserfahrzeuge;438644;613769;-175125
01.04.23;WA90;Optische, photografische usw. Erzeugnisse;5808729;3641733;2166996
01.04.23;WA91;Uhrmacherwaren;134141;194098;-59957
01.04.23;WA92;Musikinstrumente;73956;57089;16867
01.04.23;WA93;Waffen und Munition;55144;79484;-24340
01.04.23;WA94;Möbel, Beleuchtungskörper usw.;1328809;1660440;-331631
01.04.23;WA95;Spielzeug, Spiele usw., Sportgeräte;425156;683312;-258156
01.04.23;WA96;Verschiedene Waren;333751;262046;71705
01.04.23;WA97;Kunstgegenstände, Sammlungsstücke;70411;56325;14086
01.04.23;WA98;Vollständige Fabrikationsanlagen;60084;NULL;#WERT!
01.04.23;WA99;Zusammenstellungen verschiedener Waren;1007865;915465;92400
01.04.24;WA01;Lebende Tiere;125780;156621;-30841
01.04.24;WA02;Fleisch;639643;675345;-35702
01.04.24;WA03;Fische, Krebs- und Weichtiere;108687;335020;-226333
01.04.24;WA04;Milch, Milcherzeugnisse, Eier, Honig;1111673;980716;130957
01.04.24;WA05;Andere Waren tierischen Ursprungs;81195;94490;-13295
01.04.24;WA06;Pflanzen, Waren des Blumenhandels;137831;404819;-266988
01.04.24;WA07;Gemüse, Pflanzen für Ernährung;169033;855714;-686681
01.04.24;WA08;Geniessbare Früchte und Nüsse;193280;1125846;-932566
01.04.24;WA09;Kaffee, Tee, Mate, Gewürze;345545;513416;-167871
01.04.24;WA10;Getreide;224267;354395;-130128
01.04.24;WA11;Müllereierzeugnisse, Malz usw.;214941;91986;122955
01.04.24;WA12;Ölsamen usw., Heilpflanzen usw.;151887;561409;-409522
01.04.24;WA13;Schellack, Gummen, Harz, Pflanzensaft;63060;64526;-1466
01.04.24;WA14;Flechtstoffe usw. pflanzlichen Ursprungs;1256;4019;-2763
01.04.24;WA15;Tierische und pflanzliche Fette, Öle, Wachs;302966;472024;-169058
01.04.24;WA16;Zubereitungen von Fleisch, Fisch usw.;314620;320447;-5827
01.04.24;WA17;Zucker und Zuckerwaren;302172;224546;77626
01.04.24;WA18;Kakao und Zubereitungen aus Kakao;648160;649559;-1399
01.04.24;WA19;Zubereitungen aus Getreide usw., Backwaren;797538;601604;195934
01.04.24;WA20;Zubereitungen von Gemüse, Früchten usw.;330699;607771;-277072
01.04.24;WA21;Verschiedene Lebensmittelzubereitungen;794710;511649;283061
01.04.24;WA22;Getränke, alkoholhaltige Flüssigkeiten, Essig;678990;797106;-118116
01.04.24;WA23;Rückstände der Lebensmittelindustrie, Futter;584932;511032;73900
01.04.24;WA24;Tabak;277315;498967;-221652
01.04.24;WA25;Salz, Schwefel, Steine, Erden usw.;222405;175712;46693
01.04.24;WA26;Erze, Schlacken, Aschen;83943;953335;-869392
01.04.24;WA27;Mineralische Brennstoffe usw.;2907613;9415203;-6507590
01.04.24;WA28;Anorganische chemische Erzeugnisse;1092361;851910;240451
01.04.24;WA29;Organische chemische Erzeugnisse;2476576;3997581;-1521005
01.04.24;WA30;Pharmazeutische Erzeugnisse;9474700;5809824;3664876
01.04.24;WA31;Düngemittel;231708;155165;76543
01.04.24;WA32;Gerb- und Farbstoffe, Farben, Lacke usw.;1057701;507437;550264
01.04.24;WA33;Etherische Öle, Riech-, Schönheitsmittel;1043267;784258;259009
01.04.24;WA34;Seifen, Waschmittel usw.;801514;467106;334408
01.04.24;WA35;Eiweissstoffe, Klebstoffe, Enzyme;419469;258712;160757
01.04.24;WA36;Sprengstoffe, pyrotechnische Artikel usw.;46309;22110;24199
01.04.24;WA37;Photochemische Erzeugnisse;83873;57806;26067
01.04.24;WA38;Verschiedene Erzeugnisse der Chemischen Industrie;2848324;1871665;976659
01.04.24;WA39;Kunststoffe und Waren daraus;6179129;4161290;2017839
01.04.24;WA40;Kautschuk und Waren daraus;1512224;1471747;40477
01.04.24;WA41;Häute, Felle, Leder;54102;47977;6125
01.04.24;WA42;Lederwaren, Sattlerwaren;239333;352457;-113124
01.04.24;WA43;Pelzfelle, künstliches Pelzwerk;4523;5295;-772
01.04.24;WA44;Holz, Holzwaren, Holzkohle;893151;730335;162816
01.04.24;WA45;Kork, Korkwaren;2176;8696;-6520
01.04.24;WA46;Flechtwaren, Korbmacherwaren;6741;13311;-6570
01.04.24;WA47;Halbstoffe aus Holz usw., Papierabfall;125749;387677;-261928
01.04.24;WA48;Papier, Pappe und Waren daraus;1753602;1158388;595214
01.04.24;WA49;Bücher, Zeitungen, Bilddrucke usw.;269871;209225;60646
01.04.24;WA50;Seide;1883;3478;-1595
01.04.24;WA51;Wolle, feine und grobe Tierhaare;35080;44040;-8960
01.04.24;WA52;Baumwolle;52901;53140;-239
01.04.24;WA53;Andere pflanzliche Spinnstoffe, Papiergarn;2853;5841;-2988
01.04.24;WA54;Synthetisches oder künstliches Filament;144209;121861;22348
01.04.24;WA55;Synthetische oder künstliche Spinnfaser;122201;119358;2843
01.04.24;WA56;Watte, Filz, Vliesstoff usw., Tauwerk;237023;160571;76452
01.04.24;WA57;Teppiche, Fussbodenbelag aus Spinnstoff;52969;95169;-42200
01.04.24;WA58;Spezialgewebe, Spitzen, Tapisserien;47268;23558;23710
01.04.24;WA59;Getränkte, bestrichene usw. Gewebe;237776;117545;120231
01.04.24;WA60;Gewirke und Gestricke;59738;41780;17958
01.04.24;WA61;Bekleidung usw. aus Gewirken, Gestricken;1010008;1570341;-560333
01.04.24;WA62;Andere Bekleidung, Bekleidungszubehör;1079571;1542188;-462617
01.04.24;WA63;Andere Konfektion, Spinnstoffwaren usw.;276058;366553;-90495
01.04.24;WA64;Schuhe, Gamaschen, ähnliche Waren;876416;1050329;-173913
01.04.24;WA65;Kopfbedeckungen und Teile davon;65611;73405;-7794
01.04.24;WA66;Schirme, Gehstöcke usw., Peitschen;12152;25450;-13298
01.04.24;WA67;Zugerichtete Federn, Daunen, künstliche Blumen;13172;19741;-6569
01.04.24;WA68;Waren aus Steinen, Gips, Zement usw.;495720;321503;174217
01.04.24;WA69;Keramische Waren;357981;252365;105616
01.04.24;WA70;Glas und Glaswaren;682099;498656;183443
01.04.24;WA71;Perlen, Edelsteine, Edelmetalle;2681717;1718107;963610
01.04.24;WA72;Eisen und Stahl;2596933;2460245;136688
01.04.24;WA73;Waren aus Eisen oder Stahl;2885328;2281767;603561
01.04.24;WA74;Kupfer und Waren daraus;1301172;1200699;100473
01.04.24;WA75;Nickel und Waren daraus;168576;192027;-23451
01.04.24;WA76;Aluminium und Waren daraus;1604897;1726570;-121673
01.04.24;WA78;Blei und Waren daraus;43599;53498;-9899
01.04.24;WA79;Zink und Waren daraus;66318;118555;-52237
01.04.24;WA80;Zinn und Waren daraus;11034;38535;-27501
01.04.24;WA81;Andere unedle Metalle, Cermets usw.;158344;179589;-21245
01.04.24;WA82;Werkzeuge, Schneidwaren, Essbestecke;841247;499429;341818
01.04.24;WA83;Verschiedene Waren aus unedlen Metallen;743415;493831;249584
01.04.24;WA84;Maschinen, Apparate, mechanische Geräte;22433186;14314444;8118742
01.04.24;WA85;Elektrotechnische Erzeugnisse;14538112;15938829;-1400717
01.04.24;WA86;Schienenfahrzeuge;247210;299240;-52030
01.04.24;WA87;Kraftfahrzeuge, Landfahrzeuge;25050242;12389900;12660342
01.04.24;WA88;Luftfahrzeuge, Raumfahrzeuge;3204855;1001727;2203128
01.04.24;WA89;Wasserfahrzeuge;1217184;316039;901145
01.04.24;WA90;Optische, photografische usw. Erzeugnisse;6711719;4074802;2636917
01.04.24;WA91;Uhrmacherwaren;154649;217940;-63291
01.04.24;WA92;Musikinstrumente;84944;61738;23206
01.04.24;WA93;Waffen und Munition;65133;33082;32051
01.04.24;WA94;Möbel, Beleuchtungskörper usw.;1507653;1858137;-350484
01.04.24;WA95;Spielzeug, Spiele usw., Sportgeräte;361237;554323;-193086
01.04.24;WA96;Verschiedene Waren;357269;297382;59887
01.04.24;WA97;Kunstgegenstände, Sammlungsstücke;74152;58527;15625
01.04.24;WA98;Vollständige Fabrikationsanlagen;70173;NULL;#WERT!
01.04.24;WA99;Zusammenstellungen verschiedener Waren;1256873;1103165;153708
01.04.25;WA01;Lebende Tiere;NULL;NULL;#WERT!
01.04.25;WA02;Fleisch;NULL;NULL;#WERT!
01.04.25;WA03;Fische, Krebs- und Weichtiere;NULL;NULL;#WERT!
01.04.25;WA04;Milch, Milcherzeugnisse, Eier, Honig;NULL;NULL;#WERT!
01.04.25;WA05;Andere Waren tierischen Ursprungs;NULL;NULL;#WERT!
01.04.25;WA06;Pflanzen, Waren des Blumenhandels;NULL;NULL;#WERT!
01.04.25;WA07;Gemüse, Pflanzen für Ernährung;NULL;NULL;#WERT!
01.04.25;WA08;Geniessbare Früchte und Nüsse;NULL;NULL;#WERT!
01.04.25;WA09;Kaffee, Tee, Mate, Gewürze;NULL;NULL;#WERT!
01.04.25;WA10;Getreide;NULL;NULL;#WERT!
01.04.25;WA11;Müllereierzeugnisse, Malz usw.;NULL;NULL;#WERT!
01.04.25;WA12;Ölsamen usw., Heilpflanzen usw.;NULL;NULL;#WERT!
01.04.25;WA13;Schellack, Gummen, Harz, Pflanzensaft;NULL;NULL;#WERT!
01.04.25;WA14;Flechtstoffe usw. pflanzlichen Ursprungs;NULL;NULL;#WERT!
01.04.25;WA15;Tierische und pflanzliche Fette, Öle, Wachs;NULL;NULL;#WERT!
01.04.25;WA16;Zubereitungen von Fleisch, Fisch usw.;NULL;NULL;#WERT!
01.04.25;WA17;Zucker und Zuckerwaren;NULL;NULL;#WERT!
01.04.25;WA18;Kakao und Zubereitungen aus Kakao;NULL;NULL;#WERT!
01.04.25;WA19;Zubereitungen aus Getreide usw., Backwaren;NULL;NULL;#WERT!
01.04.25;WA20;Zubereitungen von Gemüse, Früchten usw.;NULL;NULL;#WERT!
01.04.25;WA21;Verschiedene Lebensmittelzubereitungen;NULL;NULL;#WERT!
01.04.25;WA22;Getränke, alkoholhaltige Flüssigkeiten, Essig;NULL;NULL;#WERT!
01.04.25;WA23;Rückstände der Lebensmittelindustrie, Futter;NULL;NULL;#WERT!
01.04.25;WA24;Tabak;NULL;NULL;#WERT!
01.04.25;WA25;Salz, Schwefel, Steine, Erden usw.;NULL;NULL;#WERT!
01.04.25;WA26;Erze, Schlacken, Aschen;NULL;NULL;#WERT!
01.04.25;WA27;Mineralische Brennstoffe usw.;NULL;NULL;#WERT!
01.04.25;WA28;Anorganische chemische Erzeugnisse;NULL;NULL;#WERT!
01.04.25;WA29;Organische chemische Erzeugnisse;NULL;NULL;#WERT!
01.04.25;WA30;Pharmazeutische Erzeugnisse;NULL;NULL;#WERT!
01.04.25;WA31;Düngemittel;NULL;NULL;#WERT!
01.04.25;WA32;Gerb- und Farbstoffe, Farben, Lacke usw.;NULL;NULL;#WERT!
01.04.25;WA33;Etherische Öle, Riech-, Schönheitsmittel;NULL;NULL;#WERT!
01.04.25;WA34;Seifen, Waschmittel usw.;NULL;NULL;#WERT!
01.04.25;WA35;Eiweissstoffe, Klebstoffe, Enzyme;NULL;NULL;#WERT!
01.04.25;WA36;Sprengstoffe, pyrotechnische Artikel usw.;NULL;NULL;#WERT!
01.04.25;WA37;Photochemische Erzeugnisse;NULL;NULL;#WERT!
01.04.25;WA38;Verschiedene Erzeugnisse der Chemischen Industrie;NULL;NULL;#WERT!
01.04.25;WA39;Kunststoffe und Waren daraus;NULL;NULL;#WERT!
01.04.25;WA40;Kautschuk und Waren daraus;NULL;NULL;#WERT!
01.04.25;WA41;Häute, Felle, Leder;NULL;NULL;#WERT!
01.04.25;WA42;Lederwaren, Sattlerwaren;NULL;NULL;#WERT!
01.04.25;WA43;Pelzfelle, künstliches Pelzwerk;NULL;NULL;#WERT!
01.04.25;WA44;Holz, Holzwaren, Holzkohle;NULL;NULL;#WERT!
01.04.25;WA45;Kork, Korkwaren;NULL;NULL;#WERT!
01.04.25;WA46;Flechtwaren, Korbmacherwaren;NULL;NULL;#WERT!
01.04.25;WA47;Halbstoffe aus Holz usw., Papierabfall;NULL;NULL;#WERT!
01.04.25;WA48;Papier, Pappe und Waren daraus;NULL;NULL;#WERT!
01.04.25;WA49;Bücher, Zeitungen, Bilddrucke usw.;NULL;NULL;#WERT!
01.04.25;WA50;Seide;NULL;NULL;#WERT!
01.04.25;WA51;Wolle, feine und grobe Tierhaare;NULL;NULL;#WERT!
01.04.25;WA52;Baumwolle;NULL;NULL;#WERT!
01.04.25;WA53;Andere pflanzliche Spinnstoffe, Papiergarn;NULL;NULL;#WERT!
01.04.25;WA54;Synthetisches oder künstliches Filament;NULL;NULL;#WERT!
01.04.25;WA55;Synthetische oder künstliche Spinnfaser;NULL;NULL;#WERT!
01.04.25;WA56;Watte, Filz, Vliesstoff usw., Tauwerk;NULL;NULL;#WERT!
01.04.25;WA57;Teppiche, Fussbodenbelag aus Spinnstoff;NULL;NULL;#WERT!
01.04.25;WA58;Spezialgewebe, Spitzen, Tapisserien;NULL;NULL;#WERT!
01.04.25;WA59;Getränkte, bestrichene usw. Gewebe;NULL;NULL;#WERT!
01.04.25;WA60;Gewirke und Gestricke;NULL;NULL;#WERT!
01.04.25;WA61;Bekleidung usw. aus Gewirken, Gestricken;NULL;NULL;#WERT!
01.04.25;WA62;Andere Bekleidung, Bekleidungszubehör;NULL;NULL;#WERT!
01.04.25;WA63;Andere Konfektion, Spinnstoffwaren usw.;NULL;NULL;#WERT!
01.04.25;WA64;Schuhe, Gamaschen, ähnliche Waren;NULL;NULL;#WERT!
01.04.25;WA65;Kopfbedeckungen und Teile davon;NULL;NULL;#WERT!
01.04.25;WA66;Schirme, Gehstöcke usw., Peitschen;NULL;NULL;#WERT!
01.04.25;WA67;Zugerichtete Federn, Daunen, künstliche Blumen;NULL;NULL;#WERT!
01.04.25;WA68;Waren aus Steinen, Gips, Zement usw.;NULL;NULL;#WERT!
01.04.25;WA69;Keramische Waren;NULL;NULL;#WERT!
01.04.25;WA70;Glas und Glaswaren;NULL;NULL;#WERT!
01.04.25;WA71;Perlen, Edelsteine, Edelmetalle;NULL;NULL;#WERT!
01.04.25;WA72;Eisen und Stahl;NULL;NULL;#WERT!
01.04.25;WA73;Waren aus Eisen oder Stahl;NULL;NULL;#WERT!
01.04.25;WA74;Kupfer und Waren daraus;NULL;NULL;#WERT!
01.04.25;WA75;Nickel und Waren daraus;NULL;NULL;#WERT!
01.04.25;WA76;Aluminium und Waren daraus;NULL;NULL;#WERT!
01.04.25;WA78;Blei und Waren daraus;NULL;NULL;#WERT!
01.04.25;WA79;Zink und Waren daraus;NULL;NULL;#WERT!
01.04.25;WA80;Zinn und Waren daraus;NULL;NULL;#WERT!
01.04.25;WA81;Andere unedle Metalle, Cermets usw.;NULL;NULL;#WERT!
01.04.25;WA82;Werkzeuge, Schneidwaren, Essbestecke;NULL;NULL;#WERT!
01.04.25;WA83;Verschiedene Waren aus unedlen Metallen;NULL;NULL;#WERT!
01.04.25;WA84;Maschinen, Apparate, mechanische Geräte;NULL;NULL;#WERT!
01.04.25;WA85;Elektrotechnische Erzeugnisse;NULL;NULL;#WERT!
01.04.25;WA86;Schienenfahrzeuge;NULL;NULL;#WERT!
01.04.25;WA87;Kraftfahrzeuge, Landfahrzeuge;NULL;NULL;#WERT!
01.04.25;WA88;Luftfahrzeuge, Raumfahrzeuge;NULL;NULL;#WERT!
01.04.25;WA89;Wasserfahrzeuge;NULL;NULL;#WERT!
01.04.25;WA90;Optische, photografische usw. Erzeugnisse;NULL;NULL;#WERT!
01.04.25;WA91;Uhrmacherwaren;NULL;NULL;#WERT!
01.04.25;WA92;Musikinstrumente;NULL;NULL;#WERT!
01.04.25;WA93;Waffen und Munition;NULL;NULL;#WERT!
01.04.25;WA94;Möbel, Beleuchtungskörper usw.;NULL;NULL;#WERT!
01.04.25;WA95;Spielzeug, Spiele usw., Sportgeräte;NULL;NULL;#WERT!
01.04.25;WA96;Verschiedene Waren;NULL;NULL;#WERT!
01.04.25;WA97;Kunstgegenstände, Sammlungsstücke;NULL;NULL;#WERT!
01.04.25;WA98;Vollständige Fabrikationsanlagen;NULL;NULL;#WERT!
01.04.25;WA99;Zusammenstellungen verschiedener Waren;NULL;NULL;#WERT!
01.05.08;WA01;Lebende Tiere;58706;93200;-34494
01.05.08;WA02;Fleisch;509232;430073;79159
01.05.08;WA03;Fische, Krebs- und Weichtiere;82664;200626;-117962
01.05.08;WA04;Milch, Milcherzeugnisse, Eier, Honig;637092;532647;104445
01.05.08;WA05;Andere Waren tierischen Ursprungs;49172;51684;-2512
01.05.08;WA06;Pflanzen, Waren des Blumenhandels;78930;312492;-233562
01.05.08;WA07;Gemüse, Pflanzen für Ernährung;76859;446409;-369550
01.05.08;WA08;Geniessbare Früchte und Nüsse;100882;521996;-421114
01.05.08;WA09;Kaffee, Tee, Mate, Gewürze;131436;202078;-70642
01.05.08;WA10;Getreide;242044;187280;54764
01.05.08;WA11;Müllereierzeugnisse, Malz usw.;77125;40506;36619
01.05.08;WA12;Ölsamen usw., Heilpflanzen usw.;83081;250146;-167065
01.05.08;WA13;Schellack, Gummen, Harz, Pflanzensaft;38596;27832;10764
01.05.08;WA14;Flechtstoffe usw. pflanzlichen Ursprungs;1419;2461;-1042
01.05.08;WA15;Tierische und pflanzliche Fette, Öle, Wachs;164879;274385;-109506
01.05.08;WA16;Zubereitungen von Fleisch, Fisch usw.;178164;185555;-7391
01.05.08;WA17;Zucker und Zuckerwaren;100659;110792;-10133
01.05.08;WA18;Kakao und Zubereitungen aus Kakao;165792;144367;21425
01.05.08;WA19;Zubereitungen aus Getreide usw., Backwaren;318920;198963;119957
01.05.08;WA20;Zubereitungen von Gemüse, Früchten usw.;180892;334932;-154040
01.05.08;WA21;Verschiedene Lebensmittelzubereitungen;357383;218080;139303
01.05.08;WA22;Getränke, alkoholhaltige Flüssigkeiten, Essig;369862;419091;-49229
01.05.08;WA23;Rückstände der Lebensmittelindustrie, Futter;208993;231795;-22802
01.05.08;WA24;Tabak;271311;101169;170142
01.05.08;WA25;Salz, Schwefel, Steine, Erden usw.;211850;144786;67064
01.05.08;WA26;Erze, Schlacken, Aschen;21715;548572;-526857
01.05.08;WA27;Mineralische Brennstoffe usw.;2176498;8974322;-6797824
01.05.08;WA28;Anorganische chemische Erzeugnisse;624997;424320;200677
01.05.08;WA29;Organische chemische Erzeugnisse;1839982;1789592;50390
01.05.08;WA30;Pharmazeutische Erzeugnisse;3202319;2269982;932337
01.05.08;WA31;Düngemittel;237243;149759;87484
01.05.08;WA32;Gerb- und Farbstoffe, Farben, Lacke usw.;701014;306378;394636
01.05.08;WA33;Etherische Öle, Riech-, Schönheitsmittel;514867;298988;215879
01.05.08;WA34;Seifen, Waschmittel usw.;420001;187503;232498
01.05.08;WA35;Eiweissstoffe, Klebstoffe, Enzyme;176509;126549;49960
01.05.08;WA36;Sprengstoffe, pyrotechnische Artikel usw.;17201;12319;4882
01.05.08;WA37;Photochemische Erzeugnisse;97919;63984;33935
01.05.08;WA38;Verschiedene Erzeugnisse der Chemischen Industrie;1201774;820372;381402
01.05.08;WA39;Kunststoffe und Waren daraus;3866902;2314326;1552576
01.05.08;WA40;Kautschuk und Waren daraus;856267;829979;26288
01.05.08;WA41;Häute, Felle, Leder;80861;70968;9893
01.05.08;WA42;Lederwaren, Sattlerwaren;87440;179831;-92391
01.05.08;WA43;Pelzfelle, künstliches Pelzwerk;15887;13093;2794
01.05.08;WA44;Holz, Holzwaren, Holzkohle;650232;463772;186460
01.05.08;WA45;Kork, Korkwaren;3353;9076;-5723
01.05.08;WA46;Flechtwaren, Korbmacherwaren;2830;10739;-7909
01.05.08;WA47;Halbstoffe aus Holz usw., Papierabfall;80143;256566;-176423
01.05.08;WA48;Papier, Pappe und Waren daraus;1467535;974579;492956
01.05.08;WA49;Bücher, Zeitungen, Bilddrucke usw.;341266;177364;163902
01.05.08;WA50;Seide;7291;6883;408
01.05.08;WA51;Wolle, feine und grobe Tierhaare;80040;74564;5476
01.05.08;WA52;Baumwolle;96942;91652;5290
01.05.08;WA53;Andere pflanzliche Spinnstoffe, Papiergarn;3840;5774;-1934
01.05.08;WA54;Synthetisches oder künstliches Filament;205720;133290;72430
01.05.08;WA55;Synthetische oder künstliche Spinnfaser;145530;124444;21086
01.05.08;WA56;Watte, Filz, Vliesstoff usw., Tauwerk;167534;88065;79469
01.05.08;WA57;Teppiche, Fussbodenbelag aus Spinnstoff;42460;78566;-36106
01.05.08;WA58;Spezialgewebe, Spitzen, Tapisserien;46207;28204;18003
01.05.08;WA59;Getränkte, bestrichene usw. Gewebe;144656;107220;37436
01.05.08;WA60;Gewirke und Gestricke;78087;38454;39633
01.05.08;WA61;Bekleidung usw. aus Gewirken, Gestricken;347881;695048;-347167
01.05.08;WA62;Andere Bekleidung, Bekleidungszubehör;393497;758735;-365238
01.05.08;WA63;Andere Konfektion, Spinnstoffwaren usw.;134731;224375;-89644
01.05.08;WA64;Schuhe, Gamaschen, ähnliche Waren;196107;350072;-153965
01.05.08;WA65;Kopfbedeckungen und Teile davon;16748;23059;-6311
01.05.08;WA66;Schirme, Gehstöcke usw., Peitschen;7116;20970;-13854
01.05.08;WA67;Zugerichtete Federn, Daunen, künstliche Blumen;3794;9835;-6041
01.05.08;WA68;Waren aus Steinen, Gips, Zement usw.;282106;186708;95398
01.05.08;WA69;Keramische Waren;268398;182641;85757
01.05.08;WA70;Glas und Glaswaren;381328;373903;7425
01.05.08;WA71;Perlen, Edelsteine, Edelmetalle;699083;829826;-130743
01.05.08;WA72;Eisen und Stahl;2606370;2762582;-156212
01.05.08;WA73;Waren aus Eisen oder Stahl;2151100;1435533;715567
01.05.08;WA74;Kupfer und Waren daraus;946421;966786;-20365
01.05.08;WA75;Nickel und Waren daraus;115183;123555;-8372
01.05.08;WA76;Aluminium und Waren daraus;1047996;1083244;-35248
01.05.08;WA78;Blei und Waren daraus;43489;22458;21031
01.05.08;WA79;Zink und Waren daraus;55140;77470;-22330
01.05.08;WA80;Zinn und Waren daraus;9811;36792;-26981
01.05.08;WA81;Andere unedle Metalle, Cermets usw.;98144;146738;-48594
01.05.08;WA82;Werkzeuge, Schneidwaren, Essbestecke;519371;325980;193391
01.05.08;WA83;Verschiedene Waren aus unedlen Metallen;532132;304959;227173
01.05.08;WA84;Maschinen, Apparate, mechanische Geräte;14929307;8293627;6635680
01.05.08;WA85;Elektrotechnische Erzeugnisse;7956844;6439303;1517541
01.05.08;WA86;Schienenfahrzeuge;267484;120486;146998
01.05.08;WA87;Kraftfahrzeuge, Landfahrzeuge;13232406;5973076;7259330
01.05.08;WA88;Luftfahrzeuge, Raumfahrzeuge;1463619;989121;474498
01.05.08;WA89;Wasserfahrzeuge;533364;550539;-17175
01.05.08;WA90;Optische, photografische usw. Erzeugnisse;2956599;1705484;1251115
01.05.08;WA91;Uhrmacherwaren;67940;100850;-32910
01.05.08;WA92;Musikinstrumente;30591;29998;593
01.05.08;WA93;Waffen und Munition;27246;11651;15595
01.05.08;WA94;Möbel, Beleuchtungskörper usw.;995827;990676;5151
01.05.08;WA95;Spielzeug, Spiele usw., Sportgeräte;188799;476606;-287807
01.05.08;WA96;Verschiedene Waren;156555;102238;54317
01.05.08;WA97;Kunstgegenstände, Sammlungsstücke;45911;31956;13955
01.05.08;WA98;Vollständige Fabrikationsanlagen;319188;3007;316181
01.05.08;WA99;Zusammenstellungen verschiedener Waren;1306274;888689;417585
01.05.09;WA01;Lebende Tiere;80263;157769;-77506
01.05.09;WA02;Fleisch;490837;377969;112868
01.05.09;WA03;Fische, Krebs- und Weichtiere;76624;195525;-118901
01.05.09;WA04;Milch, Milcherzeugnisse, Eier, Honig;476109;378673;97436
01.05.09;WA05;Andere Waren tierischen Ursprungs;39937;51567;-11630
01.05.09;WA06;Pflanzen, Waren des Blumenhandels;56376;255559;-199183
01.05.09;WA07;Gemüse, Pflanzen für Ernährung;68636;417662;-349026
01.05.09;WA08;Geniessbare Früchte und Nüsse;101695;487844;-386149
01.05.09;WA09;Kaffee, Tee, Mate, Gewürze;125534;186210;-60676
01.05.09;WA10;Getreide;179087;163290;15797
01.05.09;WA11;Müllereierzeugnisse, Malz usw.;71282;33012;38270
01.05.09;WA12;Ölsamen usw., Heilpflanzen usw.;50655;257157;-206502
01.05.09;WA13;Schellack, Gummen, Harz, Pflanzensaft;34744;24043;10701
01.05.09;WA14;Flechtstoffe usw. pflanzlichen Ursprungs;777;1734;-957
01.05.09;WA15;Tierische und pflanzliche Fette, Öle, Wachs;131314;178953;-47639
01.05.09;WA16;Zubereitungen von Fleisch, Fisch usw.;182185;149664;32521
01.05.09;WA17;Zucker und Zuckerwaren;109028;106747;2281
01.05.09;WA18;Kakao und Zubereitungen aus Kakao;150771;158287;-7516
01.05.09;WA19;Zubereitungen aus Getreide usw., Backwaren;325358;195930;129428
01.05.09;WA20;Zubereitungen von Gemüse, Früchten usw.;177951;274713;-96762
01.05.09;WA21;Verschiedene Lebensmittelzubereitungen;331248;211697;119551
01.05.09;WA22;Getränke, alkoholhaltige Flüssigkeiten, Essig;320391;410709;-90318
01.05.09;WA23;Rückstände der Lebensmittelindustrie, Futter;194701;211922;-17221
01.05.09;WA24;Tabak;301156;119779;181377
01.05.09;WA25;Salz, Schwefel, Steine, Erden usw.;155019;100974;54045
01.05.09;WA26;Erze, Schlacken, Aschen;13837;236182;-222345
01.05.09;WA27;Mineralische Brennstoffe usw.;1249277;5812071;-4562794
01.05.09;WA28;Anorganische chemische Erzeugnisse;467090;327917;139173
01.05.09;WA29;Organische chemische Erzeugnisse;1381174;1473583;-92409
01.05.09;WA30;Pharmazeutische Erzeugnisse;3504555;2499402;1005153
01.05.09;WA31;Düngemittel;155285;50596;104689
01.05.09;WA32;Gerb- und Farbstoffe, Farben, Lacke usw.;580768;239685;341083
01.05.09;WA33;Etherische Öle, Riech-, Schönheitsmittel;475750;274616;201134
01.05.09;WA34;Seifen, Waschmittel usw.;353534;174157;179377
01.05.09;WA35;Eiweissstoffe, Klebstoffe, Enzyme;149721;108790;40931
01.05.09;WA36;Sprengstoffe, pyrotechnische Artikel usw.;11096;11044;52
01.05.09;WA37;Photochemische Erzeugnisse;89801;68333;21468
01.05.09;WA38;Verschiedene Erzeugnisse der Chemischen Industrie;948711;669264;279447
01.05.09;WA39;Kunststoffe und Waren daraus;2911941;1656869;1255072
01.05.09;WA40;Kautschuk und Waren daraus;676778;573744;103034
01.05.09;WA41;Häute, Felle, Leder;45023;44636;387
01.05.09;WA42;Lederwaren, Sattlerwaren;83249;166586;-83337
01.05.09;WA43;Pelzfelle, künstliches Pelzwerk;9973;10245;-272
01.05.09;WA44;Holz, Holzwaren, Holzkohle;483046;369618;113428
01.05.09;WA45;Kork, Korkwaren;2676;7393;-4717
01.05.09;WA46;Flechtwaren, Korbmacherwaren;3272;9777;-6505
01.05.09;WA47;Halbstoffe aus Holz usw., Papierabfall;75699;170197;-94498
01.05.09;WA48;Papier, Pappe und Waren daraus;1179242;830335;348907
01.05.09;WA49;Bücher, Zeitungen, Bilddrucke usw.;302800;138843;163957
01.05.09;WA50;Seide;4678;4460;218
01.05.09;WA51;Wolle, feine und grobe Tierhaare;58875;55262;3613
01.05.09;WA52;Baumwolle;67241;61696;5545
01.05.09;WA53;Andere pflanzliche Spinnstoffe, Papiergarn;2587;4086;-1499
01.05.09;WA54;Synthetisches oder künstliches Filament;134642;85529;49113
01.05.09;WA55;Synthetische oder künstliche Spinnfaser;132314;85173;47141
01.05.09;WA56;Watte, Filz, Vliesstoff usw., Tauwerk;132823;71365;61458
01.05.09;WA57;Teppiche, Fussbodenbelag aus Spinnstoff;31530;75447;-43917
01.05.09;WA58;Spezialgewebe, Spitzen, Tapisserien;35157;22988;12169
01.05.09;WA59;Getränkte, bestrichene usw. Gewebe;107234;61843;45391
01.05.09;WA60;Gewirke und Gestricke;62972;32668;30304
01.05.09;WA61;Bekleidung usw. aus Gewirken, Gestricken;309300;683918;-374618
01.05.09;WA62;Andere Bekleidung, Bekleidungszubehör;359852;753909;-394057
01.05.09;WA63;Andere Konfektion, Spinnstoffwaren usw.;130708;186749;-56041
01.05.09;WA64;Schuhe, Gamaschen, ähnliche Waren;146657;335699;-189042
01.05.09;WA65;Kopfbedeckungen und Teile davon;14081;22937;-8856
01.05.09;WA66;Schirme, Gehstöcke usw., Peitschen;13103;13329;-226
01.05.09;WA67;Zugerichtete Federn, Daunen, künstliche Blumen;4722;10210;-5488
01.05.09;WA68;Waren aus Steinen, Gips, Zement usw.;205531;144770;60761
01.05.09;WA69;Keramische Waren;190460;142197;48263
01.05.09;WA70;Glas und Glaswaren;347755;266597;81158
01.05.09;WA71;Perlen, Edelsteine, Edelmetalle;598605;703892;-105287
01.05.09;WA72;Eisen und Stahl;1267074;1020507;246567
01.05.09;WA73;Waren aus Eisen oder Stahl;1616029;889476;726553
01.05.09;WA74;Kupfer und Waren daraus;528373;394760;133613
01.05.09;WA75;Nickel und Waren daraus;49002;46497;2505
01.05.09;WA76;Aluminium und Waren daraus;694730;589545;105185
01.05.09;WA78;Blei und Waren daraus;27262;9657;17605
01.05.09;WA79;Zink und Waren daraus;34154;46653;-12499
01.05.09;WA80;Zinn und Waren daraus;5334;14998;-9664
01.05.09;WA81;Andere unedle Metalle, Cermets usw.;50121;55608;-5487
01.05.09;WA82;Werkzeuge, Schneidwaren, Essbestecke;353929;204565;149364
01.05.09;WA83;Verschiedene Waren aus unedlen Metallen;391405;227864;163541
01.05.09;WA84;Maschinen, Apparate, mechanische Geräte;10810820;6229693;4581127
01.05.09;WA85;Elektrotechnische Erzeugnisse;5933575;5151961;781614
01.05.09;WA86;Schienenfahrzeuge;354303;125156;229147
01.05.09;WA87;Kraftfahrzeuge, Landfahrzeuge;8822942;4770989;4051953
01.05.09;WA88;Luftfahrzeuge, Raumfahrzeuge;2025346;1565056;460290
01.05.09;WA89;Wasserfahrzeuge;25910;58325;-32415
01.05.09;WA90;Optische, photografische usw. Erzeugnisse;2535946;1525808;1010138
01.05.09;WA91;Uhrmacherwaren;71237;87117;-15880
01.05.09;WA92;Musikinstrumente;26100;30081;-3981
01.05.09;WA93;Waffen und Munition;24056;10929;13127
01.05.09;WA94;Möbel, Beleuchtungskörper usw.;786222;852334;-66112
01.05.09;WA95;Spielzeug, Spiele usw., Sportgeräte;317802;498079;-180277
01.05.09;WA96;Verschiedene Waren;139671;94542;45129
01.05.09;WA97;Kunstgegenstände, Sammlungsstücke;38946;37730;1216
01.05.09;WA98;Vollständige Fabrikationsanlagen;267138;1347;265791
01.05.09;WA99;Zusammenstellungen verschiedener Waren;978434;930318;48116
01.05.10;WA01;Lebende Tiere;88857;134398;-45541
01.05.10;WA02;Fleisch;478782;429791;48991
01.05.10;WA03;Fische, Krebs- und Weichtiere;81788;211615;-129827
01.05.10;WA04;Milch, Milcherzeugnisse, Eier, Honig;581599;500436;81163
01.05.10;WA05;Andere Waren tierischen Ursprungs;50328;56460;-6132
01.05.10;WA06;Pflanzen, Waren des Blumenhandels;58058;326858;-268800
01.05.10;WA07;Gemüse, Pflanzen für Ernährung;83934;503560;-419626
01.05.10;WA08;Geniessbare Früchte und Nüsse;111096;517007;-405911
01.05.10;WA09;Kaffee, Tee, Mate, Gewürze;134275;234791;-100516
01.05.10;WA10;Getreide;150167;107008;43159
01.05.10;WA11;Müllereierzeugnisse, Malz usw.;73217;32002;41215
01.05.10;WA12;Ölsamen usw., Heilpflanzen usw.;54247;249184;-194937
01.05.10;WA13;Schellack, Gummen, Harz, Pflanzensaft;37139;34904;2235
01.05.10;WA14;Flechtstoffe usw. pflanzlichen Ursprungs;765;2890;-2125
01.05.10;WA15;Tierische und pflanzliche Fette, Öle, Wachs;144935;198705;-53770
01.05.10;WA16;Zubereitungen von Fleisch, Fisch usw.;201021;160077;40944
01.05.10;WA17;Zucker und Zuckerwaren;115204;94599;20605
01.05.10;WA18;Kakao und Zubereitungen aus Kakao;195500;209534;-14034
01.05.10;WA19;Zubereitungen aus Getreide usw., Backwaren;327173;199079;128094
01.05.10;WA20;Zubereitungen von Gemüse, Früchten usw.;161346;274318;-112972
01.05.10;WA21;Verschiedene Lebensmittelzubereitungen;324231;227880;96351
01.05.10;WA22;Getränke, alkoholhaltige Flüssigkeiten, Essig;389958;441026;-51068
01.05.10;WA23;Rückstände der Lebensmittelindustrie, Futter;208759;233047;-24288
01.05.10;WA24;Tabak;317215;122832;194383
01.05.10;WA25;Salz, Schwefel, Steine, Erden usw.;168898;146286;22612
01.05.10;WA26;Erze, Schlacken, Aschen;25082;646080;-620998
01.05.10;WA27;Mineralische Brennstoffe usw.;1659905;7985796;-6325891
01.05.10;WA28;Anorganische chemische Erzeugnisse;637713;447263;190450
01.05.10;WA29;Organische chemische Erzeugnisse;1744205;1906775;-162570
01.05.10;WA30;Pharmazeutische Erzeugnisse;4026222;2667234;1358988
01.05.10;WA31;Düngemittel;151920;76768;75152
01.05.10;WA32;Gerb- und Farbstoffe, Farben, Lacke usw.;705901;343919;361982
01.05.10;WA33;Etherische Öle, Riech-, Schönheitsmittel;566871;327432;239439
01.05.10;WA34;Seifen, Waschmittel usw.;418949;222518;196431
01.05.10;WA35;Eiweissstoffe, Klebstoffe, Enzyme;189319;128448;60871
01.05.10;WA36;Sprengstoffe, pyrotechnische Artikel usw.;17476;14213;3263
01.05.10;WA37;Photochemische Erzeugnisse;90462;65582;24880
01.05.10;WA38;Verschiedene Erzeugnisse der Chemischen Industrie;1254112;871339;382773
01.05.10;WA39;Kunststoffe und Waren daraus;3827030;2393534;1433496
01.05.10;WA40;Kautschuk und Waren daraus;933580;854135;79445
01.05.10;WA41;Häute, Felle, Leder;81332;81062;270
01.05.10;WA42;Lederwaren, Sattlerwaren;90722;192900;-102178
01.05.10;WA43;Pelzfelle, künstliches Pelzwerk;12494;9897;2597
01.05.10;WA44;Holz, Holzwaren, Holzkohle;567326;509066;58260
01.05.10;WA45;Kork, Korkwaren;2872;10181;-7309
01.05.10;WA46;Flechtwaren, Korbmacherwaren;3427;9993;-6566
01.05.10;WA47;Halbstoffe aus Holz usw., Papierabfall;88590;317189;-228599
01.05.10;WA48;Papier, Pappe und Waren daraus;1495386;917410;577976
01.05.10;WA49;Bücher, Zeitungen, Bilddrucke usw.;323050;152926;170124
01.05.10;WA50;Seide;6105;6017;88
01.05.10;WA51;Wolle, feine und grobe Tierhaare;73751;68616;5135
01.05.10;WA52;Baumwolle;87018;78692;8326
01.05.10;WA53;Andere pflanzliche Spinnstoffe, Papiergarn;2723;4645;-1922
01.05.10;WA54;Synthetisches oder künstliches Filament;165229;126160;39069
01.05.10;WA55;Synthetische oder künstliche Spinnfaser;159284;115664;43620
01.05.10;WA56;Watte, Filz, Vliesstoff usw., Tauwerk;159127;85024;74103
01.05.10;WA57;Teppiche, Fussbodenbelag aus Spinnstoff;36668;80448;-43780
01.05.10;WA58;Spezialgewebe, Spitzen, Tapisserien;39936;26994;12942
01.05.10;WA59;Getränkte, bestrichene usw. Gewebe;152114;88222;63892
01.05.10;WA60;Gewirke und Gestricke;79067;38332;40735
01.05.10;WA61;Bekleidung usw. aus Gewirken, Gestricken;348713;773515;-424802
01.05.10;WA62;Andere Bekleidung, Bekleidungszubehör;365293;789037;-423744
01.05.10;WA63;Andere Konfektion, Spinnstoffwaren usw.;141663;232887;-91224
01.05.10;WA64;Schuhe, Gamaschen, ähnliche Waren;182270;361546;-179276
01.05.10;WA65;Kopfbedeckungen und Teile davon;17913;26472;-8559
01.05.10;WA66;Schirme, Gehstöcke usw., Peitschen;8095;13973;-5878
01.05.10;WA67;Zugerichtete Federn, Daunen, künstliche Blumen;4237;9430;-5193
01.05.10;WA68;Waren aus Steinen, Gips, Zement usw.;275595;186541;89054
01.05.10;WA69;Keramische Waren;224083;172846;51237
01.05.10;WA70;Glas und Glaswaren;408161;333607;74554
01.05.10;WA71;Perlen, Edelsteine, Edelmetalle;902918;1801254;-898336
01.05.10;WA72;Eisen und Stahl;2011694;1979818;31876
01.05.10;WA73;Waren aus Eisen oder Stahl;1849596;1190994;658602
01.05.10;WA74;Kupfer und Waren daraus;851100;826851;24249
01.05.10;WA75;Nickel und Waren daraus;61430;140774;-79344
01.05.10;WA76;Aluminium und Waren daraus;819950;1021304;-201354
01.05.10;WA78;Blei und Waren daraus;36599;41297;-4698
01.05.10;WA79;Zink und Waren daraus;51262;99643;-48381
01.05.10;WA80;Zinn und Waren daraus;8002;21936;-13934
01.05.10;WA81;Andere unedle Metalle, Cermets usw.;80581;91879;-11298
01.05.10;WA82;Werkzeuge, Schneidwaren, Essbestecke;467412;268344;199068
01.05.10;WA83;Verschiedene Waren aus unedlen Metallen;479119;297099;182020
01.05.10;WA84;Maschinen, Apparate, mechanische Geräte;13003278;7657768;5345510
01.05.10;WA85;Elektrotechnische Erzeugnisse;7638436;7957430;-318994
01.05.10;WA86;Schienenfahrzeuge;363483;147602;215881
01.05.10;WA87;Kraftfahrzeuge, Landfahrzeuge;12753431;4934141;7819290
01.05.10;WA88;Luftfahrzeuge, Raumfahrzeuge;2157345;1308080;849265
01.05.10;WA89;Wasserfahrzeuge;72720;1312920;-1240200
01.05.10;WA90;Optische, photografische usw. Erzeugnisse;3304733;1918774;1385959
01.05.10;WA91;Uhrmacherwaren;95201;97632;-2431
01.05.10;WA92;Musikinstrumente;30549;31341;-792
01.05.10;WA93;Waffen und Munition;35465;13623;21842
01.05.10;WA94;Möbel, Beleuchtungskörper usw.;913643;1034809;-121166
01.05.10;WA95;Spielzeug, Spiele usw., Sportgeräte;300823;372938;-72115
01.05.10;WA96;Verschiedene Waren;157456;104358;53098
01.05.10;WA97;Kunstgegenstände, Sammlungsstücke;45253;33250;12003
01.05.10;WA98;Vollständige Fabrikationsanlagen;325060;2021;323039
01.05.10;WA99;Zusammenstellungen verschiedener Waren;985396;922374;63022
01.05.11;WA01;Lebende Tiere;102711;136533;-33822
01.05.11;WA02;Fleisch;616591;493778;122813
01.05.11;WA03;Fische, Krebs- und Weichtiere;95487;249328;-153841
01.05.11;WA04;Milch, Milcherzeugnisse, Eier, Honig;637465;487597;149868
01.05.11;WA05;Andere Waren tierischen Ursprungs;55095;67434;-12339
01.05.11;WA06;Pflanzen, Waren des Blumenhandels;83453;326618;-243165
01.05.11;WA07;Gemüse, Pflanzen für Ernährung;89513;439191;-349678
01.05.11;WA08;Geniessbare Früchte und Nüsse;108247;535315;-427068
01.05.11;WA09;Kaffee, Tee, Mate, Gewürze;172798;395159;-222361
01.05.11;WA10;Getreide;201330;180712;20618
01.05.11;WA11;Müllereierzeugnisse, Malz usw.;85703;45183;40520
01.05.11;WA12;Ölsamen usw., Heilpflanzen usw.;67811;341324;-273513
01.05.11;WA13;Schellack, Gummen, Harz, Pflanzensaft;40830;38564;2266
01.05.11;WA14;Flechtstoffe usw. pflanzlichen Ursprungs;1018;2619;-1601
01.05.11;WA15;Tierische und pflanzliche Fette, Öle, Wachs;199670;420994;-221324
01.05.11;WA16;Zubereitungen von Fleisch, Fisch usw.;203954;172123;31831
01.05.11;WA17;Zucker und Zuckerwaren;142128;118921;23207
01.05.11;WA18;Kakao und Zubereitungen aus Kakao;199972;216371;-16399
01.05.11;WA19;Zubereitungen aus Getreide usw., Backwaren;354511;214444;140067
01.05.11;WA20;Zubereitungen von Gemüse, Früchten usw.;170381;349502;-179121
01.05.11;WA21;Verschiedene Lebensmittelzubereitungen;349059;201982;147077
01.05.11;WA22;Getränke, alkoholhaltige Flüssigkeiten, Essig;440025;531512;-91487
01.05.11;WA23;Rückstände der Lebensmittelindustrie, Futter;227995;278881;-50886
01.05.11;WA24;Tabak;369926;150565;219361
01.05.11;WA25;Salz, Schwefel, Steine, Erden usw.;188565;162891;25674
01.05.11;WA26;Erze, Schlacken, Aschen;30835;822121;-791286
01.05.11;WA27;Mineralische Brennstoffe usw.;2096038;9688934;-7592896
01.05.11;WA28;Anorganische chemische Erzeugnisse;733212;560349;172863
01.05.11;WA29;Organische chemische Erzeugnisse;1998096;2048385;-50289
01.05.11;WA30;Pharmazeutische Erzeugnisse;4287122;3198559;1088563
01.05.11;WA31;Düngemittel;175944;144224;31720
01.05.11;WA32;Gerb- und Farbstoffe, Farben, Lacke usw.;838994;432957;406037
01.05.11;WA33;Etherische Öle, Riech-, Schönheitsmittel;647236;369533;277703
01.05.11;WA34;Seifen, Waschmittel usw.;505146;266075;239071
01.05.11;WA35;Eiweissstoffe, Klebstoffe, Enzyme;224556;156759;67797
01.05.11;WA36;Sprengstoffe, pyrotechnische Artikel usw.;18841;15889;2952
01.05.11;WA37;Photochemische Erzeugnisse;87918;65245;22673
01.05.11;WA38;Verschiedene Erzeugnisse der Chemischen Industrie;1556396;1115377;441019
01.05.11;WA39;Kunststoffe und Waren daraus;4525498;2821209;1704289
01.05.11;WA40;Kautschuk und Waren daraus;1192386;1232061;-39675
01.05.11;WA41;Häute, Felle, Leder;88224;91698;-3474
01.05.11;WA42;Lederwaren, Sattlerwaren;117442;234034;-116592
01.05.11;WA43;Pelzfelle, künstliches Pelzwerk;11376;16802;-5426
01.05.11;WA44;Holz, Holzwaren, Holzkohle;609393;577350;32043
01.05.11;WA45;Kork, Korkwaren;3715;8954;-5239
01.05.11;WA46;Flechtwaren, Korbmacherwaren;3175;10908;-7733
01.05.11;WA47;Halbstoffe aus Holz usw., Papierabfall;116635;339204;-222569
01.05.11;WA48;Papier, Pappe und Waren daraus;1638646;1018755;619891
01.05.11;WA49;Bücher, Zeitungen, Bilddrucke usw.;331615;174150;157465
01.05.11;WA50;Seide;7206;7973;-767
01.05.11;WA51;Wolle, feine und grobe Tierhaare;77679;95639;-17960
01.05.11;WA52;Baumwolle;111557;121935;-10378
01.05.11;WA53;Andere pflanzliche Spinnstoffe, Papiergarn;3419;6626;-3207
01.05.11;WA54;Synthetisches oder künstliches Filament;190680;136352;54328
01.05.11;WA55;Synthetische oder künstliche Spinnfaser;188818;149643;39175
01.05.11;WA56;Watte, Filz, Vliesstoff usw., Tauwerk;191263;110216;81047
01.05.11;WA57;Teppiche, Fussbodenbelag aus Spinnstoff;43778;76671;-32893
01.05.11;WA58;Spezialgewebe, Spitzen, Tapisserien;47476;30390;17086
01.05.11;WA59;Getränkte, bestrichene usw. Gewebe;174799;94634;80165
01.05.11;WA60;Gewirke und Gestricke;88875;44828;44047
01.05.11;WA61;Bekleidung usw. aus Gewirken, Gestricken;438075;957985;-519910
01.05.11;WA62;Andere Bekleidung, Bekleidungszubehör;478951;999571;-520620
01.05.11;WA63;Andere Konfektion, Spinnstoffwaren usw.;182965;306513;-123548
01.05.11;WA64;Schuhe, Gamaschen, ähnliche Waren;242131;492832;-250701
01.05.11;WA65;Kopfbedeckungen und Teile davon;19246;32295;-13049
01.05.11;WA66;Schirme, Gehstöcke usw., Peitschen;7871;20093;-12222
01.05.11;WA67;Zugerichtete Federn, Daunen, künstliche Blumen;5049;10383;-5334
01.05.11;WA68;Waren aus Steinen, Gips, Zement usw.;339461;227717;111744
01.05.11;WA69;Keramische Waren;257913;190817;67096
01.05.11;WA70;Glas und Glaswaren;465068;357516;107552
01.05.11;WA71;Perlen, Edelsteine, Edelmetalle;1314580;1279691;34889
01.05.11;WA72;Eisen und Stahl;2292124;2490578;-198454
01.05.11;WA73;Waren aus Eisen oder Stahl;2234233;1537527;696706
01.05.11;WA74;Kupfer und Waren daraus;1058478;1041392;17086
01.05.11;WA75;Nickel und Waren daraus;81086;228863;-147777
01.05.11;WA76;Aluminium und Waren daraus;1197063;1272171;-75108
01.05.11;WA78;Blei und Waren daraus;44054;38695;5359
01.05.11;WA79;Zink und Waren daraus;58606;100431;-41825
01.05.11;WA80;Zinn und Waren daraus;14254;38576;-24322
01.05.11;WA81;Andere unedle Metalle, Cermets usw.;121753;143835;-22082
01.05.11;WA82;Werkzeuge, Schneidwaren, Essbestecke;532136;345190;186946
01.05.11;WA83;Verschiedene Waren aus unedlen Metallen;568280;353101;215179
01.05.11;WA84;Maschinen, Apparate, mechanische Geräte;16300796;9295759;7005037
01.05.11;WA85;Elektrotechnische Erzeugnisse;9130811;8461205;669606
01.05.11;WA86;Schienenfahrzeuge;317729;149487;168242
01.05.11;WA87;Kraftfahrzeuge, Landfahrzeuge;16292790;6344299;9948491
01.05.11;WA88;Luftfahrzeuge, Raumfahrzeuge;2254547;1758392;496155
01.05.11;WA89;Wasserfahrzeuge;270809;779394;-508585
01.05.11;WA90;Optische, photografische usw. Erzeugnisse;4016573;2216183;1800390
01.05.11;WA91;Uhrmacherwaren;128156;147403;-19247
01.05.11;WA92;Musikinstrumente;43528;40381;3147
01.05.11;WA93;Waffen und Munition;36919;17212;19707
01.05.11;WA94;Möbel, Beleuchtungskörper usw.;1140771;1187054;-46283
01.05.11;WA95;Spielzeug, Spiele usw., Sportgeräte;351924;428514;-76590
01.05.11;WA96;Verschiedene Waren;178760;122964;55796
01.05.11;WA97;Kunstgegenstände, Sammlungsstücke;53401;31171;22230
01.05.11;WA98;Vollständige Fabrikationsanlagen;233998;17284;216714
01.05.11;WA99;Zusammenstellungen verschiedener Waren;1478914;1214176;264738
01.05.12;WA01;Lebende Tiere;101034;164647;-63613
01.05.12;WA02;Fleisch;608974;477563;131411
01.05.12;WA03;Fische, Krebs- und Weichtiere;92165;235884;-143719
01.05.12;WA04;Milch, Milcherzeugnisse, Eier, Honig;692344;528527;163817
01.05.12;WA05;Andere Waren tierischen Ursprungs;71897;83861;-11964
01.05.12;WA06;Pflanzen, Waren des Blumenhandels;86549;333629;-247080
01.05.12;WA07;Gemüse, Pflanzen für Ernährung;73806;494397;-420591
01.05.12;WA08;Geniessbare Früchte und Nüsse;98194;588539;-490345
01.05.12;WA09;Kaffee, Tee, Mate, Gewürze;216689;363876;-147187
01.05.12;WA10;Getreide;184502;185185;-683
01.05.12;WA11;Müllereierzeugnisse, Malz usw.;116094;40128;75966
01.05.12;WA12;Ölsamen usw., Heilpflanzen usw.;61006;471262;-410256
01.05.12;WA13;Schellack, Gummen, Harz, Pflanzensaft;44985;40777;4208
01.05.12;WA14;Flechtstoffe usw. pflanzlichen Ursprungs;946;2630;-1684
01.05.12;WA15;Tierische und pflanzliche Fette, Öle, Wachs;249950;295945;-45995
01.05.12;WA16;Zubereitungen von Fleisch, Fisch usw.;221092;199029;22063
01.05.12;WA17;Zucker und Zuckerwaren;160817;124641;36176
01.05.12;WA18;Kakao und Zubereitungen aus Kakao;258039;215429;42610
01.05.12;WA19;Zubereitungen aus Getreide usw., Backwaren;393400;244999;148401
01.05.12;WA20;Zubereitungen von Gemüse, Früchten usw.;199330;363978;-164648
01.05.12;WA21;Verschiedene Lebensmittelzubereitungen;440318;234095;206223
01.05.12;WA22;Getränke, alkoholhaltige Flüssigkeiten, Essig;426316;546102;-119786
01.05.12;WA23;Rückstände der Lebensmittelindustrie, Futter;274110;288673;-14563
01.05.12;WA24;Tabak;346703;156800;189903
01.05.12;WA25;Salz, Schwefel, Steine, Erden usw.;181994;160215;21779
01.05.12;WA26;Erze, Schlacken, Aschen;28595;748567;-719972
01.05.12;WA27;Mineralische Brennstoffe usw.;2306866;10475332;-8168466
01.05.12;WA28;Anorganische chemische Erzeugnisse;742786;690302;52484
01.05.12;WA29;Organische chemische Erzeugnisse;2057360;2185387;-128027
01.05.12;WA30;Pharmazeutische Erzeugnisse;4612363;2934482;1677881
01.05.12;WA31;Düngemittel;274435;128440;145995
01.05.12;WA32;Gerb- und Farbstoffe, Farben, Lacke usw.;881226;435036;446190
01.05.12;WA33;Etherische Öle, Riech-, Schönheitsmittel;669778;383466;286312
01.05.12;WA34;Seifen, Waschmittel usw.;530180;256100;274080
01.05.12;WA35;Eiweissstoffe, Klebstoffe, Enzyme;234482;159726;74756
01.05.12;WA36;Sprengstoffe, pyrotechnische Artikel usw.;19730;15554;4176
01.05.12;WA37;Photochemische Erzeugnisse;86731;64423;22308
01.05.12;WA38;Verschiedene Erzeugnisse der Chemischen Industrie;1533963;1067760;466203
01.05.12;WA39;Kunststoffe und Waren daraus;4379116;2723937;1655179
01.05.12;WA40;Kautschuk und Waren daraus;1199112;1120228;78884
01.05.12;WA41;Häute, Felle, Leder;96312;82565;13747
01.05.12;WA42;Lederwaren, Sattlerwaren;108436;236734;-128298
01.05.12;WA43;Pelzfelle, künstliches Pelzwerk;14802;14891;-89
01.05.12;WA44;Holz, Holzwaren, Holzkohle;588911;565722;23189
01.05.12;WA45;Kork, Korkwaren;2999;10324;-7325
01.05.12;WA46;Flechtwaren, Korbmacherwaren;3527;11759;-8232
01.05.12;WA47;Halbstoffe aus Holz usw., Papierabfall;99292;297490;-198198
01.05.12;WA48;Papier, Pappe und Waren daraus;1510759;981914;528845
01.05.12;WA49;Bücher, Zeitungen, Bilddrucke usw.;305464;160915;144549
01.05.12;WA50;Seide;7230;6741;489
01.05.12;WA51;Wolle, feine und grobe Tierhaare;70401;81859;-11458
01.05.12;WA52;Baumwolle;94702;87427;7275
01.05.12;WA53;Andere pflanzliche Spinnstoffe, Papiergarn;3012;5761;-2749
01.05.12;WA54;Synthetisches oder künstliches Filament;166316;127785;38531
01.05.12;WA55;Synthetische oder künstliche Spinnfaser;171950;138433;33517
01.05.12;WA56;Watte, Filz, Vliesstoff usw., Tauwerk;188007;102940;85067
01.05.12;WA57;Teppiche, Fussbodenbelag aus Spinnstoff;42629;80915;-38286
01.05.12;WA58;Spezialgewebe, Spitzen, Tapisserien;42029;29390;12639
01.05.12;WA59;Getränkte, bestrichene usw. Gewebe;181237;98449;82788
01.05.12;WA60;Gewirke und Gestricke;72830;45243;27587
01.05.12;WA61;Bekleidung usw. aus Gewirken, Gestricken;400619;842280;-441661
01.05.12;WA62;Andere Bekleidung, Bekleidungszubehör;426826;880742;-453916
01.05.12;WA63;Andere Konfektion, Spinnstoffwaren usw.;183847;270209;-86362
01.05.12;WA64;Schuhe, Gamaschen, ähnliche Waren;197601;463342;-265741
01.05.12;WA65;Kopfbedeckungen und Teile davon;18964;29449;-10485
01.05.12;WA66;Schirme, Gehstöcke usw., Peitschen;7757;13286;-5529
01.05.12;WA67;Zugerichtete Federn, Daunen, künstliche Blumen;6475;11549;-5074
01.05.12;WA68;Waren aus Steinen, Gips, Zement usw.;310338;235611;74727
01.05.12;WA69;Keramische Waren;247257;197391;49866
01.05.12;WA70;Glas und Glaswaren;429007;337610;91397
01.05.12;WA71;Perlen, Edelsteine, Edelmetalle;1248366;1288513;-40147
01.05.12;WA72;Eisen und Stahl;2187607;2215229;-27622
01.05.12;WA73;Waren aus Eisen oder Stahl;2123879;1485749;638130
01.05.12;WA74;Kupfer und Waren daraus;1055199;1012888;42311
01.05.12;WA75;Nickel und Waren daraus;94228;159663;-65435
01.05.12;WA76;Aluminium und Waren daraus;1055889;1162275;-106386
01.05.12;WA78;Blei und Waren daraus;27750;28996;-1246
01.05.12;WA79;Zink und Waren daraus;58931;92566;-33635
01.05.12;WA80;Zinn und Waren daraus;10903;41662;-30759
01.05.12;WA81;Andere unedle Metalle, Cermets usw.;123474;142033;-18559
01.05.12;WA82;Werkzeuge, Schneidwaren, Essbestecke;558486;350191;208295
01.05.12;WA83;Verschiedene Waren aus unedlen Metallen;558243;340876;217367
01.05.12;WA84;Maschinen, Apparate, mechanische Geräte;16023670;9241037;6782633
01.05.12;WA85;Elektrotechnische Erzeugnisse;9104201;8465844;638357
01.05.12;WA86;Schienenfahrzeuge;242585;128958;113627
01.05.12;WA87;Kraftfahrzeuge, Landfahrzeuge;15429933;6396403;9033530
01.05.12;WA88;Luftfahrzeuge, Raumfahrzeuge;2849412;1758908;1090504
01.05.12;WA89;Wasserfahrzeuge;687602;356330;331272
01.05.12;WA90;Optische, photografische usw. Erzeugnisse;4075562;2245691;1829871
01.05.12;WA91;Uhrmacherwaren;159354;174752;-15398
01.05.12;WA92;Musikinstrumente;42205;42599;-394
01.05.12;WA93;Waffen und Munition;37490;19572;17918
01.05.12;WA94;Möbel, Beleuchtungskörper usw.;1129579;1179505;-49926
01.05.12;WA95;Spielzeug, Spiele usw., Sportgeräte;342151;327307;14844
01.05.12;WA96;Verschiedene Waren;287943;189632;98311
01.05.12;WA97;Kunstgegenstände, Sammlungsstücke;67404;34828;32576
01.05.12;WA98;Vollständige Fabrikationsanlagen;304124;2607;301517
01.05.12;WA99;Zusammenstellungen verschiedener Waren;1401676;894823;506853
01.05.13;WA01;Lebende Tiere;127279;152987;-25708
01.05.13;WA02;Fleisch;617493;474298;143195
01.05.13;WA03;Fische, Krebs- und Weichtiere;110747;257469;-146722
01.05.13;WA04;Milch, Milcherzeugnisse, Eier, Honig;781106;536365;244741
01.05.13;WA05;Andere Waren tierischen Ursprungs;72243;75604;-3361
01.05.13;WA06;Pflanzen, Waren des Blumenhandels;102529;363191;-260662
01.05.13;WA07;Gemüse, Pflanzen für Ernährung;106314;559805;-453491
01.05.13;WA08;Geniessbare Früchte und Nüsse;120240;657398;-537158
01.05.13;WA09;Kaffee, Tee, Mate, Gewürze;173838;305627;-131789
01.05.13;WA10;Getreide;242062;196452;45610
01.05.13;WA11;Müllereierzeugnisse, Malz usw.;107292;43575;63717
01.05.13;WA12;Ölsamen usw., Heilpflanzen usw.;60124;443616;-383492
01.05.13;WA13;Schellack, Gummen, Harz, Pflanzensaft;49248;43806;5442
01.05.13;WA14;Flechtstoffe usw. pflanzlichen Ursprungs;732;2922;-2190
01.05.13;WA15;Tierische und pflanzliche Fette, Öle, Wachs;285832;299263;-13431
01.05.13;WA16;Zubereitungen von Fleisch, Fisch usw.;237204;191757;45447
01.05.13;WA17;Zucker und Zuckerwaren;152879;139364;13515
01.05.13;WA18;Kakao und Zubereitungen aus Kakao;251582;203033;48549
01.05.13;WA19;Zubereitungen aus Getreide usw., Backwaren;427884;289341;138543
01.05.13;WA20;Zubereitungen von Gemüse, Früchten usw.;207851;363469;-155618
01.05.13;WA21;Verschiedene Lebensmittelzubereitungen;423148;226178;196970
01.05.13;WA22;Getränke, alkoholhaltige Flüssigkeiten, Essig;457020;545906;-88886
01.05.13;WA23;Rückstände der Lebensmittelindustrie, Futter;301081;327048;-25967
01.05.13;WA24;Tabak;287071;146960;140111
01.05.13;WA25;Salz, Schwefel, Steine, Erden usw.;178971;139312;39659
01.05.13;WA26;Erze, Schlacken, Aschen;23031;567723;-544692
01.05.13;WA27;Mineralische Brennstoffe usw.;2130762;10396616;-8265854
01.05.13;WA28;Anorganische chemische Erzeugnisse;739775;619402;120373
01.05.13;WA29;Organische chemische Erzeugnisse;1913227;2254273;-341046
01.05.13;WA30;Pharmazeutische Erzeugnisse;4222739;2690490;1532249
01.05.13;WA31;Düngemittel;225752;133896;91856
01.05.13;WA32;Gerb- und Farbstoffe, Farben, Lacke usw.;893299;474543;418756
01.05.13;WA33;Etherische Öle, Riech-, Schönheitsmittel;693986;395316;298670
01.05.13;WA34;Seifen, Waschmittel usw.;530295;250558;279737
01.05.13;WA35;Eiweissstoffe, Klebstoffe, Enzyme;230935;154403;76532
01.05.13;WA36;Sprengstoffe, pyrotechnische Artikel usw.;20768;14361;6407
01.05.13;WA37;Photochemische Erzeugnisse;90591;60502;30089
01.05.13;WA38;Verschiedene Erzeugnisse der Chemischen Industrie;1566563;952113;614450
01.05.13;WA39;Kunststoffe und Waren daraus;4467046;2781583;1685463
01.05.13;WA40;Kautschuk und Waren daraus;1153394;1065670;87724
01.05.13;WA41;Häute, Felle, Leder;90482;77684;12798
01.05.13;WA42;Lederwaren, Sattlerwaren;110160;242427;-132267
01.05.13;WA43;Pelzfelle, künstliches Pelzwerk;16326;16047;279
01.05.13;WA44;Holz, Holzwaren, Holzkohle;585146;571242;13904
01.05.13;WA45;Kork, Korkwaren;1836;5819;-3983
01.05.13;WA46;Flechtwaren, Korbmacherwaren;3146;7792;-4646
01.05.13;WA47;Halbstoffe aus Holz usw., Papierabfall;100837;322383;-221546
01.05.13;WA48;Papier, Pappe und Waren daraus;1432882;904850;528032
01.05.13;WA49;Bücher, Zeitungen, Bilddrucke usw.;322105;148791;173314
01.05.13;WA50;Seide;7158;7326;-168
01.05.13;WA51;Wolle, feine und grobe Tierhaare;52475;59108;-6633
01.05.13;WA52;Baumwolle;83140;82483;657
01.05.13;WA53;Andere pflanzliche Spinnstoffe, Papiergarn;2727;4728;-2001
01.05.13;WA54;Synthetisches oder künstliches Filament;152688;120846;31842
01.05.13;WA55;Synthetische oder künstliche Spinnfaser;168888;135585;33303
01.05.13;WA56;Watte, Filz, Vliesstoff usw., Tauwerk;184044;100963;83081
01.05.13;WA57;Teppiche, Fussbodenbelag aus Spinnstoff;37837;80422;-42585
01.05.13;WA58;Spezialgewebe, Spitzen, Tapisserien;39003;25156;13847
01.05.13;WA59;Getränkte, bestrichene usw. Gewebe;168516;93494;75022
01.05.13;WA60;Gewirke und Gestricke;74181;41518;32663
01.05.13;WA61;Bekleidung usw. aus Gewirken, Gestricken;383255;874773;-491518
01.05.13;WA62;Andere Bekleidung, Bekleidungszubehör;398566;877186;-478620
01.05.13;WA63;Andere Konfektion, Spinnstoffwaren usw.;178959;269508;-90549
01.05.13;WA64;Schuhe, Gamaschen, ähnliche Waren;202329;478889;-276560
01.05.13;WA65;Kopfbedeckungen und Teile davon;17934;25903;-7969
01.05.13;WA66;Schirme, Gehstöcke usw., Peitschen;6681;14882;-8201
01.05.13;WA67;Zugerichtete Federn, Daunen, künstliche Blumen;5994;8495;-2501
01.05.13;WA68;Waren aus Steinen, Gips, Zement usw.;306181;214566;91615
01.05.13;WA69;Keramische Waren;234530;187680;46850
01.05.13;WA70;Glas und Glaswaren;433589;330542;103047
01.05.13;WA71;Perlen, Edelsteine, Edelmetalle;1003501;1473865;-470364
01.05.13;WA72;Eisen und Stahl;1931971;1868281;63690
01.05.13;WA73;Waren aus Eisen oder Stahl;2141762;1400176;741586
01.05.13;WA74;Kupfer und Waren daraus;855913;733056;122857
01.05.13;WA75;Nickel und Waren daraus;86882;128309;-41427
01.05.13;WA76;Aluminium und Waren daraus;1030115;1100505;-70390
01.05.13;WA78;Blei und Waren daraus;32836;23525;9311
01.05.13;WA79;Zink und Waren daraus;50175;85862;-35687
01.05.13;WA80;Zinn und Waren daraus;9100;28660;-19560
01.05.13;WA81;Andere unedle Metalle, Cermets usw.;90654;121150;-30496
01.05.13;WA82;Werkzeuge, Schneidwaren, Essbestecke;527934;314564;213370
01.05.13;WA83;Verschiedene Waren aus unedlen Metallen;549108;312789;236319
01.05.13;WA84;Maschinen, Apparate, mechanische Geräte;15540299;8580544;6959755
01.05.13;WA85;Elektrotechnische Erzeugnisse;8802658;7819675;982983
01.05.13;WA86;Schienenfahrzeuge;309518;169536;139982
01.05.13;WA87;Kraftfahrzeuge, Landfahrzeuge;14343777;6185020;8158757
01.05.13;WA88;Luftfahrzeuge, Raumfahrzeuge;2163777;2179950;-16173
01.05.13;WA89;Wasserfahrzeuge;132328;341837;-209509
01.05.13;WA90;Optische, photografische usw. Erzeugnisse;4125857;2282543;1843314
01.05.13;WA91;Uhrmacherwaren;149826;181440;-31614
01.05.13;WA92;Musikinstrumente;41383;34816;6567
01.05.13;WA93;Waffen und Munition;40844;15742;25102
01.05.13;WA94;Möbel, Beleuchtungskörper usw.;1049424;1144847;-95423
01.05.13;WA95;Spielzeug, Spiele usw., Sportgeräte;251651;298226;-46575
01.05.13;WA96;Verschiedene Waren;283763;185627;98136
01.05.13;WA97;Kunstgegenstände, Sammlungsstücke;47913;33630;14283
01.05.13;WA98;Vollständige Fabrikationsanlagen;239467;1134;238333
01.05.13;WA99;Zusammenstellungen verschiedener Waren;1361969;784787;577182
01.05.14;WA01;Lebende Tiere;135087;160977;-25890
01.05.14;WA02;Fleisch;601482;484037;117445
01.05.14;WA03;Fische, Krebs- und Weichtiere;108600;228217;-119617
01.05.14;WA04;Milch, Milcherzeugnisse, Eier, Honig;796426;565032;231394
01.05.14;WA05;Andere Waren tierischen Ursprungs;65650;76829;-11179
01.05.14;WA06;Pflanzen, Waren des Blumenhandels;85562;299928;-214366
01.05.14;WA07;Gemüse, Pflanzen für Ernährung;96084;441617;-345533
01.05.14;WA08;Geniessbare Früchte und Nüsse;116648;619559;-502911
01.05.14;WA09;Kaffee, Tee, Mate, Gewürze;201493;322435;-120942
01.05.14;WA10;Getreide;258394;183081;75313
01.05.14;WA11;Müllereierzeugnisse, Malz usw.;109618;42947;66671
01.05.14;WA12;Ölsamen usw., Heilpflanzen usw.;64723;297053;-232330
01.05.14;WA13;Schellack, Gummen, Harz, Pflanzensaft;41650;34856;6794
01.05.14;WA14;Flechtstoffe usw. pflanzlichen Ursprungs;632;3337;-2705
01.05.14;WA15;Tierische und pflanzliche Fette, Öle, Wachs;180536;315767;-135231
01.05.14;WA16;Zubereitungen von Fleisch, Fisch usw.;231709;169511;62198
01.05.14;WA17;Zucker und Zuckerwaren;144968;143608;1360
01.05.14;WA18;Kakao und Zubereitungen aus Kakao;272381;251508;20873
01.05.14;WA19;Zubereitungen aus Getreide usw., Backwaren;416840;275990;140850
01.05.14;WA20;Zubereitungen von Gemüse, Früchten usw.;208777;341516;-132739
01.05.14;WA21;Verschiedene Lebensmittelzubereitungen;415324;228025;187299
01.05.14;WA22;Getränke, alkoholhaltige Flüssigkeiten, Essig;447085;528281;-81196
01.05.14;WA23;Rückstände der Lebensmittelindustrie, Futter;289860;306523;-16663
01.05.14;WA24;Tabak;286212;138601;147611
01.05.14;WA25;Salz, Schwefel, Steine, Erden usw.;175574;156069;19505
01.05.14;WA26;Erze, Schlacken, Aschen;29453;550077;-520624
01.05.14;WA27;Mineralische Brennstoffe usw.;1956424;9832577;-7876153
01.05.14;WA28;Anorganische chemische Erzeugnisse;759316;483047;276269
01.05.14;WA29;Organische chemische Erzeugnisse;2103401;2104379;-978
01.05.14;WA30;Pharmazeutische Erzeugnisse;5058369;3052372;2005997
01.05.14;WA31;Düngemittel;185773;117127;68646
01.05.14;WA32;Gerb- und Farbstoffe, Farben, Lacke usw.;903625;484268;419357
01.05.14;WA33;Etherische Öle, Riech-, Schönheitsmittel;688403;419507;268896
01.05.14;WA34;Seifen, Waschmittel usw.;529895;268852;261043
01.05.14;WA35;Eiweissstoffe, Klebstoffe, Enzyme;248521;157610;90911
01.05.14;WA36;Sprengstoffe, pyrotechnische Artikel usw.;15794;11699;4095
01.05.14;WA37;Photochemische Erzeugnisse;88466;56085;32381
01.05.14;WA38;Verschiedene Erzeugnisse der Chemischen Industrie;1505203;997900;507303
01.05.14;WA39;Kunststoffe und Waren daraus;4469330;2856038;1613292
01.05.14;WA40;Kautschuk und Waren daraus;1121232;1002061;119171
01.05.14;WA41;Häute, Felle, Leder;106574;86288;20286
01.05.14;WA42;Lederwaren, Sattlerwaren;123106;250090;-126984
01.05.14;WA43;Pelzfelle, künstliches Pelzwerk;14837;14128;709
01.05.14;WA44;Holz, Holzwaren, Holzkohle;596582;594864;1718
01.05.14;WA45;Kork, Korkwaren;2437;6012;-3575
01.05.14;WA46;Flechtwaren, Korbmacherwaren;3321;8255;-4934
01.05.14;WA47;Halbstoffe aus Holz usw., Papierabfall;89167;273614;-184447
01.05.14;WA48;Papier, Pappe und Waren daraus;1352331;970815;381516
01.05.14;WA49;Bücher, Zeitungen, Bilddrucke usw.;298595;171092;127503
01.05.14;WA50;Seide;6663;6087;576
01.05.14;WA51;Wolle, feine und grobe Tierhaare;46494;53512;-7018
01.05.14;WA52;Baumwolle;82313;79022;3291
01.05.14;WA53;Andere pflanzliche Spinnstoffe, Papiergarn;2724;4438;-1714
01.05.14;WA54;Synthetisches oder künstliches Filament;166257;122762;43495
01.05.14;WA55;Synthetische oder künstliche Spinnfaser;160364;137860;22504
01.05.14;WA56;Watte, Filz, Vliesstoff usw., Tauwerk;191187;102962;88225
01.05.14;WA57;Teppiche, Fussbodenbelag aus Spinnstoff;35942;72504;-36562
01.05.14;WA58;Spezialgewebe, Spitzen, Tapisserien;38489;21550;16939
01.05.14;WA59;Getränkte, bestrichene usw. Gewebe;167982;85572;82410
01.05.14;WA60;Gewirke und Gestricke;73584;41506;32078
01.05.14;WA61;Bekleidung usw. aus Gewirken, Gestricken;439188;937605;-498417
01.05.14;WA62;Andere Bekleidung, Bekleidungszubehör;438133;905042;-466909
01.05.14;WA63;Andere Konfektion, Spinnstoffwaren usw.;184397;275905;-91508
01.05.14;WA64;Schuhe, Gamaschen, ähnliche Waren;250479;517661;-267182
01.05.14;WA65;Kopfbedeckungen und Teile davon;22305;31993;-9688
01.05.14;WA66;Schirme, Gehstöcke usw., Peitschen;8625;18664;-10039
01.05.14;WA67;Zugerichtete Federn, Daunen, künstliche Blumen;6727;8135;-1408
01.05.14;WA68;Waren aus Steinen, Gips, Zement usw.;337344;230079;107265
01.05.14;WA69;Keramische Waren;243056;185628;57428
01.05.14;WA70;Glas und Glaswaren;466002;371090;94912
01.05.14;WA71;Perlen, Edelsteine, Edelmetalle;900588;885918;14670
01.05.14;WA72;Eisen und Stahl;1876809;1984778;-107969
01.05.14;WA73;Waren aus Eisen oder Stahl;2114645;1475442;639203
01.05.14;WA74;Kupfer und Waren daraus;836935;699118;137817
01.05.14;WA75;Nickel und Waren daraus;88118;122827;-34709
01.05.14;WA76;Aluminium und Waren daraus;1055052;1106752;-51700
01.05.14;WA78;Blei und Waren daraus;39130;23414;15716
01.05.14;WA79;Zink und Waren daraus;49193;93158;-43965
01.05.14;WA80;Zinn und Waren daraus;10131;31084;-20953
01.05.14;WA81;Andere unedle Metalle, Cermets usw.;114751;128459;-13708
01.05.14;WA82;Werkzeuge, Schneidwaren, Essbestecke;583463;339421;244042
01.05.14;WA83;Verschiedene Waren aus unedlen Metallen;547861;330891;216970
01.05.14;WA84;Maschinen, Apparate, mechanische Geräte;15742828;9113525;6629303
01.05.14;WA85;Elektrotechnische Erzeugnisse;8684340;7969084;715256
01.05.14;WA86;Schienenfahrzeuge;338749;183746;155003
01.05.14;WA87;Kraftfahrzeuge, Landfahrzeuge;16106810;6858670;9248140
01.05.14;WA88;Luftfahrzeuge, Raumfahrzeuge;2624448;1107629;1516819
01.05.14;WA89;Wasserfahrzeuge;152555;372165;-219610
01.05.14;WA90;Optische, photografische usw. Erzeugnisse;4101577;2297958;1803619
01.05.14;WA91;Uhrmacherwaren;143420;174195;-30775
01.05.14;WA92;Musikinstrumente;39135;36790;2345
01.05.14;WA93;Waffen und Munition;35026;12703;22323
01.05.14;WA94;Möbel, Beleuchtungskörper usw.;1075066;1260003;-184937
01.05.14;WA95;Spielzeug, Spiele usw., Sportgeräte;243847;367004;-123157
01.05.14;WA96;Verschiedene Waren;284984;185841;99143
01.05.14;WA97;Kunstgegenstände, Sammlungsstücke;55069;25088;29981
01.05.14;WA98;Vollständige Fabrikationsanlagen;243705;3531;240174
01.05.14;WA99;Zusammenstellungen verschiedener Waren;1606466;843327;763139
01.05.15;WA01;Lebende Tiere;133104;168867;-35763
01.05.15;WA02;Fleisch;579013;497981;81032
01.05.15;WA03;Fische, Krebs- und Weichtiere;103025;276997;-173972
01.05.15;WA04;Milch, Milcherzeugnisse, Eier, Honig;736881;631016;105865
01.05.15;WA05;Andere Waren tierischen Ursprungs;69796;68901;895
01.05.15;WA06;Pflanzen, Waren des Blumenhandels;89304;302506;-213202
01.05.15;WA07;Gemüse, Pflanzen für Ernährung;91899;515793;-423894
01.05.15;WA08;Geniessbare Früchte und Nüsse;153782;754898;-601116
01.05.15;WA09;Kaffee, Tee, Mate, Gewürze;209993;356916;-146923
01.05.15;WA10;Getreide;331790;176231;155559
01.05.15;WA11;Müllereierzeugnisse, Malz usw.;112669;39588;73081
01.05.15;WA12;Ölsamen usw., Heilpflanzen usw.;66301;348877;-282576
01.05.15;WA13;Schellack, Gummen, Harz, Pflanzensaft;46826;39665;7161
01.05.15;WA14;Flechtstoffe usw. pflanzlichen Ursprungs;791;3719;-2928
01.05.15;WA15;Tierische und pflanzliche Fette, Öle, Wachs;219062;303461;-84399
01.05.15;WA16;Zubereitungen von Fleisch, Fisch usw.;231752;191711;40041
01.05.15;WA17;Zucker und Zuckerwaren;138390;125674;12716
01.05.15;WA18;Kakao und Zubereitungen aus Kakao;334386;299806;34580
01.05.15;WA19;Zubereitungen aus Getreide usw., Backwaren;432272;280566;151706
01.05.15;WA20;Zubereitungen von Gemüse, Früchten usw.;205444;365681;-160237
01.05.15;WA21;Verschiedene Lebensmittelzubereitungen;419337;245698;173639
01.05.15;WA22;Getränke, alkoholhaltige Flüssigkeiten, Essig;472767;524470;-51703
01.05.15;WA23;Rückstände der Lebensmittelindustrie, Futter;299364;296073;3291
01.05.15;WA24;Tabak;361737;135876;225861
01.05.15;WA25;Salz, Schwefel, Steine, Erden usw.;167619;143836;23783
01.05.15;WA26;Erze, Schlacken, Aschen;29211;687583;-658372
01.05.15;WA27;Mineralische Brennstoffe usw.;2264750;7976201;-5711451
01.05.15;WA28;Anorganische chemische Erzeugnisse;672891;523713;149178
01.05.15;WA29;Organische chemische Erzeugnisse;1967370;2167898;-200528
01.05.15;WA30;Pharmazeutische Erzeugnisse;5010257;3065414;1944843
01.05.15;WA31;Düngemittel;194049;106100;87949
01.05.15;WA32;Gerb- und Farbstoffe, Farben, Lacke usw.;866504;455017;411487
01.05.15;WA33;Etherische Öle, Riech-, Schönheitsmittel;664470;480340;184130
01.05.15;WA34;Seifen, Waschmittel usw.;545990;284573;261417
01.05.15;WA35;Eiweissstoffe, Klebstoffe, Enzyme;249610;172718;76892
01.05.15;WA36;Sprengstoffe, pyrotechnische Artikel usw.;18377;15467;2910
01.05.15;WA37;Photochemische Erzeugnisse;89909;58373;31536
01.05.15;WA38;Verschiedene Erzeugnisse der Chemischen Industrie;1654432;985442;668990
01.05.15;WA39;Kunststoffe und Waren daraus;4477920;3027635;1450285
01.05.15;WA40;Kautschuk und Waren daraus;1128349;1097656;30693
01.05.15;WA41;Häute, Felle, Leder;89439;75260;14179
01.05.15;WA42;Lederwaren, Sattlerwaren;125205;301055;-175850
01.05.15;WA43;Pelzfelle, künstliches Pelzwerk;11367;12109;-742
01.05.15;WA44;Holz, Holzwaren, Holzkohle;590775;640283;-49508
01.05.15;WA45;Kork, Korkwaren;2112;8637;-6525
01.05.15;WA46;Flechtwaren, Korbmacherwaren;2938;9334;-6396
01.05.15;WA47;Halbstoffe aus Holz usw., Papierabfall;116848;297383;-180535
01.05.15;WA48;Papier, Pappe und Waren daraus;1354088;971110;382978
01.05.15;WA49;Bücher, Zeitungen, Bilddrucke usw.;317525;171022;146503
01.05.15;WA50;Seide;6103;5394;709
01.05.15;WA51;Wolle, feine und grobe Tierhaare;55291;54627;664
01.05.15;WA52;Baumwolle;77761;75544;2217
01.05.15;WA53;Andere pflanzliche Spinnstoffe, Papiergarn;2493;5200;-2707
01.05.15;WA54;Synthetisches oder künstliches Filament;159323;132592;26731
01.05.15;WA55;Synthetische oder künstliche Spinnfaser;153521;126203;27318
01.05.15;WA56;Watte, Filz, Vliesstoff usw., Tauwerk;186829;111160;75669
01.05.15;WA57;Teppiche, Fussbodenbelag aus Spinnstoff;39417;79281;-39864
01.05.15;WA58;Spezialgewebe, Spitzen, Tapisserien;44450;22035;22415
01.05.15;WA59;Getränkte, bestrichene usw. Gewebe;174529;95547;78982
01.05.15;WA60;Gewirke und Gestricke;70765;43759;27006
01.05.15;WA61;Bekleidung usw. aus Gewirken, Gestricken;452864;984205;-531341
01.05.15;WA62;Andere Bekleidung, Bekleidungszubehör;449161;970580;-521419
01.05.15;WA63;Andere Konfektion, Spinnstoffwaren usw.;204983;284229;-79246
01.05.15;WA64;Schuhe, Gamaschen, ähnliche Waren;280284;620955;-340671
01.05.15;WA65;Kopfbedeckungen und Teile davon;24483;31630;-7147
01.05.15;WA66;Schirme, Gehstöcke usw., Peitschen;9399;19319;-9920
01.05.15;WA67;Zugerichtete Federn, Daunen, künstliche Blumen;6296;10427;-4131
01.05.15;WA68;Waren aus Steinen, Gips, Zement usw.;341797;245324;96473
01.05.15;WA69;Keramische Waren;250546;218767;31779
01.05.15;WA70;Glas und Glaswaren;472425;379482;92943
01.05.15;WA71;Perlen, Edelsteine, Edelmetalle;822606;1100915;-278309
01.05.15;WA72;Eisen und Stahl;1795194;2000868;-205674
01.05.15;WA73;Waren aus Eisen oder Stahl;2066342;1466438;599904
01.05.15;WA74;Kupfer und Waren daraus;846869;856165;-9296
01.05.15;WA75;Nickel und Waren daraus;97936;125325;-27389
01.05.15;WA76;Aluminium und Waren daraus;1186722;1296371;-109649
01.05.15;WA78;Blei und Waren daraus;40818;22719;18099
01.05.15;WA79;Zink und Waren daraus;52221;121981;-69760
01.05.15;WA80;Zinn und Waren daraus;8524;27762;-19238
01.05.15;WA81;Andere unedle Metalle, Cermets usw.;120264;126874;-6610
01.05.15;WA82;Werkzeuge, Schneidwaren, Essbestecke;639645;385742;253903
01.05.15;WA83;Verschiedene Waren aus unedlen Metallen;578143;332712;245431
01.05.15;WA84;Maschinen, Apparate, mechanische Geräte;16280498;9554039;6726459
01.05.15;WA85;Elektrotechnische Erzeugnisse;9305632;8552580;753052
01.05.15;WA86;Schienenfahrzeuge;237717;171942;65775
01.05.15;WA87;Kraftfahrzeuge, Landfahrzeuge;17234849;7472767;9762082
01.05.15;WA88;Luftfahrzeuge, Raumfahrzeuge;3363303;1675582;1687721
01.05.15;WA89;Wasserfahrzeuge;500788;85064;415724
01.05.15;WA90;Optische, photografische usw. Erzeugnisse;4500322;2598889;1901433
01.05.15;WA91;Uhrmacherwaren;170969;206687;-35718
01.05.15;WA92;Musikinstrumente;42270;40012;2258
01.05.15;WA93;Waffen und Munition;34056;15265;18791
01.05.15;WA94;Möbel, Beleuchtungskörper usw.;1143331;1339250;-195919
01.05.15;WA95;Spielzeug, Spiele usw., Sportgeräte;254118;405405;-151287
01.05.15;WA96;Verschiedene Waren;292333;202725;89608
01.05.15;WA97;Kunstgegenstände, Sammlungsstücke;67685;59905;7780
01.05.15;WA98;Vollständige Fabrikationsanlagen;218047;7456;210591
01.05.15;WA99;Zusammenstellungen verschiedener Waren;1574630;847457;727173
01.05.16;WA01;Lebende Tiere;127437;163167;-35730
01.05.16;WA02;Fleisch;610469;522801;87668
01.05.16;WA03;Fische, Krebs- und Weichtiere;133856;301385;-167529
01.05.16;WA04;Milch, Milcherzeugnisse, Eier, Honig;607228;526971;80257
01.05.16;WA05;Andere Waren tierischen Ursprungs;67065;73350;-6285
01.05.16;WA06;Pflanzen, Waren des Blumenhandels;114357;350699;-236342
01.05.16;WA07;Gemüse, Pflanzen für Ernährung;84446;556491;-472045
01.05.16;WA08;Geniessbare Früchte und Nüsse;165751;787150;-621399
01.05.16;WA09;Kaffee, Tee, Mate, Gewürze;213589;338935;-125346
01.05.16;WA10;Getreide;213029;177621;35408
01.05.16;WA11;Müllereierzeugnisse, Malz usw.;128549;45649;82900
01.05.16;WA12;Ölsamen usw., Heilpflanzen usw.;76876;393019;-316143
01.05.16;WA13;Schellack, Gummen, Harz, Pflanzensaft;49541;41881;7660
01.05.16;WA14;Flechtstoffe usw. pflanzlichen Ursprungs;745;3822;-3077
01.05.16;WA15;Tierische und pflanzliche Fette, Öle, Wachs;236966;306422;-69456
01.05.16;WA16;Zubereitungen von Fleisch, Fisch usw.;246676;215575;31101
01.05.16;WA17;Zucker und Zuckerwaren;155633;132294;23339
01.05.16;WA18;Kakao und Zubereitungen aus Kakao;332024;337459;-5435
01.05.16;WA19;Zubereitungen aus Getreide usw., Backwaren;469263;339225;130038
01.05.16;WA20;Zubereitungen von Gemüse, Früchten usw.;210603;385196;-174593
01.05.16;WA21;Verschiedene Lebensmittelzubereitungen;458928;273494;185434
01.05.16;WA22;Getränke, alkoholhaltige Flüssigkeiten, Essig;504646;565991;-61345
01.05.16;WA23;Rückstände der Lebensmittelindustrie, Futter;303521;318224;-14703
01.05.16;WA24;Tabak;391603;196049;195554
01.05.16;WA25;Salz, Schwefel, Steine, Erden usw.;168026;147450;20576
01.05.16;WA26;Erze, Schlacken, Aschen;28354;452617;-424263
01.05.16;WA27;Mineralische Brennstoffe usw.;1602152;5279910;-3677758
01.05.16;WA28;Anorganische chemische Erzeugnisse;691209;500157;191052
01.05.16;WA29;Organische chemische Erzeugnisse;1889812;1750537;139275
01.05.16;WA30;Pharmazeutische Erzeugnisse;5454724;3625595;1829129
01.05.16;WA31;Düngemittel;161866;74144;87722
01.05.16;WA32;Gerb- und Farbstoffe, Farben, Lacke usw.;931278;491302;439976
01.05.16;WA33;Etherische Öle, Riech-, Schönheitsmittel;711618;547980;163638
01.05.16;WA34;Seifen, Waschmittel usw.;580451;301165;279286
01.05.16;WA35;Eiweissstoffe, Klebstoffe, Enzyme;248886;152295;96591
01.05.16;WA36;Sprengstoffe, pyrotechnische Artikel usw.;25116;15822;9294
01.05.16;WA37;Photochemische Erzeugnisse;105039;63776;41263
01.05.16;WA38;Verschiedene Erzeugnisse der Chemischen Industrie;1711615;1003097;708518
01.05.16;WA39;Kunststoffe und Waren daraus;4676165;3056766;1619399
01.05.16;WA40;Kautschuk und Waren daraus;1175205;1076977;98228
01.05.16;WA41;Häute, Felle, Leder;79699;70067;9632
01.05.16;WA42;Lederwaren, Sattlerwaren;151171;320837;-169666
01.05.16;WA43;Pelzfelle, künstliches Pelzwerk;8775;11820;-3045
01.05.16;WA44;Holz, Holzwaren, Holzkohle;635705;665343;-29638
01.05.16;WA45;Kork, Korkwaren;2320;8666;-6346
01.05.16;WA46;Flechtwaren, Korbmacherwaren;4306;10006;-5700
01.05.16;WA47;Halbstoffe aus Holz usw., Papierabfall;101749;314665;-212916
01.05.16;WA48;Papier, Pappe und Waren daraus;1422881;962383;460498
01.05.16;WA49;Bücher, Zeitungen, Bilddrucke usw.;317126;212743;104383
01.05.16;WA50;Seide;4566;5204;-638
01.05.16;WA51;Wolle, feine und grobe Tierhaare;44072;60497;-16425
01.05.16;WA52;Baumwolle;71071;79622;-8551
01.05.16;WA53;Andere pflanzliche Spinnstoffe, Papiergarn;2918;5571;-2653
01.05.16;WA54;Synthetisches oder künstliches Filament;159642;126552;33090
01.05.16;WA55;Synthetische oder künstliche Spinnfaser;152587;133273;19314
01.05.16;WA56;Watte, Filz, Vliesstoff usw., Tauwerk;198210;114103;84107
01.05.16;WA57;Teppiche, Fussbodenbelag aus Spinnstoff;41317;84706;-43389
01.05.16;WA58;Spezialgewebe, Spitzen, Tapisserien;42604;25137;17467
01.05.16;WA59;Getränkte, bestrichene usw. Gewebe;194802;98648;96154
01.05.16;WA60;Gewirke und Gestricke;72073;46058;26015
01.05.16;WA61;Bekleidung usw. aus Gewirken, Gestricken;480392;1088406;-608014
01.05.16;WA62;Andere Bekleidung, Bekleidungszubehör;503634;1122924;-619290
01.05.16;WA63;Andere Konfektion, Spinnstoffwaren usw.;208106;309832;-101726
01.05.16;WA64;Schuhe, Gamaschen, ähnliche Waren;322010;713562;-391552
01.05.16;WA65;Kopfbedeckungen und Teile davon;26449;40384;-13935
01.05.16;WA66;Schirme, Gehstöcke usw., Peitschen;8284;18524;-10240
01.05.16;WA67;Zugerichtete Federn, Daunen, künstliche Blumen;7266;12460;-5194
01.05.16;WA68;Waren aus Steinen, Gips, Zement usw.;356297;261357;94940
01.05.16;WA69;Keramische Waren;262973;230477;32496
01.05.16;WA70;Glas und Glaswaren;491350;416043;75307
01.05.16;WA71;Perlen, Edelsteine, Edelmetalle;881747;1054483;-172736
01.05.16;WA72;Eisen und Stahl;1654586;1657349;-2763
01.05.16;WA73;Waren aus Eisen oder Stahl;2085748;1584568;501180
01.05.16;WA74;Kupfer und Waren daraus;713179;612283;100896
01.05.16;WA75;Nickel und Waren daraus;67869;85384;-17515
01.05.16;WA76;Aluminium und Waren daraus;1144920;1304475;-159555
01.05.16;WA78;Blei und Waren daraus;25065;27832;-2767
01.05.16;WA79;Zink und Waren daraus;47618;101275;-53657
01.05.16;WA80;Zinn und Waren daraus;8052;27632;-19580
01.05.16;WA81;Andere unedle Metalle, Cermets usw.;111011;134648;-23637
01.05.16;WA82;Werkzeuge, Schneidwaren, Essbestecke;616075;392941;223134
01.05.16;WA83;Verschiedene Waren aus unedlen Metallen;607041;371380;235661
01.05.16;WA84;Maschinen, Apparate, mechanische Geräte;15945170;9904863;6040307
01.05.16;WA85;Elektrotechnische Erzeugnisse;9902305;9266854;635451
01.05.16;WA86;Schienenfahrzeuge;284437;212187;72250
01.05.16;WA87;Kraftfahrzeuge, Landfahrzeuge;17552579;8391671;9160908
01.05.16;WA88;Luftfahrzeuge, Raumfahrzeuge;3274968;1669362;1605606
01.05.16;WA89;Wasserfahrzeuge;918738;69570;849168
01.05.16;WA90;Optische, photografische usw. Erzeugnisse;4566074;2742808;1823266
01.05.16;WA91;Uhrmacherwaren;125097;155360;-30263
01.05.16;WA92;Musikinstrumente;44883;47172;-2289
01.05.16;WA93;Waffen und Munition;43758;21231;22527
01.05.16;WA94;Möbel, Beleuchtungskörper usw.;1196858;1469153;-272295
01.05.16;WA95;Spielzeug, Spiele usw., Sportgeräte;270695;393573;-122878
01.05.16;WA96;Verschiedene Waren;304818;213497;91321
01.05.16;WA97;Kunstgegenstände, Sammlungsstücke;53143;44055;9088
01.05.16;WA98;Vollständige Fabrikationsanlagen;205157;1901;203256
01.05.16;WA99;Zusammenstellungen verschiedener Waren;1671912;851750;820162
01.05.17;WA01;Lebende Tiere;114322;167044;-52722
01.05.17;WA02;Fleisch;668528;575956;92572
01.05.17;WA03;Fische, Krebs- und Weichtiere;148428;339775;-191347
01.05.17;WA04;Milch, Milcherzeugnisse, Eier, Honig;802933;668445;134488
01.05.17;WA05;Andere Waren tierischen Ursprungs;83987;88577;-4590
01.05.17;WA06;Pflanzen, Waren des Blumenhandels;124862;380439;-255577
01.05.17;WA07;Gemüse, Pflanzen für Ernährung;90977;556309;-465332
01.05.17;WA08;Geniessbare Früchte und Nüsse;168739;858602;-689863
01.05.17;WA09;Kaffee, Tee, Mate, Gewürze;239883;410527;-170644
01.05.17;WA10;Getreide;221236;202891;18345
01.05.17;WA11;Müllereierzeugnisse, Malz usw.;133987;47095;86892
01.05.17;WA12;Ölsamen usw., Heilpflanzen usw.;83553;443263;-359710
01.05.17;WA13;Schellack, Gummen, Harz, Pflanzensaft;55885;40981;14904
01.05.17;WA14;Flechtstoffe usw. pflanzlichen Ursprungs;725;3780;-3055
01.05.17;WA15;Tierische und pflanzliche Fette, Öle, Wachs;259446;376784;-117338
01.05.17;WA16;Zubereitungen von Fleisch, Fisch usw.;235633;234529;1104
01.05.17;WA17;Zucker und Zuckerwaren;178485;156190;22295
01.05.17;WA18;Kakao und Zubereitungen aus Kakao;349546;356377;-6831
01.05.17;WA19;Zubereitungen aus Getreide usw., Backwaren;539591;355959;183632
01.05.17;WA20;Zubereitungen von Gemüse, Früchten usw.;240954;418259;-177305
01.05.17;WA21;Verschiedene Lebensmittelzubereitungen;509221;309521;199700
01.05.17;WA22;Getränke, alkoholhaltige Flüssigkeiten, Essig;542819;593330;-50511
01.05.17;WA23;Rückstände der Lebensmittelindustrie, Futter;312664;331244;-18580
01.05.17;WA24;Tabak;369683;212716;156967
01.05.17;WA25;Salz, Schwefel, Steine, Erden usw.;178510;166542;11968
01.05.17;WA26;Erze, Schlacken, Aschen;43719;663547;-619828
01.05.17;WA27;Mineralische Brennstoffe usw.;1781264;6750451;-4969187
01.05.17;WA28;Anorganische chemische Erzeugnisse;741042;631406;109636
01.05.17;WA29;Organische chemische Erzeugnisse;2109160;2942535;-833375
01.05.17;WA30;Pharmazeutische Erzeugnisse;6248767;3802930;2445837
01.05.17;WA31;Düngemittel;169734;71433;98301
01.05.17;WA32;Gerb- und Farbstoffe, Farben, Lacke usw.;1022524;554144;468380
01.05.17;WA33;Etherische Öle, Riech-, Schönheitsmittel;819571;568731;250840
01.05.17;WA34;Seifen, Waschmittel usw.;641303;324973;316330
01.05.17;WA35;Eiweissstoffe, Klebstoffe, Enzyme;307106;184576;122530
01.05.17;WA36;Sprengstoffe, pyrotechnische Artikel usw.;18848;16412;2436
01.05.17;WA37;Photochemische Erzeugnisse;114575;84293;30282
01.05.17;WA38;Verschiedene Erzeugnisse der Chemischen Industrie;1880398;1169025;711373
01.05.17;WA39;Kunststoffe und Waren daraus;5309030;3501832;1807198
01.05.17;WA40;Kautschuk und Waren daraus;1356996;1259741;97255
01.05.17;WA41;Häute, Felle, Leder;87484;79213;8271
01.05.17;WA42;Lederwaren, Sattlerwaren;180708;359016;-178308
01.05.17;WA43;Pelzfelle, künstliches Pelzwerk;9179;14706;-5527
01.05.17;WA44;Holz, Holzwaren, Holzkohle;697776;711140;-13364
01.05.17;WA45;Kork, Korkwaren;2682;9168;-6486
01.05.17;WA46;Flechtwaren, Korbmacherwaren;4455;10492;-6037
01.05.17;WA47;Halbstoffe aus Holz usw., Papierabfall;113295;331524;-218229
01.05.17;WA48;Papier, Pappe und Waren daraus;1533477;1041086;492391
01.05.17;WA49;Bücher, Zeitungen, Bilddrucke usw.;338559;207073;131486
01.05.17;WA50;Seide;4292;5123;-831
01.05.17;WA51;Wolle, feine und grobe Tierhaare;45961;60132;-14171
01.05.17;WA52;Baumwolle;75316;93397;-18081
01.05.17;WA53;Andere pflanzliche Spinnstoffe, Papiergarn;2788;5609;-2821
01.05.17;WA54;Synthetisches oder künstliches Filament;172405;147051;25354
01.05.17;WA55;Synthetische oder künstliche Spinnfaser;173931;137783;36148
01.05.17;WA56;Watte, Filz, Vliesstoff usw., Tauwerk;215408;136057;79351
01.05.17;WA57;Teppiche, Fussbodenbelag aus Spinnstoff;47185;90546;-43361
01.05.17;WA58;Spezialgewebe, Spitzen, Tapisserien;47025;23601;23424
01.05.17;WA59;Getränkte, bestrichene usw. Gewebe;224482;100550;123932
01.05.17;WA60;Gewirke und Gestricke;84470;49834;34636
01.05.17;WA61;Bekleidung usw. aus Gewirken, Gestricken;612686;1248255;-635569
01.05.17;WA62;Andere Bekleidung, Bekleidungszubehör;652483;1254193;-601710
01.05.17;WA63;Andere Konfektion, Spinnstoffwaren usw.;224100;359256;-135156
01.05.17;WA64;Schuhe, Gamaschen, ähnliche Waren;467411;885000;-417589
01.05.17;WA65;Kopfbedeckungen und Teile davon;29605;43288;-13683
01.05.17;WA66;Schirme, Gehstöcke usw., Peitschen;8721;22691;-13970
01.05.17;WA67;Zugerichtete Federn, Daunen, künstliche Blumen;8585;14128;-5543
01.05.17;WA68;Waren aus Steinen, Gips, Zement usw.;406289;289956;116333
01.05.17;WA69;Keramische Waren;274572;247560;27012
01.05.17;WA70;Glas und Glaswaren;546235;457002;89233
01.05.17;WA71;Perlen, Edelsteine, Edelmetalle;1038892;1302170;-263278
01.05.17;WA72;Eisen und Stahl;1994435;2306338;-311903
01.05.17;WA73;Waren aus Eisen oder Stahl;2352607;1794023;558584
01.05.17;WA74;Kupfer und Waren daraus;943990;794347;149643
01.05.17;WA75;Nickel und Waren daraus;99603;118909;-19306
01.05.17;WA76;Aluminium und Waren daraus;1277961;1495091;-217130
01.05.17;WA78;Blei und Waren daraus;42807;42903;-96
01.05.17;WA79;Zink und Waren daraus;68820;143136;-74316
01.05.17;WA80;Zinn und Waren daraus;9913;40878;-30965
01.05.17;WA81;Andere unedle Metalle, Cermets usw.;131109;168272;-37163
01.05.17;WA82;Werkzeuge, Schneidwaren, Essbestecke;692465;443099;249366
01.05.17;WA83;Verschiedene Waren aus unedlen Metallen;649926;405849;244077
01.05.17;WA84;Maschinen, Apparate, mechanische Geräte;19058542;11230392;7828150
01.05.17;WA85;Elektrotechnische Erzeugnisse;11101358;10977316;124042
01.05.17;WA86;Schienenfahrzeuge;378977;223436;155541
01.05.17;WA87;Kraftfahrzeuge, Landfahrzeuge;20439038;9925321;10513717
01.05.17;WA88;Luftfahrzeuge, Raumfahrzeuge;3858878;1077277;2781601
01.05.17;WA89;Wasserfahrzeuge;324839;79031;245808
01.05.17;WA90;Optische, photografische usw. Erzeugnisse;5480172;3050294;2429878
01.05.17;WA91;Uhrmacherwaren;144167;166411;-22244
01.05.17;WA92;Musikinstrumente;46944;47301;-357
01.05.17;WA93;Waffen und Munition;41115;24740;16375
01.05.17;WA94;Möbel, Beleuchtungskörper usw.;1333135;1567145;-234010
01.05.17;WA95;Spielzeug, Spiele usw., Sportgeräte;319804;469218;-149414
01.05.17;WA96;Verschiedene Waren;333981;231041;102940
01.05.17;WA97;Kunstgegenstände, Sammlungsstücke;52391;35290;17101
01.05.17;WA98;Vollständige Fabrikationsanlagen;149873;12;149861
01.05.17;WA99;Zusammenstellungen verschiedener Waren;1576975;1014814;562161
01.05.18;WA01;Lebende Tiere;116948;140620;-23672
01.05.18;WA02;Fleisch;567697;553714;13983
01.05.18;WA03;Fische, Krebs- und Weichtiere;122441;316254;-193813
01.05.18;WA04;Milch, Milcherzeugnisse, Eier, Honig;767970;683606;84364
01.05.18;WA05;Andere Waren tierischen Ursprungs;81481;83875;-2394
01.05.18;WA06;Pflanzen, Waren des Blumenhandels;127816;336257;-208441
01.05.18;WA07;Gemüse, Pflanzen für Ernährung;85645;559784;-474139
01.05.18;WA08;Geniessbare Früchte und Nüsse;156905;921146;-764241
01.05.18;WA09;Kaffee, Tee, Mate, Gewürze;221085;290466;-69381
01.05.18;WA10;Getreide;159683;190133;-30450
01.05.18;WA11;Müllereierzeugnisse, Malz usw.;126152;62131;64021
01.05.18;WA12;Ölsamen usw., Heilpflanzen usw.;84025;448337;-364312
01.05.18;WA13;Schellack, Gummen, Harz, Pflanzensaft;52858;42900;9958
01.05.18;WA14;Flechtstoffe usw. pflanzlichen Ursprungs;955;3420;-2465
01.05.18;WA15;Tierische und pflanzliche Fette, Öle, Wachs;227658;286137;-58479
01.05.18;WA16;Zubereitungen von Fleisch, Fisch usw.;260384;245198;15186
01.05.18;WA17;Zucker und Zuckerwaren;190784;125248;65536
01.05.18;WA18;Kakao und Zubereitungen aus Kakao;356602;296090;60512
01.05.18;WA19;Zubereitungen aus Getreide usw., Backwaren;535386;342198;193188
01.05.18;WA20;Zubereitungen von Gemüse, Früchten usw.;242927;402017;-159090
01.05.18;WA21;Verschiedene Lebensmittelzubereitungen;489862;292312;197550
01.05.18;WA22;Getränke, alkoholhaltige Flüssigkeiten, Essig;531403;602911;-71508
01.05.18;WA23;Rückstände der Lebensmittelindustrie, Futter;336029;302139;33890
01.05.18;WA24;Tabak;342572;195681;146891
01.05.18;WA25;Salz, Schwefel, Steine, Erden usw.;166525;161723;4802
01.05.18;WA26;Erze, Schlacken, Aschen;31330;638587;-607257
01.05.18;WA27;Mineralische Brennstoffe usw.;2082377;7912133;-5829756
01.05.18;WA28;Anorganische chemische Erzeugnisse;797914;585625;212289
01.05.18;WA29;Organische chemische Erzeugnisse;2050090;3141406;-1091316
01.05.18;WA30;Pharmazeutische Erzeugnisse;6547358;3748441;2798917
01.05.18;WA31;Düngemittel;155806;77811;77995
01.05.18;WA32;Gerb- und Farbstoffe, Farben, Lacke usw.;970395;512002;458393
01.05.18;WA33;Etherische Öle, Riech-, Schönheitsmittel;810472;584000;226472
01.05.18;WA34;Seifen, Waschmittel usw.;630567;324798;305769
01.05.18;WA35;Eiweissstoffe, Klebstoffe, Enzyme;293894;176627;117267
01.05.18;WA36;Sprengstoffe, pyrotechnische Artikel usw.;20672;12638;8034
01.05.18;WA37;Photochemische Erzeugnisse;100176;71860;28316
01.05.18;WA38;Verschiedene Erzeugnisse der Chemischen Industrie;1825925;1169768;656157
01.05.18;WA39;Kunststoffe und Waren daraus;5174807;3448322;1726485
01.05.18;WA40;Kautschuk und Waren daraus;1259438;1172052;87386
01.05.18;WA41;Häute, Felle, Leder;78410;61347;17063
01.05.18;WA42;Lederwaren, Sattlerwaren;173286;332784;-159498
01.05.18;WA43;Pelzfelle, künstliches Pelzwerk;12274;13885;-1611
01.05.18;WA44;Holz, Holzwaren, Holzkohle;714473;687476;26997
01.05.18;WA45;Kork, Korkwaren;2234;6086;-3852
01.05.18;WA46;Flechtwaren, Korbmacherwaren;3859;8611;-4752
01.05.18;WA47;Halbstoffe aus Holz usw., Papierabfall;100116;353731;-253615
01.05.18;WA48;Papier, Pappe und Waren daraus;1546541;1007070;539471
01.05.18;WA49;Bücher, Zeitungen, Bilddrucke usw.;320533;206709;113824
01.05.18;WA50;Seide;5610;4225;1385
01.05.18;WA51;Wolle, feine und grobe Tierhaare;45898;61763;-15865
01.05.18;WA52;Baumwolle;72276;77044;-4768
01.05.18;WA53;Andere pflanzliche Spinnstoffe, Papiergarn;2592;5033;-2441
01.05.18;WA54;Synthetisches oder künstliches Filament;164029;135341;28688
01.05.18;WA55;Synthetische oder künstliche Spinnfaser;156090;128251;27839
01.05.18;WA56;Watte, Filz, Vliesstoff usw., Tauwerk;212131;124327;87804
01.05.18;WA57;Teppiche, Fussbodenbelag aus Spinnstoff;40497;79438;-38941
01.05.18;WA58;Spezialgewebe, Spitzen, Tapisserien;45973;22555;23418
01.05.18;WA59;Getränkte, bestrichene usw. Gewebe;216753;94877;121876
01.05.18;WA60;Gewirke und Gestricke;72153;41785;30368
01.05.18;WA61;Bekleidung usw. aus Gewirken, Gestricken;673616;1224330;-550714
01.05.18;WA62;Andere Bekleidung, Bekleidungszubehör;741689;1207364;-465675
01.05.18;WA63;Andere Konfektion, Spinnstoffwaren usw.;228052;339481;-111429
01.05.18;WA64;Schuhe, Gamaschen, ähnliche Waren;469042;867283;-398241
01.05.18;WA65;Kopfbedeckungen und Teile davon;34254;39827;-5573
01.05.18;WA66;Schirme, Gehstöcke usw., Peitschen;9333;21900;-12567
01.05.18;WA67;Zugerichtete Federn, Daunen, künstliche Blumen;9566;12555;-2989
01.05.18;WA68;Waren aus Steinen, Gips, Zement usw.;412998;276688;136310
01.05.18;WA69;Keramische Waren;291829;241902;49927
01.05.18;WA70;Glas und Glaswaren;585798;417272;168526
01.05.18;WA71;Perlen, Edelsteine, Edelmetalle;982686;1122792;-140106
01.05.18;WA72;Eisen und Stahl;2090061;2399634;-309573
01.05.18;WA73;Waren aus Eisen oder Stahl;2492302;1794900;697402
01.05.18;WA74;Kupfer und Waren daraus;954047;903270;50777
01.05.18;WA75;Nickel und Waren daraus;101318;138164;-36846
01.05.18;WA76;Aluminium und Waren daraus;1292232;1380324;-88092
01.05.18;WA78;Blei und Waren daraus;35536;36165;-629
01.05.18;WA79;Zink und Waren daraus;69291;135695;-66404
01.05.18;WA80;Zinn und Waren daraus;8278;37580;-29302
01.05.18;WA81;Andere unedle Metalle, Cermets usw.;136157;172208;-36051
01.05.18;WA82;Werkzeuge, Schneidwaren, Essbestecke;700111;416417;283694
01.05.18;WA83;Verschiedene Waren aus unedlen Metallen;638807;397344;241463
01.05.18;WA84;Maschinen, Apparate, mechanische Geräte;18943017;11150243;7792774
01.05.18;WA85;Elektrotechnische Erzeugnisse;11238071;10660317;577754
01.05.18;WA86;Schienenfahrzeuge;335268;203356;131912
01.05.18;WA87;Kraftfahrzeuge, Landfahrzeuge;19152487;9998267;9154220
01.05.18;WA88;Luftfahrzeuge, Raumfahrzeuge;2424536;1904632;519904
01.05.18;WA89;Wasserfahrzeuge;1598031;138256;1459775
01.05.18;WA90;Optische, photografische usw. Erzeugnisse;5487903;3003186;2484717
01.05.18;WA91;Uhrmacherwaren;152371;155564;-3193
01.05.18;WA92;Musikinstrumente;50242;45274;4968
01.05.18;WA93;Waffen und Munition;39225;18350;20875
01.05.18;WA94;Möbel, Beleuchtungskörper usw.;1270394;1445685;-175291
01.05.18;WA95;Spielzeug, Spiele usw., Sportgeräte;332198;503040;-170842
01.05.18;WA96;Verschiedene Waren;334461;234021;100440
01.05.18;WA97;Kunstgegenstände, Sammlungsstücke;94219;51064;43155
01.05.18;WA98;Vollständige Fabrikationsanlagen;184346;NULL;#WERT!
01.05.18;WA99;Zusammenstellungen verschiedener Waren;1381614;1035078;346536
01.05.19;WA01;Lebende Tiere;93280;154267;-60987
01.05.19;WA02;Fleisch;660982;571691;89291
01.05.19;WA03;Fische, Krebs- und Weichtiere;105163;336996;-231833
01.05.19;WA04;Milch, Milcherzeugnisse, Eier, Honig;822855;651421;171434
01.05.19;WA05;Andere Waren tierischen Ursprungs;78168;77598;570
01.05.19;WA06;Pflanzen, Waren des Blumenhandels;115774;322674;-206900
01.05.19;WA07;Gemüse, Pflanzen für Ernährung;121439;572324;-450885
01.05.19;WA08;Geniessbare Früchte und Nüsse;147965;844905;-696940
01.05.19;WA09;Kaffee, Tee, Mate, Gewürze;221323;318106;-96783
01.05.19;WA10;Getreide;137077;212754;-75677
01.05.19;WA11;Müllereierzeugnisse, Malz usw.;141864;61819;80045
01.05.19;WA12;Ölsamen usw., Heilpflanzen usw.;91104;445269;-354165
01.05.19;WA13;Schellack, Gummen, Harz, Pflanzensaft;61660;43512;18148
01.05.19;WA14;Flechtstoffe usw. pflanzlichen Ursprungs;658;3900;-3242
01.05.19;WA15;Tierische und pflanzliche Fette, Öle, Wachs;212204;276801;-64597
01.05.19;WA16;Zubereitungen von Fleisch, Fisch usw.;219554;234062;-14508
01.05.19;WA17;Zucker und Zuckerwaren;186875;127379;59496
01.05.19;WA18;Kakao und Zubereitungen aus Kakao;381023;360354;20669
01.05.19;WA19;Zubereitungen aus Getreide usw., Backwaren;540175;353906;186269
01.05.19;WA20;Zubereitungen von Gemüse, Früchten usw.;257897;414628;-156731
01.05.19;WA21;Verschiedene Lebensmittelzubereitungen;493510;291223;202287
01.05.19;WA22;Getränke, alkoholhaltige Flüssigkeiten, Essig;540259;623835;-83576
01.05.19;WA23;Rückstände der Lebensmittelindustrie, Futter;330779;318416;12363
01.05.19;WA24;Tabak;262858;220299;42559
01.05.19;WA25;Salz, Schwefel, Steine, Erden usw.;182027;179427;2600
01.05.19;WA26;Erze, Schlacken, Aschen;45869;744976;-699107
01.05.19;WA27;Mineralische Brennstoffe usw.;2700635;8357584;-5656949
01.05.19;WA28;Anorganische chemische Erzeugnisse;882270;585107;297163
01.05.19;WA29;Organische chemische Erzeugnisse;2163306;3684055;-1520749
01.05.19;WA30;Pharmazeutische Erzeugnisse;6634337;4189217;2445120
01.05.19;WA31;Düngemittel;178255;107395;70860
01.05.19;WA32;Gerb- und Farbstoffe, Farben, Lacke usw.;1009519;521535;487984
01.05.19;WA33;Etherische Öle, Riech-, Schönheitsmittel;883149;621290;261859
01.05.19;WA34;Seifen, Waschmittel usw.;660670;368488;292182
01.05.19;WA35;Eiweissstoffe, Klebstoffe, Enzyme;318598;191973;126625
01.05.19;WA36;Sprengstoffe, pyrotechnische Artikel usw.;23233;16905;6328
01.05.19;WA37;Photochemische Erzeugnisse;103110;72746;30364
01.05.19;WA38;Verschiedene Erzeugnisse der Chemischen Industrie;1966828;1195695;771133
01.05.19;WA39;Kunststoffe und Waren daraus;5318581;3523342;1795239
01.05.19;WA40;Kautschuk und Waren daraus;1264781;1172353;92428
01.05.19;WA41;Häute, Felle, Leder;60097;53135;6962
01.05.19;WA42;Lederwaren, Sattlerwaren;190679;349297;-158618
01.05.19;WA43;Pelzfelle, künstliches Pelzwerk;11378;12938;-1560
01.05.19;WA44;Holz, Holzwaren, Holzkohle;742150;676244;65906
01.05.19;WA45;Kork, Korkwaren;2681;8885;-6204
01.05.19;WA46;Flechtwaren, Korbmacherwaren;4789;9997;-5208
01.05.19;WA47;Halbstoffe aus Holz usw., Papierabfall;98773;320528;-221755
01.05.19;WA48;Papier, Pappe und Waren daraus;1606942;1009211;597731
01.05.19;WA49;Bücher, Zeitungen, Bilddrucke usw.;315539;213097;102442
01.05.19;WA50;Seide;2326;4192;-1866
01.05.19;WA51;Wolle, feine und grobe Tierhaare;46825;59271;-12446
01.05.19;WA52;Baumwolle;68032;65682;2350
01.05.19;WA53;Andere pflanzliche Spinnstoffe, Papiergarn;2573;4948;-2375
01.05.19;WA54;Synthetisches oder künstliches Filament;162436;131854;30582
01.05.19;WA55;Synthetische oder künstliche Spinnfaser;140181;126332;13849
01.05.19;WA56;Watte, Filz, Vliesstoff usw., Tauwerk;220149;132527;87622
01.05.19;WA57;Teppiche, Fussbodenbelag aus Spinnstoff;45836;87196;-41360
01.05.19;WA58;Spezialgewebe, Spitzen, Tapisserien;46461;22521;23940
01.05.19;WA59;Getränkte, bestrichene usw. Gewebe;213119;96908;116211
01.05.19;WA60;Gewirke und Gestricke;70841;42582;28259
01.05.19;WA61;Bekleidung usw. aus Gewirken, Gestricken;745613;1228117;-482504
01.05.19;WA62;Andere Bekleidung, Bekleidungszubehör;850116;1266306;-416190
01.05.19;WA63;Andere Konfektion, Spinnstoffwaren usw.;243508;362223;-118715
01.05.19;WA64;Schuhe, Gamaschen, ähnliche Waren;601152;804172;-203020
01.05.19;WA65;Kopfbedeckungen und Teile davon;36823;47498;-10675
01.05.19;WA66;Schirme, Gehstöcke usw., Peitschen;9167;24114;-14947
01.05.19;WA67;Zugerichtete Federn, Daunen, künstliche Blumen;10644;14834;-4190
01.05.19;WA68;Waren aus Steinen, Gips, Zement usw.;406499;303224;103275
01.05.19;WA69;Keramische Waren;315216;254728;60488
01.05.19;WA70;Glas und Glaswaren;577963;455780;122183
01.05.19;WA71;Perlen, Edelsteine, Edelmetalle;1189292;1326852;-137560
01.05.19;WA72;Eisen und Stahl;2248944;2172775;76169
01.05.19;WA73;Waren aus Eisen oder Stahl;2406860;1844724;562136
01.05.19;WA74;Kupfer und Waren daraus;887762;798411;89351
01.05.19;WA75;Nickel und Waren daraus;121026;138685;-17659
01.05.19;WA76;Aluminium und Waren daraus;1310180;1371019;-60839
01.05.19;WA78;Blei und Waren daraus;33136;39302;-6166
01.05.19;WA79;Zink und Waren daraus;78911;126691;-47780
01.05.19;WA80;Zinn und Waren daraus;8345;37351;-29006
01.05.19;WA81;Andere unedle Metalle, Cermets usw.;141046;156555;-15509
01.05.19;WA82;Werkzeuge, Schneidwaren, Essbestecke;725076;454147;270929
01.05.19;WA83;Verschiedene Waren aus unedlen Metallen;642076;412341;229735
01.05.19;WA84;Maschinen, Apparate, mechanische Geräte;20377007;11939107;8437900
01.05.19;WA85;Elektrotechnische Erzeugnisse;11853044;11026603;826441
01.05.19;WA86;Schienenfahrzeuge;297483;279117;18366
01.05.19;WA87;Kraftfahrzeuge, Landfahrzeuge;19975059;11163248;8811811
01.05.19;WA88;Luftfahrzeuge, Raumfahrzeuge;3178017;1616145;1561872
01.05.19;WA89;Wasserfahrzeuge;459162;96628;362534
01.05.19;WA90;Optische, photografische usw. Erzeugnisse;6017507;3172826;2844681
01.05.19;WA91;Uhrmacherwaren;133400;163212;-29812
01.05.19;WA92;Musikinstrumente;58668;51563;7105
01.05.19;WA93;Waffen und Munition;42302;22607;19695
01.05.19;WA94;Möbel, Beleuchtungskörper usw.;1386200;1589908;-203708
01.05.19;WA95;Spielzeug, Spiele usw., Sportgeräte;325916;545958;-220042
01.05.19;WA96;Verschiedene Waren;343040;237759;105281
01.05.19;WA97;Kunstgegenstände, Sammlungsstücke;74180;29881;44299
01.05.19;WA98;Vollständige Fabrikationsanlagen;145949;NULL;#WERT!
01.05.19;WA99;Zusammenstellungen verschiedener Waren;1381096;1127261;253835
01.05.20;WA01;Lebende Tiere;75883;144818;-68935
01.05.20;WA02;Fleisch;583073;449114;133959
01.05.20;WA03;Fische, Krebs- und Weichtiere;85645;269968;-184323
01.05.20;WA04;Milch, Milcherzeugnisse, Eier, Honig;751465;625003;126462
01.05.20;WA05;Andere Waren tierischen Ursprungs;68775;67859;916
01.05.20;WA06;Pflanzen, Waren des Blumenhandels;114185;353337;-239152
01.05.20;WA07;Gemüse, Pflanzen für Ernährung;94149;594126;-499977
01.05.20;WA08;Geniessbare Früchte und Nüsse;168622;966051;-797429
01.05.20;WA09;Kaffee, Tee, Mate, Gewürze;193349;340314;-146965
01.05.20;WA10;Getreide;219546;228848;-9302
01.05.20;WA11;Müllereierzeugnisse, Malz usw.;123624;55963;67661
01.05.20;WA12;Ölsamen usw., Heilpflanzen usw.;86163;461771;-375608
01.05.20;WA13;Schellack, Gummen, Harz, Pflanzensaft;62436;49514;12922
01.05.20;WA14;Flechtstoffe usw. pflanzlichen Ursprungs;774;2986;-2212
01.05.20;WA15;Tierische und pflanzliche Fette, Öle, Wachs;216766;297006;-80240
01.05.20;WA16;Zubereitungen von Fleisch, Fisch usw.;257777;245612;12165
01.05.20;WA17;Zucker und Zuckerwaren;162709;120549;42160
01.05.20;WA18;Kakao und Zubereitungen aus Kakao;297570;314523;-16953
01.05.20;WA19;Zubereitungen aus Getreide usw., Backwaren;472721;317110;155611
01.05.20;WA20;Zubereitungen von Gemüse, Früchten usw.;220365;388724;-168359
01.05.20;WA21;Verschiedene Lebensmittelzubereitungen;509097;306636;202461
01.05.20;WA22;Getränke, alkoholhaltige Flüssigkeiten, Essig;388284;529511;-141227
01.05.20;WA23;Rückstände der Lebensmittelindustrie, Futter;391549;348631;42918
01.05.20;WA24;Tabak;208631;242387;-33756
01.05.20;WA25;Salz, Schwefel, Steine, Erden usw.;144390;142775;1615
01.05.20;WA26;Erze, Schlacken, Aschen;21040;651544;-630504
01.05.20;WA27;Mineralische Brennstoffe usw.;1360831;4165596;-2804765
01.05.20;WA28;Anorganische chemische Erzeugnisse;620130;431029;189101
01.05.20;WA29;Organische chemische Erzeugnisse;1796407;2803386;-1006979
01.05.20;WA30;Pharmazeutische Erzeugnisse;6908510;4964940;1943570
01.05.20;WA31;Düngemittel;139252;67487;71765
01.05.20;WA32;Gerb- und Farbstoffe, Farben, Lacke usw.;738943;453007;285936
01.05.20;WA33;Etherische Öle, Riech-, Schönheitsmittel;604664;414869;189795
01.05.20;WA34;Seifen, Waschmittel usw.;537942;332892;205050
01.05.20;WA35;Eiweissstoffe, Klebstoffe, Enzyme;261661;165412;96249
01.05.20;WA36;Sprengstoffe, pyrotechnische Artikel usw.;13872;12162;1710
01.05.20;WA37;Photochemische Erzeugnisse;68706;56614;12092
01.05.20;WA38;Verschiedene Erzeugnisse der Chemischen Industrie;1648804;1111127;537677
01.05.20;WA39;Kunststoffe und Waren daraus;3904751;2806337;1098414
01.05.20;WA40;Kautschuk und Waren daraus;793622;789468;4154
01.05.20;WA41;Häute, Felle, Leder;38090;24548;13542
01.05.20;WA42;Lederwaren, Sattlerwaren;131412;226738;-95326
01.05.20;WA43;Pelzfelle, künstliches Pelzwerk;2208;3693;-1485
01.05.20;WA44;Holz, Holzwaren, Holzkohle;645387;594290;51097
01.05.20;WA45;Kork, Korkwaren;2254;9938;-7684
01.05.20;WA46;Flechtwaren, Korbmacherwaren;5209;10205;-4996
01.05.20;WA47;Halbstoffe aus Holz usw., Papierabfall;70307;241497;-171190
01.05.20;WA48;Papier, Pappe und Waren daraus;1199343;879515;319828
01.05.20;WA49;Bücher, Zeitungen, Bilddrucke usw.;244468;186021;58447
01.05.20;WA50;Seide;1822;1416;406
01.05.20;WA51;Wolle, feine und grobe Tierhaare;32437;36348;-3911
01.05.20;WA52;Baumwolle;44797;46746;-1949
01.05.20;WA53;Andere pflanzliche Spinnstoffe, Papiergarn;1934;2809;-875
01.05.20;WA54;Synthetisches oder künstliches Filament;92311;86031;6280
01.05.20;WA55;Synthetische oder künstliche Spinnfaser;100325;91986;8339
01.05.20;WA56;Watte, Filz, Vliesstoff usw., Tauwerk;182495;123653;58842
01.05.20;WA57;Teppiche, Fussbodenbelag aus Spinnstoff;29407;61610;-32203
01.05.20;WA58;Spezialgewebe, Spitzen, Tapisserien;24021;17531;6490
01.05.20;WA59;Getränkte, bestrichene usw. Gewebe;140088;76999;63089
01.05.20;WA60;Gewirke und Gestricke;40512;31429;9083
01.05.20;WA61;Bekleidung usw. aus Gewirken, Gestricken;648354;897972;-249618
01.05.20;WA62;Andere Bekleidung, Bekleidungszubehör;710901;987779;-276878
01.05.20;WA63;Andere Konfektion, Spinnstoffwaren usw.;391915;2533558;-2141643
01.05.20;WA64;Schuhe, Gamaschen, ähnliche Waren;430376;716972;-286596
01.05.20;WA65;Kopfbedeckungen und Teile davon;38328;44883;-6555
01.05.20;WA66;Schirme, Gehstöcke usw., Peitschen;7732;27162;-19430
01.05.20;WA67;Zugerichtete Federn, Daunen, künstliche Blumen;6969;12124;-5155
01.05.20;WA68;Waren aus Steinen, Gips, Zement usw.;334801;236145;98656
01.05.20;WA69;Keramische Waren;206051;178714;27337
01.05.20;WA70;Glas und Glaswaren;419550;300069;119481
01.05.20;WA71;Perlen, Edelsteine, Edelmetalle;1335012;1547612;-212600
01.05.20;WA72;Eisen und Stahl;1345727;1381650;-35923
01.05.20;WA73;Waren aus Eisen oder Stahl;1782887;1420303;362584
01.05.20;WA74;Kupfer und Waren daraus;670691;593560;77131
01.05.20;WA75;Nickel und Waren daraus;110504;101452;9052
01.05.20;WA76;Aluminium und Waren daraus;934038;938087;-4049
01.05.20;WA78;Blei und Waren daraus;33341;19764;13577
01.05.20;WA79;Zink und Waren daraus;41878;78135;-36257
01.05.20;WA80;Zinn und Waren daraus;6228;20941;-14713
01.05.20;WA81;Andere unedle Metalle, Cermets usw.;81804;105817;-24013
01.05.20;WA82;Werkzeuge, Schneidwaren, Essbestecke;523100;360133;162967
01.05.20;WA83;Verschiedene Waren aus unedlen Metallen;420081;301434;118647
01.05.20;WA84;Maschinen, Apparate, mechanische Geräte;14349071;9282908;5066163
01.05.20;WA85;Elektrotechnische Erzeugnisse;8852633;8882775;-30142
01.05.20;WA86;Schienenfahrzeuge;309875;241728;68147
01.05.20;WA87;Kraftfahrzeuge, Landfahrzeuge;9125330;5645563;3479767
01.05.20;WA88;Luftfahrzeuge, Raumfahrzeuge;1388784;752154;636630
01.05.20;WA89;Wasserfahrzeuge;678284;164793;513491
01.05.20;WA90;Optische, photografische usw. Erzeugnisse;4371941;2663942;1707999
01.05.20;WA91;Uhrmacherwaren;78232;115966;-37734
01.05.20;WA92;Musikinstrumente;39336;46237;-6901
01.05.20;WA93;Waffen und Munition;33085;18930;14155
01.05.20;WA94;Möbel, Beleuchtungskörper usw.;989812;1259778;-269966
01.05.20;WA95;Spielzeug, Spiele usw., Sportgeräte;288409;459624;-171215
01.05.20;WA96;Verschiedene Waren;276275;211668;64607
01.05.20;WA97;Kunstgegenstände, Sammlungsstücke;24432;20702;3730
01.05.20;WA98;Vollständige Fabrikationsanlagen;116630;NULL;#WERT!
01.05.20;WA99;Zusammenstellungen verschiedener Waren;830216;880057;-49841
01.05.21;WA01;Lebende Tiere;91468;123227;-31759
01.05.21;WA02;Fleisch;523885;505213;18672
01.05.21;WA03;Fische, Krebs- und Weichtiere;99325;287977;-188652
01.05.21;WA04;Milch, Milcherzeugnisse, Eier, Honig;842353;687984;154369
01.05.21;WA05;Andere Waren tierischen Ursprungs;75574;83445;-7871
01.05.21;WA06;Pflanzen, Waren des Blumenhandels;135808;424755;-288947
01.05.21;WA07;Gemüse, Pflanzen für Ernährung;106351;638904;-532553
01.05.21;WA08;Geniessbare Früchte und Nüsse;159296;959405;-800109
01.05.21;WA09;Kaffee, Tee, Mate, Gewürze;244738;332442;-87704
01.05.21;WA10;Getreide;257342;222781;34561
01.05.21;WA11;Müllereierzeugnisse, Malz usw.;140215;56687;83528
01.05.21;WA12;Ölsamen usw., Heilpflanzen usw.;101357;534115;-432758
01.05.21;WA13;Schellack, Gummen, Harz, Pflanzensaft;58561;45439;13122
01.05.21;WA14;Flechtstoffe usw. pflanzlichen Ursprungs;870;2797;-1927
01.05.21;WA15;Tierische und pflanzliche Fette, Öle, Wachs;332363;356261;-23898
01.05.21;WA16;Zubereitungen von Fleisch, Fisch usw.;250883;303202;-52319
01.05.21;WA17;Zucker und Zuckerwaren;220724;135802;84922
01.05.21;WA18;Kakao und Zubereitungen aus Kakao;397770;377403;20367
01.05.21;WA19;Zubereitungen aus Getreide usw., Backwaren;532763;391567;141196
01.05.21;WA20;Zubereitungen von Gemüse, Früchten usw.;231175;398060;-166885
01.05.21;WA21;Verschiedene Lebensmittelzubereitungen;559843;349834;210009
01.05.21;WA22;Getränke, alkoholhaltige Flüssigkeiten, Essig;529857;627117;-97260
01.05.21;WA23;Rückstände der Lebensmittelindustrie, Futter;450331;375976;74355
01.05.21;WA24;Tabak;211956;248245;-36289
01.05.21;WA25;Salz, Schwefel, Steine, Erden usw.;184416;144748;39668
01.05.21;WA26;Erze, Schlacken, Aschen;62897;1198845;-1135948
01.05.21;WA27;Mineralische Brennstoffe usw.;1871346;7080929;-5209583
01.05.21;WA28;Anorganische chemische Erzeugnisse;1170942;548118;622824
01.05.21;WA29;Organische chemische Erzeugnisse;2248106;3297816;-1049710
01.05.21;WA30;Pharmazeutische Erzeugnisse;7837916;6222634;1615282
01.05.21;WA31;Düngemittel;164468;84741;79727
01.05.21;WA32;Gerb- und Farbstoffe, Farben, Lacke usw.;1019139;532561;486578
01.05.21;WA33;Etherische Öle, Riech-, Schönheitsmittel;775083;542733;232350
01.05.21;WA34;Seifen, Waschmittel usw.;658283;354981;303302
01.05.21;WA35;Eiweissstoffe, Klebstoffe, Enzyme;363773;207823;155950
01.05.21;WA36;Sprengstoffe, pyrotechnische Artikel usw.;22311;10656;11655
01.05.21;WA37;Photochemische Erzeugnisse;93604;53376;40228
01.05.21;WA38;Verschiedene Erzeugnisse der Chemischen Industrie;2269647;1750744;518903
01.05.21;WA39;Kunststoffe und Waren daraus;5774982;3942925;1832057
01.05.21;WA40;Kautschuk und Waren daraus;1247416;1263289;-15873
01.05.21;WA41;Häute, Felle, Leder;56981;38925;18056
01.05.21;WA42;Lederwaren, Sattlerwaren;194103;284574;-90471
01.05.21;WA43;Pelzfelle, künstliches Pelzwerk;2071;5006;-2935
01.05.21;WA44;Holz, Holzwaren, Holzkohle;969742;879205;90537
01.05.21;WA45;Kork, Korkwaren;2173;7339;-5166
01.05.21;WA46;Flechtwaren, Korbmacherwaren;6466;12826;-6360
01.05.21;WA47;Halbstoffe aus Holz usw., Papierabfall;94870;323750;-228880
01.05.21;WA48;Papier, Pappe und Waren daraus;1524979;968170;556809
01.05.21;WA49;Bücher, Zeitungen, Bilddrucke usw.;286978;235038;51940
01.05.21;WA50;Seide;1907;1681;226
01.05.21;WA51;Wolle, feine und grobe Tierhaare;33534;41045;-7511
01.05.21;WA52;Baumwolle;50155;56006;-5851
01.05.21;WA53;Andere pflanzliche Spinnstoffe, Papiergarn;2823;7009;-4186
01.05.21;WA54;Synthetisches oder künstliches Filament;128040;106908;21132
01.05.21;WA55;Synthetische oder künstliche Spinnfaser;140844;121707;19137
01.05.21;WA56;Watte, Filz, Vliesstoff usw., Tauwerk;227650;150715;76935
01.05.21;WA57;Teppiche, Fussbodenbelag aus Spinnstoff;42679;85169;-42490
01.05.21;WA58;Spezialgewebe, Spitzen, Tapisserien;40536;20813;19723
01.05.21;WA59;Getränkte, bestrichene usw. Gewebe;200059;101609;98450
01.05.21;WA60;Gewirke und Gestricke;58294;38803;19491
01.05.21;WA61;Bekleidung usw. aus Gewirken, Gestricken;830553;1309916;-479363
01.05.21;WA62;Andere Bekleidung, Bekleidungszubehör;799041;1151632;-352591
01.05.21;WA63;Andere Konfektion, Spinnstoffwaren usw.;283195;396212;-113017
01.05.21;WA64;Schuhe, Gamaschen, ähnliche Waren;583993;838462;-254469
01.05.21;WA65;Kopfbedeckungen und Teile davon;47378;62337;-14959
01.05.21;WA66;Schirme, Gehstöcke usw., Peitschen;11134;27896;-16762
01.05.21;WA67;Zugerichtete Federn, Daunen, künstliche Blumen;14126;12786;1340
01.05.21;WA68;Waren aus Steinen, Gips, Zement usw.;435483;304275;131208
01.05.21;WA69;Keramische Waren;331779;299679;32100
01.05.21;WA70;Glas und Glaswaren;567393;413110;154283
01.05.21;WA71;Perlen, Edelsteine, Edelmetalle;1866059;3395295;-1529236
01.05.21;WA72;Eisen und Stahl;2243397;2331730;-88333
01.05.21;WA73;Waren aus Eisen oder Stahl;2336528;1997252;339276
01.05.21;WA74;Kupfer und Waren daraus;1205201;1131329;73872
01.05.21;WA75;Nickel und Waren daraus;108709;132621;-23912
01.05.21;WA76;Aluminium und Waren daraus;1309139;1464139;-155000
01.05.21;WA78;Blei und Waren daraus;60200;46090;14110
01.05.21;WA79;Zink und Waren daraus;66733;130546;-63813
01.05.21;WA80;Zinn und Waren daraus;9397;39386;-29989
01.05.21;WA81;Andere unedle Metalle, Cermets usw.;102615;127829;-25214
01.05.21;WA82;Werkzeuge, Schneidwaren, Essbestecke;741740;473810;267930
01.05.21;WA83;Verschiedene Waren aus unedlen Metallen;677330;413551;263779
01.05.21;WA84;Maschinen, Apparate, mechanische Geräte;18539660;11971465;6568195
01.05.21;WA85;Elektrotechnische Erzeugnisse;11880941;11637406;243535
01.05.21;WA86;Schienenfahrzeuge;249307;229661;19646
01.05.21;WA87;Kraftfahrzeuge, Landfahrzeuge;16434527;9196155;7238372
01.05.21;WA88;Luftfahrzeuge, Raumfahrzeuge;2132306;578632;1553674
01.05.21;WA89;Wasserfahrzeuge;151558;135546;16012
01.05.21;WA90;Optische, photografische usw. Erzeugnisse;5608381;3380122;2228259
01.05.21;WA91;Uhrmacherwaren;121222;176937;-55715
01.05.21;WA92;Musikinstrumente;52764;51316;1448
01.05.21;WA93;Waffen und Munition;50376;21450;28926
01.05.21;WA94;Möbel, Beleuchtungskörper usw.;1381926;1708855;-326929
01.05.21;WA95;Spielzeug, Spiele usw., Sportgeräte;403282;667817;-264535
01.05.21;WA96;Verschiedene Waren;323090;244059;79031
01.05.21;WA97;Kunstgegenstände, Sammlungsstücke;136391;46662;89729
01.05.21;WA98;Vollständige Fabrikationsanlagen;27820;NULL;#WERT!
01.05.21;WA99;Zusammenstellungen verschiedener Waren;1304350;919644;384706
01.05.22;WA01;Lebende Tiere;106970;119409;-12439
01.05.22;WA02;Fleisch;632111;670859;-38748
01.05.22;WA03;Fische, Krebs- und Weichtiere;132346;356856;-224510
01.05.22;WA04;Milch, Milcherzeugnisse, Eier, Honig;1051744;935968;115776
01.05.22;WA05;Andere Waren tierischen Ursprungs;88844;103064;-14220
01.05.22;WA06;Pflanzen, Waren des Blumenhandels;122338;387442;-265104
01.05.22;WA07;Gemüse, Pflanzen für Ernährung;106797;619932;-513135
01.05.22;WA08;Geniessbare Früchte und Nüsse;169742;1037012;-867270
01.05.22;WA09;Kaffee, Tee, Mate, Gewürze;326071;602452;-276381
01.05.22;WA10;Getreide;272693;403332;-130639
01.05.22;WA11;Müllereierzeugnisse, Malz usw.;180408;85216;95192
01.05.22;WA12;Ölsamen usw., Heilpflanzen usw.;112870;913237;-800367
01.05.22;WA13;Schellack, Gummen, Harz, Pflanzensaft;65398;71433;-6035
01.05.22;WA14;Flechtstoffe usw. pflanzlichen Ursprungs;1134;4965;-3831
01.05.22;WA15;Tierische und pflanzliche Fette, Öle, Wachs;430699;629551;-198852
01.05.22;WA16;Zubereitungen von Fleisch, Fisch usw.;294754;300880;-6126
01.05.22;WA17;Zucker und Zuckerwaren;268619;167592;101027
01.05.22;WA18;Kakao und Zubereitungen aus Kakao;442433;376427;66006
01.05.22;WA19;Zubereitungen aus Getreide usw., Backwaren;651106;474881;176225
01.05.22;WA20;Zubereitungen von Gemüse, Früchten usw.;269261;493392;-224131
01.05.22;WA21;Verschiedene Lebensmittelzubereitungen;683211;428728;254483
01.05.22;WA22;Getränke, alkoholhaltige Flüssigkeiten, Essig;622789;853194;-230405
01.05.22;WA23;Rückstände der Lebensmittelindustrie, Futter;538610;512020;26590
01.05.22;WA24;Tabak;240445;281220;-40775
01.05.22;WA25;Salz, Schwefel, Steine, Erden usw.;211701;213848;-2147
01.05.22;WA26;Erze, Schlacken, Aschen;102225;899850;-797625
01.05.22;WA27;Mineralische Brennstoffe usw.;4581397;15394589;-10813192
01.05.22;WA28;Anorganische chemische Erzeugnisse;1358305;968015;390290
01.05.22;WA29;Organische chemische Erzeugnisse;4017302;10209291;-6191989
01.05.22;WA30;Pharmazeutische Erzeugnisse;11440378;5899041;5541337
01.05.22;WA31;Düngemittel;453941;184568;269373
01.05.22;WA32;Gerb- und Farbstoffe, Farben, Lacke usw.;1139920;622001;517919
01.05.22;WA33;Etherische Öle, Riech-, Schönheitsmittel;959167;677515;281652
01.05.22;WA34;Seifen, Waschmittel usw.;815771;472274;343497
01.05.22;WA35;Eiweissstoffe, Klebstoffe, Enzyme;422547;258020;164527
01.05.22;WA36;Sprengstoffe, pyrotechnische Artikel usw.;24369;14433;9936
01.05.22;WA37;Photochemische Erzeugnisse;103013;66143;36870
01.05.22;WA38;Verschiedene Erzeugnisse der Chemischen Industrie;2789327;1951474;837853
01.05.22;WA39;Kunststoffe und Waren daraus;7156267;5109153;2047114
01.05.22;WA40;Kautschuk und Waren daraus;1465039;1504818;-39779
01.05.22;WA41;Häute, Felle, Leder;62026;50513;11513
01.05.22;WA42;Lederwaren, Sattlerwaren;235361;408117;-172756
01.05.22;WA43;Pelzfelle, künstliches Pelzwerk;2748;5696;-2948
01.05.22;WA44;Holz, Holzwaren, Holzkohle;1246260;1133733;112527
01.05.22;WA45;Kork, Korkwaren;2762;10666;-7904
01.05.22;WA46;Flechtwaren, Korbmacherwaren;7463;21471;-14008
01.05.22;WA47;Halbstoffe aus Holz usw., Papierabfall;132946;462466;-329520
01.05.22;WA48;Papier, Pappe und Waren daraus;2150280;1343583;806697
01.05.22;WA49;Bücher, Zeitungen, Bilddrucke usw.;304889;254938;49951
01.05.22;WA50;Seide;1673;3247;-1574
01.05.22;WA51;Wolle, feine und grobe Tierhaare;48490;60728;-12238
01.05.22;WA52;Baumwolle;61037;87423;-26386
01.05.22;WA53;Andere pflanzliche Spinnstoffe, Papiergarn;3173;8741;-5568
01.05.22;WA54;Synthetisches oder künstliches Filament;154327;145332;8995
01.05.22;WA55;Synthetische oder künstliche Spinnfaser;142625;148093;-5468
01.05.22;WA56;Watte, Filz, Vliesstoff usw., Tauwerk;246560;172233;74327
01.05.22;WA57;Teppiche, Fussbodenbelag aus Spinnstoff;44903;96385;-51482
01.05.22;WA58;Spezialgewebe, Spitzen, Tapisserien;47400;24388;23012
01.05.22;WA59;Getränkte, bestrichene usw. Gewebe;226569;111602;114967
01.05.22;WA60;Gewirke und Gestricke;67861;47198;20663
01.05.22;WA61;Bekleidung usw. aus Gewirken, Gestricken;1041414;1859395;-817981
01.05.22;WA62;Andere Bekleidung, Bekleidungszubehör;1005163;1602974;-597811
01.05.22;WA63;Andere Konfektion, Spinnstoffwaren usw.;276227;484839;-208612
01.05.22;WA64;Schuhe, Gamaschen, ähnliche Waren;779314;1139245;-359931
01.05.22;WA65;Kopfbedeckungen und Teile davon;62256;85628;-23372
01.05.22;WA66;Schirme, Gehstöcke usw., Peitschen;12373;43329;-30956
01.05.22;WA67;Zugerichtete Federn, Daunen, künstliche Blumen;14438;24743;-10305
01.05.22;WA68;Waren aus Steinen, Gips, Zement usw.;495872;364123;131749
01.05.22;WA69;Keramische Waren;358365;319857;38508
01.05.22;WA70;Glas und Glaswaren;691187;505637;185550
01.05.22;WA71;Perlen, Edelsteine, Edelmetalle;2025033;3349908;-1324875
01.05.22;WA72;Eisen und Stahl;3502173;3743187;-241014
01.05.22;WA73;Waren aus Eisen oder Stahl;2896963;2775280;121683
01.05.22;WA74;Kupfer und Waren daraus;1471725;1479361;-7636
01.05.22;WA75;Nickel und Waren daraus;169797;292733;-122936
01.05.22;WA76;Aluminium und Waren daraus;1901941;2514113;-612172
01.05.22;WA78;Blei und Waren daraus;35681;54274;-18593
01.05.22;WA79;Zink und Waren daraus;96189;173782;-77593
01.05.22;WA80;Zinn und Waren daraus;17192;61852;-44660
01.05.22;WA81;Andere unedle Metalle, Cermets usw.;156995;226197;-69202
01.05.22;WA82;Werkzeuge, Schneidwaren, Essbestecke;780145;561679;218466
01.05.22;WA83;Verschiedene Waren aus unedlen Metallen;725807;531735;194072
01.05.22;WA84;Maschinen, Apparate, mechanische Geräte;20587646;14217547;6370099
01.05.22;WA85;Elektrotechnische Erzeugnisse;13975652;15483124;-1507472
01.05.22;WA86;Schienenfahrzeuge;186215;249566;-63351
01.05.22;WA87;Kraftfahrzeuge, Landfahrzeuge;21199220;11600163;9599057
01.05.22;WA88;Luftfahrzeuge, Raumfahrzeuge;2066439;740317;1326122
01.05.22;WA89;Wasserfahrzeuge;356720;142335;214385
01.05.22;WA90;Optische, photografische usw. Erzeugnisse;6230304;3741794;2488510
01.05.22;WA91;Uhrmacherwaren;158261;220737;-62476
01.05.22;WA92;Musikinstrumente;74902;63007;11895
01.05.22;WA93;Waffen und Munition;60482;32528;27954
01.05.22;WA94;Möbel, Beleuchtungskörper usw.;1532367;2128778;-596411
01.05.22;WA95;Spielzeug, Spiele usw., Sportgeräte;452149;769031;-316882
01.05.22;WA96;Verschiedene Waren;361748;292786;68962
01.05.22;WA97;Kunstgegenstände, Sammlungsstücke;144537;42985;101552
01.05.22;WA98;Vollständige Fabrikationsanlagen;50792;NULL;#WERT!
01.05.22;WA99;Zusammenstellungen verschiedener Waren;1432775;961032;471743
01.05.23;WA01;Lebende Tiere;130307;161152;-30845
01.05.23;WA02;Fleisch;640527;681317;-40790
01.05.23;WA03;Fische, Krebs- und Weichtiere;126742;372648;-245906
01.05.23;WA04;Milch, Milcherzeugnisse, Eier, Honig;1066338;948968;117370
01.05.23;WA05;Andere Waren tierischen Ursprungs;85025;111588;-26563
01.05.23;WA06;Pflanzen, Waren des Blumenhandels;119293;393871;-274578
01.05.23;WA07;Gemüse, Pflanzen für Ernährung;136701;778679;-641978
01.05.23;WA08;Geniessbare Früchte und Nüsse;170457;1057582;-887125
01.05.23;WA09;Kaffee, Tee, Mate, Gewürze;313187;454358;-141171
01.05.23;WA10;Getreide;282857;343034;-60177
01.05.23;WA11;Müllereierzeugnisse, Malz usw.;216189;96052;120137
01.05.23;WA12;Ölsamen usw., Heilpflanzen usw.;115204;695200;-579996
01.05.23;WA13;Schellack, Gummen, Harz, Pflanzensaft;52632;51176;1456
01.05.23;WA14;Flechtstoffe usw. pflanzlichen Ursprungs;991;4235;-3244
01.05.23;WA15;Tierische und pflanzliche Fette, Öle, Wachs;366681;429300;-62619
01.05.23;WA16;Zubereitungen von Fleisch, Fisch usw.;333705;328840;4865
01.05.23;WA17;Zucker und Zuckerwaren;307796;220061;87735
01.05.23;WA18;Kakao und Zubereitungen aus Kakao;502353;420598;81755
01.05.23;WA19;Zubereitungen aus Getreide usw., Backwaren;784764;572241;212523
01.05.23;WA20;Zubereitungen von Gemüse, Früchten usw.;290532;544420;-253888
01.05.23;WA21;Verschiedene Lebensmittelzubereitungen;778417;463928;314489
01.05.23;WA22;Getränke, alkoholhaltige Flüssigkeiten, Essig;663595;801473;-137878
01.05.23;WA23;Rückstände der Lebensmittelindustrie, Futter;617863;514812;103051
01.05.23;WA24;Tabak;255338;474604;-219266
01.05.23;WA25;Salz, Schwefel, Steine, Erden usw.;231580;194708;36872
01.05.23;WA26;Erze, Schlacken, Aschen;73197;1053241;-980044
01.05.23;WA27;Mineralische Brennstoffe usw.;2340829;9683420;-7342591
01.05.23;WA28;Anorganische chemische Erzeugnisse;1102690;737395;365295
01.05.23;WA29;Organische chemische Erzeugnisse;2640636;4469318;-1828682
01.05.23;WA30;Pharmazeutische Erzeugnisse;8053159;5770760;2282399
01.05.23;WA31;Düngemittel;219899;144139;75760
01.05.23;WA32;Gerb- und Farbstoffe, Farben, Lacke usw.;1001437;466881;534556
01.05.23;WA33;Etherische Öle, Riech-, Schönheitsmittel;1007685;705703;301982
01.05.23;WA34;Seifen, Waschmittel usw.;729883;431759;298124
01.05.23;WA35;Eiweissstoffe, Klebstoffe, Enzyme;380231;244305;135926
01.05.23;WA36;Sprengstoffe, pyrotechnische Artikel usw.;35643;18232;17411
01.05.23;WA37;Photochemische Erzeugnisse;85095;47810;37285
01.05.23;WA38;Verschiedene Erzeugnisse der Chemischen Industrie;2727810;1731916;995894
01.05.23;WA39;Kunststoffe und Waren daraus;5856037;4099061;1756976
01.05.23;WA40;Kautschuk und Waren daraus;1418600;1366881;51719
01.05.23;WA41;Häute, Felle, Leder;55184;44896;10288
01.05.23;WA42;Lederwaren, Sattlerwaren;244318;395121;-150803
01.05.23;WA43;Pelzfelle, künstliches Pelzwerk;3575;5681;-2106
01.05.23;WA44;Holz, Holzwaren, Holzkohle;899664;782431;117233
01.05.23;WA45;Kork, Korkwaren;2045;8243;-6198
01.05.23;WA46;Flechtwaren, Korbmacherwaren;6852;12552;-5700
01.05.23;WA47;Halbstoffe aus Holz usw., Papierabfall;96826;314786;-217960
01.05.23;WA48;Papier, Pappe und Waren daraus;1751756;1137409;614347
01.05.23;WA49;Bücher, Zeitungen, Bilddrucke usw.;268677;233508;35169
01.05.23;WA50;Seide;2046;4254;-2208
01.05.23;WA51;Wolle, feine und grobe Tierhaare;41859;50652;-8793
01.05.23;WA52;Baumwolle;60416;66140;-5724
01.05.23;WA53;Andere pflanzliche Spinnstoffe, Papiergarn;2745;5379;-2634
01.05.23;WA54;Synthetisches oder künstliches Filament;146475;123523;22952
01.05.23;WA55;Synthetische oder künstliche Spinnfaser;135944;119420;16524
01.05.23;WA56;Watte, Filz, Vliesstoff usw., Tauwerk;225604;156314;69290
01.05.23;WA57;Teppiche, Fussbodenbelag aus Spinnstoff;46919;88068;-41149
01.05.23;WA58;Spezialgewebe, Spitzen, Tapisserien;46469;24231;22238
01.05.23;WA59;Getränkte, bestrichene usw. Gewebe;232394;117426;114968
01.05.23;WA60;Gewirke und Gestricke;62718;42307;20411
01.05.23;WA61;Bekleidung usw. aus Gewirken, Gestricken;973946;1402887;-428941
01.05.23;WA62;Andere Bekleidung, Bekleidungszubehör;973088;1319969;-346881
01.05.23;WA63;Andere Konfektion, Spinnstoffwaren usw.;272222;396111;-123889
01.05.23;WA64;Schuhe, Gamaschen, ähnliche Waren;788040;1095261;-307221
01.05.23;WA65;Kopfbedeckungen und Teile davon;60411;68948;-8537
01.05.23;WA66;Schirme, Gehstöcke usw., Peitschen;13701;23367;-9666
01.05.23;WA67;Zugerichtete Federn, Daunen, künstliche Blumen;13782;21583;-7801
01.05.23;WA68;Waren aus Steinen, Gips, Zement usw.;475794;331025;144769
01.05.23;WA69;Keramische Waren;330487;274102;56385
01.05.23;WA70;Glas und Glaswaren;694286;527461;166825
01.05.23;WA71;Perlen, Edelsteine, Edelmetalle;1885275;2626123;-740848
01.05.23;WA72;Eisen und Stahl;2754838;2724236;30602
01.05.23;WA73;Waren aus Eisen oder Stahl;2880157;2436040;444117
01.05.23;WA74;Kupfer und Waren daraus;1218550;1061151;157399
01.05.23;WA75;Nickel und Waren daraus;185301;241633;-56332
01.05.23;WA76;Aluminium und Waren daraus;1611915;2034017;-422102
01.05.23;WA78;Blei und Waren daraus;38959;62035;-23076
01.05.23;WA79;Zink und Waren daraus;53114;161483;-108369
01.05.23;WA80;Zinn und Waren daraus;13232;39387;-26155
01.05.23;WA81;Andere unedle Metalle, Cermets usw.;151769;204465;-52696
01.05.23;WA82;Werkzeuge, Schneidwaren, Essbestecke;787102;508376;278726
01.05.23;WA83;Verschiedene Waren aus unedlen Metallen;700869;486896;213973
01.05.23;WA84;Maschinen, Apparate, mechanische Geräte;21811945;13881883;7930062
01.05.23;WA85;Elektrotechnische Erzeugnisse;14832836;17672251;-2839415
01.05.23;WA86;Schienenfahrzeuge;214238;272846;-58608
01.05.23;WA87;Kraftfahrzeuge, Landfahrzeuge;23969442;13149102;10820340
01.05.23;WA88;Luftfahrzeuge, Raumfahrzeuge;3292074;1152146;2139928
01.05.23;WA89;Wasserfahrzeuge;247436;724730;-477294
01.05.23;WA90;Optische, photografische usw. Erzeugnisse;6533636;3976571;2557065
01.05.23;WA91;Uhrmacherwaren;156243;213396;-57153
01.05.23;WA92;Musikinstrumente;80915;60519;20396
01.05.23;WA93;Waffen und Munition;57835;34858;22977
01.05.23;WA94;Möbel, Beleuchtungskörper usw.;1481484;1832827;-351343
01.05.23;WA95;Spielzeug, Spiele usw., Sportgeräte;400334;681080;-280746
01.05.23;WA96;Verschiedene Waren;364336;319233;45103
01.05.23;WA97;Kunstgegenstände, Sammlungsstücke;71937;61009;10928
01.05.23;WA98;Vollständige Fabrikationsanlagen;94754;248;94506
01.05.23;WA99;Zusammenstellungen verschiedener Waren;1625429;1017900;607529
01.05.24;WA01;Lebende Tiere;116816;158123;-41307
01.05.24;WA02;Fleisch;620042;629798;-9756
01.05.24;WA03;Fische, Krebs- und Weichtiere;111335;305391;-194056
01.05.24;WA04;Milch, Milcherzeugnisse, Eier, Honig;1081610;944641;136969
01.05.24;WA05;Andere Waren tierischen Ursprungs;75245;87094;-11849
01.05.24;WA06;Pflanzen, Waren des Blumenhandels;100682;358021;-257339
01.05.24;WA07;Gemüse, Pflanzen für Ernährung;144793;738223;-593430
01.05.24;WA08;Geniessbare Früchte und Nüsse;176374;1116150;-939776
01.05.24;WA09;Kaffee, Tee, Mate, Gewürze;341590;501620;-160030
01.05.24;WA10;Getreide;234890;303332;-68442
01.05.24;WA11;Müllereierzeugnisse, Malz usw.;197460;82477;114983
01.05.24;WA12;Ölsamen usw., Heilpflanzen usw.;130665;463191;-332526
01.05.24;WA13;Schellack, Gummen, Harz, Pflanzensaft;53931;63338;-9407
01.05.24;WA14;Flechtstoffe usw. pflanzlichen Ursprungs;1038;4107;-3069
01.05.24;WA15;Tierische und pflanzliche Fette, Öle, Wachs;286571;396815;-110244
01.05.24;WA16;Zubereitungen von Fleisch, Fisch usw.;307139;303319;3820
01.05.24;WA17;Zucker und Zuckerwaren;299931;210857;89074
01.05.24;WA18;Kakao und Zubereitungen aus Kakao;654736;640959;13777
01.05.24;WA19;Zubereitungen aus Getreide usw., Backwaren;792822;569571;223251
01.05.24;WA20;Zubereitungen von Gemüse, Früchten usw.;313118;566417;-253299
01.05.24;WA21;Verschiedene Lebensmittelzubereitungen;804561;503182;301379
01.05.24;WA22;Getränke, alkoholhaltige Flüssigkeiten, Essig;660677;726782;-66105
01.05.24;WA23;Rückstände der Lebensmittelindustrie, Futter;563955;481167;82788
01.05.24;WA24;Tabak;270892;491345;-220453
01.05.24;WA25;Salz, Schwefel, Steine, Erden usw.;211717;160587;51130
01.05.24;WA26;Erze, Schlacken, Aschen;58942;632004;-573062
01.05.24;WA27;Mineralische Brennstoffe usw.;2808978;9585290;-6776312
01.05.24;WA28;Anorganische chemische Erzeugnisse;991136;618258;372878
01.05.24;WA29;Organische chemische Erzeugnisse;2599133;2847178;-248045
01.05.24;WA30;Pharmazeutische Erzeugnisse;8948378;5449095;3499283
01.05.24;WA31;Düngemittel;213739;101304;112435
01.05.24;WA32;Gerb- und Farbstoffe, Farben, Lacke usw.;980103;454803;525300
01.05.24;WA33;Etherische Öle, Riech-, Schönheitsmittel;976684;748701;227983
01.05.24;WA34;Seifen, Waschmittel usw.;747681;413960;333721
01.05.24;WA35;Eiweissstoffe, Klebstoffe, Enzyme;411266;235426;175840
01.05.24;WA36;Sprengstoffe, pyrotechnische Artikel usw.;31875;19605;12270
01.05.24;WA37;Photochemische Erzeugnisse;81990;50402;31588
01.05.24;WA38;Verschiedene Erzeugnisse der Chemischen Industrie;2722788;1653251;1069537
01.05.24;WA39;Kunststoffe und Waren daraus;5730414;3790899;1939515
01.05.24;WA40;Kautschuk und Waren daraus;1356052;1233325;122727
01.05.24;WA41;Häute, Felle, Leder;47715;38755;8960
01.05.24;WA42;Lederwaren, Sattlerwaren;237515;367984;-130469
01.05.24;WA43;Pelzfelle, künstliches Pelzwerk;3644;4175;-531
01.05.24;WA44;Holz, Holzwaren, Holzkohle;827417;674922;152495
01.05.24;WA45;Kork, Korkwaren;1769;6532;-4763
01.05.24;WA46;Flechtwaren, Korbmacherwaren;6141;13220;-7079
01.05.24;WA47;Halbstoffe aus Holz usw., Papierabfall;123958;379275;-255317
01.05.24;WA48;Papier, Pappe und Waren daraus;1684715;1091618;593097
01.05.24;WA49;Bücher, Zeitungen, Bilddrucke usw.;256382;198598;57784
01.05.24;WA50;Seide;2014;3840;-1826
01.05.24;WA51;Wolle, feine und grobe Tierhaare;36047;38049;-2002
01.05.24;WA52;Baumwolle;44699;51907;-7208
01.05.24;WA53;Andere pflanzliche Spinnstoffe, Papiergarn;2462;6129;-3667
01.05.24;WA54;Synthetisches oder künstliches Filament;131121;114902;16219
01.05.24;WA55;Synthetische oder künstliche Spinnfaser;117459;119084;-1625
01.05.24;WA56;Watte, Filz, Vliesstoff usw., Tauwerk;218313;142579;75734
01.05.24;WA57;Teppiche, Fussbodenbelag aus Spinnstoff;49181;88937;-39756
01.05.24;WA58;Spezialgewebe, Spitzen, Tapisserien;44334;20809;23525
01.05.24;WA59;Getränkte, bestrichene usw. Gewebe;221221;102110;119111
01.05.24;WA60;Gewirke und Gestricke;55543;36521;19022
01.05.24;WA61;Bekleidung usw. aus Gewirken, Gestricken;979386;1551472;-572086
01.05.24;WA62;Andere Bekleidung, Bekleidungszubehör;994732;1441137;-446405
01.05.24;WA63;Andere Konfektion, Spinnstoffwaren usw.;251036;355279;-104243
01.05.24;WA64;Schuhe, Gamaschen, ähnliche Waren;815904;937331;-121427
01.05.24;WA65;Kopfbedeckungen und Teile davon;58782;72948;-14166
01.05.24;WA66;Schirme, Gehstöcke usw., Peitschen;10245;26737;-16492
01.05.24;WA67;Zugerichtete Federn, Daunen, künstliche Blumen;11425;19643;-8218
01.05.24;WA68;Waren aus Steinen, Gips, Zement usw.;448268;285102;163166
01.05.24;WA69;Keramische Waren;313161;226903;86258
01.05.24;WA70;Glas und Glaswaren;632993;440788;192205
01.05.24;WA71;Perlen, Edelsteine, Edelmetalle;2108202;1431979;676223
01.05.24;WA72;Eisen und Stahl;2450467;2281675;168792
01.05.24;WA73;Waren aus Eisen oder Stahl;2786116;2057480;728636
01.05.24;WA74;Kupfer und Waren daraus;1243197;1176587;66610
01.05.24;WA75;Nickel und Waren daraus;158738;199231;-40493
01.05.24;WA76;Aluminium und Waren daraus;1562527;1709426;-146899
01.05.24;WA78;Blei und Waren daraus;35729;46098;-10369
01.05.24;WA79;Zink und Waren daraus;66142;106000;-39858
01.05.24;WA80;Zinn und Waren daraus;12276;40746;-28470
01.05.24;WA81;Andere unedle Metalle, Cermets usw.;137718;169575;-31857
01.05.24;WA82;Werkzeuge, Schneidwaren, Essbestecke;738022;455627;282395
01.05.24;WA83;Verschiedene Waren aus unedlen Metallen;674000;436618;237382
01.05.24;WA84;Maschinen, Apparate, mechanische Geräte;20158262;12876572;7281690
01.05.24;WA85;Elektrotechnische Erzeugnisse;13449390;14927452;-1478062
01.05.24;WA86;Schienenfahrzeuge;281569;269502;12067
01.05.24;WA87;Kraftfahrzeuge, Landfahrzeuge;21510476;11759133;9751343
01.05.24;WA88;Luftfahrzeuge, Raumfahrzeuge;2501719;902773;1598946
01.05.24;WA89;Wasserfahrzeuge;657583;240877;416706
01.05.24;WA90;Optische, photografische usw. Erzeugnisse;6261022;3667690;2593332
01.05.24;WA91;Uhrmacherwaren;174974;207533;-32559
01.05.24;WA92;Musikinstrumente;71330;49728;21602
01.05.24;WA93;Waffen und Munition;60961;26694;34267
01.05.24;WA94;Möbel, Beleuchtungskörper usw.;1361358;1703614;-342256
01.05.24;WA95;Spielzeug, Spiele usw., Sportgeräte;359962;548469;-188507
01.05.24;WA96;Verschiedene Waren;344944;288867;56077
01.05.24;WA97;Kunstgegenstände, Sammlungsstücke;54057;49475;4582
01.05.24;WA98;Vollständige Fabrikationsanlagen;112024;NULL;#WERT!
01.05.24;WA99;Zusammenstellungen verschiedener Waren;1485138;1019884;465254
01.05.25;WA01;Lebende Tiere;NULL;NULL;#WERT!
01.05.25;WA02;Fleisch;NULL;NULL;#WERT!
01.05.25;WA03;Fische, Krebs- und Weichtiere;NULL;NULL;#WERT!
01.05.25;WA04;Milch, Milcherzeugnisse, Eier, Honig;NULL;NULL;#WERT!
01.05.25;WA05;Andere Waren tierischen Ursprungs;NULL;NULL;#WERT!
01.05.25;WA06;Pflanzen, Waren des Blumenhandels;NULL;NULL;#WERT!
01.05.25;WA07;Gemüse, Pflanzen für Ernährung;NULL;NULL;#WERT!
01.05.25;WA08;Geniessbare Früchte und Nüsse;NULL;NULL;#WERT!
01.05.25;WA09;Kaffee, Tee, Mate, Gewürze;NULL;NULL;#WERT!
01.05.25;WA10;Getreide;NULL;NULL;#WERT!
01.05.25;WA11;Müllereierzeugnisse, Malz usw.;NULL;NULL;#WERT!
01.05.25;WA12;Ölsamen usw., Heilpflanzen usw.;NULL;NULL;#WERT!
01.05.25;WA13;Schellack, Gummen, Harz, Pflanzensaft;NULL;NULL;#WERT!
01.05.25;WA14;Flechtstoffe usw. pflanzlichen Ursprungs;NULL;NULL;#WERT!
01.05.25;WA15;Tierische und pflanzliche Fette, Öle, Wachs;NULL;NULL;#WERT!
01.05.25;WA16;Zubereitungen von Fleisch, Fisch usw.;NULL;NULL;#WERT!
01.05.25;WA17;Zucker und Zuckerwaren;NULL;NULL;#WERT!
01.05.25;WA18;Kakao und Zubereitungen aus Kakao;NULL;NULL;#WERT!
01.05.25;WA19;Zubereitungen aus Getreide usw., Backwaren;NULL;NULL;#WERT!
01.05.25;WA20;Zubereitungen von Gemüse, Früchten usw.;NULL;NULL;#WERT!
01.05.25;WA21;Verschiedene Lebensmittelzubereitungen;NULL;NULL;#WERT!
01.05.25;WA22;Getränke, alkoholhaltige Flüssigkeiten, Essig;NULL;NULL;#WERT!
01.05.25;WA23;Rückstände der Lebensmittelindustrie, Futter;NULL;NULL;#WERT!
01.05.25;WA24;Tabak;NULL;NULL;#WERT!
01.05.25;WA25;Salz, Schwefel, Steine, Erden usw.;NULL;NULL;#WERT!
01.05.25;WA26;Erze, Schlacken, Aschen;NULL;NULL;#WERT!
01.05.25;WA27;Mineralische Brennstoffe usw.;NULL;NULL;#WERT!
01.05.25;WA28;Anorganische chemische Erzeugnisse;NULL;NULL;#WERT!
01.05.25;WA29;Organische chemische Erzeugnisse;NULL;NULL;#WERT!
01.05.25;WA30;Pharmazeutische Erzeugnisse;NULL;NULL;#WERT!
01.05.25;WA31;Düngemittel;NULL;NULL;#WERT!
01.05.25;WA32;Gerb- und Farbstoffe, Farben, Lacke usw.;NULL;NULL;#WERT!
01.05.25;WA33;Etherische Öle, Riech-, Schönheitsmittel;NULL;NULL;#WERT!
01.05.25;WA34;Seifen, Waschmittel usw.;NULL;NULL;#WERT!
01.05.25;WA35;Eiweissstoffe, Klebstoffe, Enzyme;NULL;NULL;#WERT!
01.05.25;WA36;Sprengstoffe, pyrotechnische Artikel usw.;NULL;NULL;#WERT!
01.05.25;WA37;Photochemische Erzeugnisse;NULL;NULL;#WERT!
01.05.25;WA38;Verschiedene Erzeugnisse der Chemischen Industrie;NULL;NULL;#WERT!
01.05.25;WA39;Kunststoffe und Waren daraus;NULL;NULL;#WERT!
01.05.25;WA40;Kautschuk und Waren daraus;NULL;NULL;#WERT!
01.05.25;WA41;Häute, Felle, Leder;NULL;NULL;#WERT!
01.05.25;WA42;Lederwaren, Sattlerwaren;NULL;NULL;#WERT!
01.05.25;WA43;Pelzfelle, künstliches Pelzwerk;NULL;NULL;#WERT!
01.05.25;WA44;Holz, Holzwaren, Holzkohle;NULL;NULL;#WERT!
01.05.25;WA45;Kork, Korkwaren;NULL;NULL;#WERT!
01.05.25;WA46;Flechtwaren, Korbmacherwaren;NULL;NULL;#WERT!
01.05.25;WA47;Halbstoffe aus Holz usw., Papierabfall;NULL;NULL;#WERT!
01.05.25;WA48;Papier, Pappe und Waren daraus;NULL;NULL;#WERT!
01.05.25;WA49;Bücher, Zeitungen, Bilddrucke usw.;NULL;NULL;#WERT!
01.05.25;WA50;Seide;NULL;NULL;#WERT!
01.05.25;WA51;Wolle, feine und grobe Tierhaare;NULL;NULL;#WERT!
01.05.25;WA52;Baumwolle;NULL;NULL;#WERT!
01.05.25;WA53;Andere pflanzliche Spinnstoffe, Papiergarn;NULL;NULL;#WERT!
01.05.25;WA54;Synthetisches oder künstliches Filament;NULL;NULL;#WERT!
01.05.25;WA55;Synthetische oder künstliche Spinnfaser;NULL;NULL;#WERT!
01.05.25;WA56;Watte, Filz, Vliesstoff usw., Tauwerk;NULL;NULL;#WERT!
01.05.25;WA57;Teppiche, Fussbodenbelag aus Spinnstoff;NULL;NULL;#WERT!
01.05.25;WA58;Spezialgewebe, Spitzen, Tapisserien;NULL;NULL;#WERT!
01.05.25;WA59;Getränkte, bestrichene usw. Gewebe;NULL;NULL;#WERT!
01.05.25;WA60;Gewirke und Gestricke;NULL;NULL;#WERT!
01.05.25;WA61;Bekleidung usw. aus Gewirken, Gestricken;NULL;NULL;#WERT!
01.05.25;WA62;Andere Bekleidung, Bekleidungszubehör;NULL;NULL;#WERT!
01.05.25;WA63;Andere Konfektion, Spinnstoffwaren usw.;NULL;NULL;#WERT!
01.05.25;WA64;Schuhe, Gamaschen, ähnliche Waren;NULL;NULL;#WERT!
01.05.25;WA65;Kopfbedeckungen und Teile davon;NULL;NULL;#WERT!
01.05.25;WA66;Schirme, Gehstöcke usw., Peitschen;NULL;NULL;#WERT!
01.05.25;WA67;Zugerichtete Federn, Daunen, künstliche Blumen;NULL;NULL;#WERT!
01.05.25;WA68;Waren aus Steinen, Gips, Zement usw.;NULL;NULL;#WERT!
01.05.25;WA69;Keramische Waren;NULL;NULL;#WERT!
01.05.25;WA70;Glas und Glaswaren;NULL;NULL;#WERT!
01.05.25;WA71;Perlen, Edelsteine, Edelmetalle;NULL;NULL;#WERT!
01.05.25;WA72;Eisen und Stahl;NULL;NULL;#WERT!
01.05.25;WA73;Waren aus Eisen oder Stahl;NULL;NULL;#WERT!
01.05.25;WA74;Kupfer und Waren daraus;NULL;NULL;#WERT!
01.05.25;WA75;Nickel und Waren daraus;NULL;NULL;#WERT!
01.05.25;WA76;Aluminium und Waren daraus;NULL;NULL;#WERT!
01.05.25;WA78;Blei und Waren daraus;NULL;NULL;#WERT!
01.05.25;WA79;Zink und Waren daraus;NULL;NULL;#WERT!
01.05.25;WA80;Zinn und Waren daraus;NULL;NULL;#WERT!
01.05.25;WA81;Andere unedle Metalle, Cermets usw.;NULL;NULL;#WERT!
01.05.25;WA82;Werkzeuge, Schneidwaren, Essbestecke;NULL;NULL;#WERT!
01.05.25;WA83;Verschiedene Waren aus unedlen Metallen;NULL;NULL;#WERT!
01.05.25;WA84;Maschinen, Apparate, mechanische Geräte;NULL;NULL;#WERT!
01.05.25;WA85;Elektrotechnische Erzeugnisse;NULL;NULL;#WERT!
01.05.25;WA86;Schienenfahrzeuge;NULL;NULL;#WERT!
01.05.25;WA87;Kraftfahrzeuge, Landfahrzeuge;NULL;NULL;#WERT!
01.05.25;WA88;Luftfahrzeuge, Raumfahrzeuge;NULL;NULL;#WERT!
01.05.25;WA89;Wasserfahrzeuge;NULL;NULL;#WERT!
01.05.25;WA90;Optische, photografische usw. Erzeugnisse;NULL;NULL;#WERT!
01.05.25;WA91;Uhrmacherwaren;NULL;NULL;#WERT!
01.05.25;WA92;Musikinstrumente;NULL;NULL;#WERT!
01.05.25;WA93;Waffen und Munition;NULL;NULL;#WERT!
01.05.25;WA94;Möbel, Beleuchtungskörper usw.;NULL;NULL;#WERT!
01.05.25;WA95;Spielzeug, Spiele usw., Sportgeräte;NULL;NULL;#WERT!
01.05.25;WA96;Verschiedene Waren;NULL;NULL;#WERT!
01.05.25;WA97;Kunstgegenstände, Sammlungsstücke;NULL;NULL;#WERT!
01.05.25;WA98;Vollständige Fabrikationsanlagen;NULL;NULL;#WERT!
01.05.25;WA99;Zusammenstellungen verschiedener Waren;NULL;NULL;#WERT!
01.06.08;WA01;Lebende Tiere;80844;120708;-39864
01.06.08;WA02;Fleisch;547960;427284;120676
01.06.08;WA03;Fische, Krebs- und Weichtiere;86326;164930;-78604
01.06.08;WA04;Milch, Milcherzeugnisse, Eier, Honig;578474;437103;141371
01.06.08;WA05;Andere Waren tierischen Ursprungs;46914;64421;-17507
01.06.08;WA06;Pflanzen, Waren des Blumenhandels;50439;201676;-151237
01.06.08;WA07;Gemüse, Pflanzen für Ernährung;72047;379329;-307282
01.06.08;WA08;Geniessbare Früchte und Nüsse;127198;531583;-404385
01.06.08;WA09;Kaffee, Tee, Mate, Gewürze;129584;222468;-92884
01.06.08;WA10;Getreide;209555;161936;47619
01.06.08;WA11;Müllereierzeugnisse, Malz usw.;95793;48738;47055
01.06.08;WA12;Ölsamen usw., Heilpflanzen usw.;75151;305168;-230017
01.06.08;WA13;Schellack, Gummen, Harz, Pflanzensaft;41651;24969;16682
01.06.08;WA14;Flechtstoffe usw. pflanzlichen Ursprungs;992;2286;-1294
01.06.08;WA15;Tierische und pflanzliche Fette, Öle, Wachs;191396;260354;-68958
01.06.08;WA16;Zubereitungen von Fleisch, Fisch usw.;196764;163202;33562
01.06.08;WA17;Zucker und Zuckerwaren;110110;124256;-14146
01.06.08;WA18;Kakao und Zubereitungen aus Kakao;141564;155237;-13673
01.06.08;WA19;Zubereitungen aus Getreide usw., Backwaren;341847;202608;139239
01.06.08;WA20;Zubereitungen von Gemüse, Früchten usw.;216159;325609;-109450
01.06.08;WA21;Verschiedene Lebensmittelzubereitungen;311447;219588;91859
01.06.08;WA22;Getränke, alkoholhaltige Flüssigkeiten, Essig;387955;439544;-51589
01.06.08;WA23;Rückstände der Lebensmittelindustrie, Futter;210069;200882;9187
01.06.08;WA24;Tabak;328539;130007;198532
01.06.08;WA25;Salz, Schwefel, Steine, Erden usw.;209063;156806;52257
01.06.08;WA26;Erze, Schlacken, Aschen;25764;459836;-434072
01.06.08;WA27;Mineralische Brennstoffe usw.;2666270;9362488;-6696218
01.06.08;WA28;Anorganische chemische Erzeugnisse;596300;474432;121868
01.06.08;WA29;Organische chemische Erzeugnisse;2673390;2097836;575554
01.06.08;WA30;Pharmazeutische Erzeugnisse;3562674;2651556;911118
01.06.08;WA31;Düngemittel;243733;152829;90904
01.06.08;WA32;Gerb- und Farbstoffe, Farben, Lacke usw.;760268;334132;426136
01.06.08;WA33;Etherische Öle, Riech-, Schönheitsmittel;574634;330725;243909
01.06.08;WA34;Seifen, Waschmittel usw.;455644;192232;263412
01.06.08;WA35;Eiweissstoffe, Klebstoffe, Enzyme;202065;135084;66981
01.06.08;WA36;Sprengstoffe, pyrotechnische Artikel usw.;21457;14547;6910
01.06.08;WA37;Photochemische Erzeugnisse;115284;61435;53849
01.06.08;WA38;Verschiedene Erzeugnisse der Chemischen Industrie;1205423;856272;349151
01.06.08;WA39;Kunststoffe und Waren daraus;4086846;2391086;1695760
01.06.08;WA40;Kautschuk und Waren daraus;877928;822268;55660
01.06.08;WA41;Häute, Felle, Leder;89964;66250;23714
01.06.08;WA42;Lederwaren, Sattlerwaren;98817;194349;-95532
01.06.08;WA43;Pelzfelle, künstliches Pelzwerk;16011;15218;793
01.06.08;WA44;Holz, Holzwaren, Holzkohle;693050;461585;231465
01.06.08;WA45;Kork, Korkwaren;2752;7641;-4889
01.06.08;WA46;Flechtwaren, Korbmacherwaren;3422;10101;-6679
01.06.08;WA47;Halbstoffe aus Holz usw., Papierabfall;108305;304916;-196611
01.06.08;WA48;Papier, Pappe und Waren daraus;1565307;977281;588026
01.06.08;WA49;Bücher, Zeitungen, Bilddrucke usw.;399684;169411;230273
01.06.08;WA50;Seide;7232;6496;736
01.06.08;WA51;Wolle, feine und grobe Tierhaare;70729;77065;-6336
01.06.08;WA52;Baumwolle;89464;85328;4136
01.06.08;WA53;Andere pflanzliche Spinnstoffe, Papiergarn;3487;4984;-1497
01.06.08;WA54;Synthetisches oder künstliches Filament;209920;136562;73358
01.06.08;WA55;Synthetische oder künstliche Spinnfaser;172452;125233;47219
01.06.08;WA56;Watte, Filz, Vliesstoff usw., Tauwerk;179646;91054;88592
01.06.08;WA57;Teppiche, Fussbodenbelag aus Spinnstoff;42687;80193;-37506
01.06.08;WA58;Spezialgewebe, Spitzen, Tapisserien;45343;27639;17704
01.06.08;WA59;Getränkte, bestrichene usw. Gewebe;156474;103719;52755
01.06.08;WA60;Gewirke und Gestricke;76569;37382;39187
01.06.08;WA61;Bekleidung usw. aus Gewirken, Gestricken;345520;768825;-423305
01.06.08;WA62;Andere Bekleidung, Bekleidungszubehör;417423;823903;-406480
01.06.08;WA63;Andere Konfektion, Spinnstoffwaren usw.;133922;197405;-63483
01.06.08;WA64;Schuhe, Gamaschen, ähnliche Waren;190265;375966;-185701
01.06.08;WA65;Kopfbedeckungen und Teile davon;17319;23239;-5920
01.06.08;WA66;Schirme, Gehstöcke usw., Peitschen;10263;11133;-870
01.06.08;WA67;Zugerichtete Federn, Daunen, künstliche Blumen;4706;11184;-6478
01.06.08;WA68;Waren aus Steinen, Gips, Zement usw.;319759;201426;118333
01.06.08;WA69;Keramische Waren;244245;175125;69120
01.06.08;WA70;Glas und Glaswaren;436489;312731;123758
01.06.08;WA71;Perlen, Edelsteine, Edelmetalle;810745;995726;-184981
01.06.08;WA72;Eisen und Stahl;2611559;2902543;-290984
01.06.08;WA73;Waren aus Eisen oder Stahl;2329018;1461211;867807
01.06.08;WA74;Kupfer und Waren daraus;872228;1073480;-201252
01.06.08;WA75;Nickel und Waren daraus;111840;160034;-48194
01.06.08;WA76;Aluminium und Waren daraus;1131901;1082992;48909
01.06.08;WA78;Blei und Waren daraus;37094;40374;-3280
01.06.08;WA79;Zink und Waren daraus;51749;65984;-14235
01.06.08;WA80;Zinn und Waren daraus;8291;34625;-26334
01.06.08;WA81;Andere unedle Metalle, Cermets usw.;103646;145016;-41370
01.06.08;WA82;Werkzeuge, Schneidwaren, Essbestecke;532774;328321;204453
01.06.08;WA83;Verschiedene Waren aus unedlen Metallen;571430;318395;253035
01.06.08;WA84;Maschinen, Apparate, mechanische Geräte;16498054;8639150;7858904
01.06.08;WA85;Elektrotechnische Erzeugnisse;8562372;6603304;1959068
01.06.08;WA86;Schienenfahrzeuge;284110;133877;150233
01.06.08;WA87;Kraftfahrzeuge, Landfahrzeuge;14793764;5992908;8800856
01.06.08;WA88;Luftfahrzeuge, Raumfahrzeuge;1690425;1227109;463316
01.06.08;WA89;Wasserfahrzeuge;316086;136921;179165
01.06.08;WA90;Optische, photografische usw. Erzeugnisse;3404832;1809304;1595528
01.06.08;WA91;Uhrmacherwaren;83812;96546;-12734
01.06.08;WA92;Musikinstrumente;39576;25053;14523
01.06.08;WA93;Waffen und Munition;39091;15117;23974
01.06.08;WA94;Möbel, Beleuchtungskörper usw.;1047397;951431;95966
01.06.08;WA95;Spielzeug, Spiele usw., Sportgeräte;631630;562162;69468
01.06.08;WA96;Verschiedene Waren;164630;104050;60580
01.06.08;WA97;Kunstgegenstände, Sammlungsstücke;44873;31044;13829
01.06.08;WA98;Vollständige Fabrikationsanlagen;404262;2576;401686
01.06.08;WA99;Zusammenstellungen verschiedener Waren;1180271;973282;206989
01.06.09;WA01;Lebende Tiere;79185;96487;-17302
01.06.09;WA02;Fleisch;458452;372895;85557
01.06.09;WA03;Fische, Krebs- und Weichtiere;71910;205003;-133093
01.06.09;WA04;Milch, Milcherzeugnisse, Eier, Honig;499167;411729;87438
01.06.09;WA05;Andere Waren tierischen Ursprungs;53141;57633;-4492
01.06.09;WA06;Pflanzen, Waren des Blumenhandels;44686;201135;-156449
01.06.09;WA07;Gemüse, Pflanzen für Ernährung;65313;315909;-250596
01.06.09;WA08;Geniessbare Früchte und Nüsse;106375;475436;-369061
01.06.09;WA09;Kaffee, Tee, Mate, Gewürze;119726;203397;-83671
01.06.09;WA10;Getreide;262551;143193;119358
01.06.09;WA11;Müllereierzeugnisse, Malz usw.;72343;37536;34807
01.06.09;WA12;Ölsamen usw., Heilpflanzen usw.;48457;248103;-199646
01.06.09;WA13;Schellack, Gummen, Harz, Pflanzensaft;40506;25531;14975
01.06.09;WA14;Flechtstoffe usw. pflanzlichen Ursprungs;578;1469;-891
01.06.09;WA15;Tierische und pflanzliche Fette, Öle, Wachs;141346;185045;-43699
01.06.09;WA16;Zubereitungen von Fleisch, Fisch usw.;181689;150928;30761
01.06.09;WA17;Zucker und Zuckerwaren;123050;106732;16318
01.06.09;WA18;Kakao und Zubereitungen aus Kakao;166163;157287;8876
01.06.09;WA19;Zubereitungen aus Getreide usw., Backwaren;309629;169909;139720
01.06.09;WA20;Zubereitungen von Gemüse, Früchten usw.;176032;287211;-111179
01.06.09;WA21;Verschiedene Lebensmittelzubereitungen;312667;214727;97940
01.06.09;WA22;Getränke, alkoholhaltige Flüssigkeiten, Essig;367051;431775;-64724
01.06.09;WA23;Rückstände der Lebensmittelindustrie, Futter;188035;204257;-16222
01.06.09;WA24;Tabak;273995;137610;136385
01.06.09;WA25;Salz, Schwefel, Steine, Erden usw.;167828;106615;61213
01.06.09;WA26;Erze, Schlacken, Aschen;14945;332585;-317640
01.06.09;WA27;Mineralische Brennstoffe usw.;1478161;5764438;-4286277
01.06.09;WA28;Anorganische chemische Erzeugnisse;606048;498852;107196
01.06.09;WA29;Organische chemische Erzeugnisse;1522623;1514353;8270
01.06.09;WA30;Pharmazeutische Erzeugnisse;3590730;2423276;1167454
01.06.09;WA31;Düngemittel;141708;58849;82859
01.06.09;WA32;Gerb- und Farbstoffe, Farben, Lacke usw.;666750;262298;404452
01.06.09;WA33;Etherische Öle, Riech-, Schönheitsmittel;492672;288487;204185
01.06.09;WA34;Seifen, Waschmittel usw.;385293;195002;190291
01.06.09;WA35;Eiweissstoffe, Klebstoffe, Enzyme;161047;110479;50568
01.06.09;WA36;Sprengstoffe, pyrotechnische Artikel usw.;14990;15377;-387
01.06.09;WA37;Photochemische Erzeugnisse;102174;66290;35884
01.06.09;WA38;Verschiedene Erzeugnisse der Chemischen Industrie;1039687;719455;320232
01.06.09;WA39;Kunststoffe und Waren daraus;3226168;1772520;1453648
01.06.09;WA40;Kautschuk und Waren daraus;762633;616828;145805
01.06.09;WA41;Häute, Felle, Leder;49187;45938;3249
01.06.09;WA42;Lederwaren, Sattlerwaren;98521;197636;-99115
01.06.09;WA43;Pelzfelle, künstliches Pelzwerk;9722;11952;-2230
01.06.09;WA44;Holz, Holzwaren, Holzkohle;518015;382465;135550
01.06.09;WA45;Kork, Korkwaren;2536;5369;-2833
01.06.09;WA46;Flechtwaren, Korbmacherwaren;3301;10512;-7211
01.06.09;WA47;Halbstoffe aus Holz usw., Papierabfall;78011;171314;-93303
01.06.09;WA48;Papier, Pappe und Waren daraus;1274212;799806;474406
01.06.09;WA49;Bücher, Zeitungen, Bilddrucke usw.;340547;156893;183654
01.06.09;WA50;Seide;4506;4367;139
01.06.09;WA51;Wolle, feine und grobe Tierhaare;58155;46332;11823
01.06.09;WA52;Baumwolle;69763;58656;11107
01.06.09;WA53;Andere pflanzliche Spinnstoffe, Papiergarn;2247;4448;-2201
01.06.09;WA54;Synthetisches oder künstliches Filament;134742;92234;42508
01.06.09;WA55;Synthetische oder künstliche Spinnfaser;136861;88873;47988
01.06.09;WA56;Watte, Filz, Vliesstoff usw., Tauwerk;146205;70963;75242
01.06.09;WA57;Teppiche, Fussbodenbelag aus Spinnstoff;37751;71968;-34217
01.06.09;WA58;Spezialgewebe, Spitzen, Tapisserien;39524;24849;14675
01.06.09;WA59;Getränkte, bestrichene usw. Gewebe;127862;99752;28110
01.06.09;WA60;Gewirke und Gestricke;56287;29384;26903
01.06.09;WA61;Bekleidung usw. aus Gewirken, Gestricken;340582;864224;-523642
01.06.09;WA62;Andere Bekleidung, Bekleidungszubehör;389392;872613;-483221
01.06.09;WA63;Andere Konfektion, Spinnstoffwaren usw.;130582;187294;-56712
01.06.09;WA64;Schuhe, Gamaschen, ähnliche Waren;190020;430599;-240579
01.06.09;WA65;Kopfbedeckungen und Teile davon;16129;26598;-10469
01.06.09;WA66;Schirme, Gehstöcke usw., Peitschen;18142;8965;9177
01.06.09;WA67;Zugerichtete Federn, Daunen, künstliche Blumen;3963;10872;-6909
01.06.09;WA68;Waren aus Steinen, Gips, Zement usw.;245579;155775;89804
01.06.09;WA69;Keramische Waren;216187;150463;65724
01.06.09;WA70;Glas und Glaswaren;374093;264433;109660
01.06.09;WA71;Perlen, Edelsteine, Edelmetalle;603550;695063;-91513
01.06.09;WA72;Eisen und Stahl;1342364;1103999;238365
01.06.09;WA73;Waren aus Eisen oder Stahl;1621207;983386;637821
01.06.09;WA74;Kupfer und Waren daraus;496607;480257;16350
01.06.09;WA75;Nickel und Waren daraus;51320;62438;-11118
01.06.09;WA76;Aluminium und Waren daraus;738498;621166;117332
01.06.09;WA78;Blei und Waren daraus;30376;17027;13349
01.06.09;WA79;Zink und Waren daraus;37268;45512;-8244
01.06.09;WA80;Zinn und Waren daraus;6501;13359;-6858
01.06.09;WA81;Andere unedle Metalle, Cermets usw.;51388;58324;-6936
01.06.09;WA82;Werkzeuge, Schneidwaren, Essbestecke;379442;220150;159292
01.06.09;WA83;Verschiedene Waren aus unedlen Metallen;436973;241036;195937
01.06.09;WA84;Maschinen, Apparate, mechanische Geräte;11922199;6784024;5138175
01.06.09;WA85;Elektrotechnische Erzeugnisse;6597519;5783302;814217
01.06.09;WA86;Schienenfahrzeuge;265978;139090;126888
01.06.09;WA87;Kraftfahrzeuge, Landfahrzeuge;10145089;5134224;5010865
01.06.09;WA88;Luftfahrzeuge, Raumfahrzeuge;2050321;1446445;603876
01.06.09;WA89;Wasserfahrzeuge;544843;271797;273046
01.06.09;WA90;Optische, photografische usw. Erzeugnisse;2765983;1674928;1091055
01.06.09;WA91;Uhrmacherwaren;68987;77662;-8675
01.06.09;WA92;Musikinstrumente;32838;29071;3767
01.06.09;WA93;Waffen und Munition;28438;12851;15587
01.06.09;WA94;Möbel, Beleuchtungskörper usw.;889041;857962;31079
01.06.09;WA95;Spielzeug, Spiele usw., Sportgeräte;317773;312405;5368
01.06.09;WA96;Verschiedene Waren;141229;87894;53335
01.06.09;WA97;Kunstgegenstände, Sammlungsstücke;43116;51088;-7972
01.06.09;WA98;Vollständige Fabrikationsanlagen;414902;4645;410257
01.06.09;WA99;Zusammenstellungen verschiedener Waren;1226968;1031606;195362
01.06.10;WA01;Lebende Tiere;100418;123868;-23450
01.06.10;WA02;Fleisch;543914;407937;135977
01.06.10;WA03;Fische, Krebs- und Weichtiere;87490;214303;-126813
01.06.10;WA04;Milch, Milcherzeugnisse, Eier, Honig;612316;462755;149561
01.06.10;WA05;Andere Waren tierischen Ursprungs;53673;62921;-9248
01.06.10;WA06;Pflanzen, Waren des Blumenhandels;45683;235464;-189781
01.06.10;WA07;Gemüse, Pflanzen für Ernährung;72260;399773;-327513
01.06.10;WA08;Geniessbare Früchte und Nüsse;110670;559932;-449262
01.06.10;WA09;Kaffee, Tee, Mate, Gewürze;147157;294706;-147549
01.06.10;WA10;Getreide;183275;112722;70553
01.06.10;WA11;Müllereierzeugnisse, Malz usw.;72231;31647;40584
01.06.10;WA12;Ölsamen usw., Heilpflanzen usw.;51127;180106;-128979
01.06.10;WA13;Schellack, Gummen, Harz, Pflanzensaft;47523;32459;15064
01.06.10;WA14;Flechtstoffe usw. pflanzlichen Ursprungs;765;2710;-1945
01.06.10;WA15;Tierische und pflanzliche Fette, Öle, Wachs;155979;282565;-126586
01.06.10;WA16;Zubereitungen von Fleisch, Fisch usw.;185134;162618;22516
01.06.10;WA17;Zucker und Zuckerwaren;136864;101827;35037
01.06.10;WA18;Kakao und Zubereitungen aus Kakao;206398;216474;-10076
01.06.10;WA19;Zubereitungen aus Getreide usw., Backwaren;341449;201843;139606
01.06.10;WA20;Zubereitungen von Gemüse, Früchten usw.;168006;293367;-125361
01.06.10;WA21;Verschiedene Lebensmittelzubereitungen;343460;235129;108331
01.06.10;WA22;Getränke, alkoholhaltige Flüssigkeiten, Essig;403835;466435;-62600
01.06.10;WA23;Rückstände der Lebensmittelindustrie, Futter;211414;222939;-11525
01.06.10;WA24;Tabak;321645;136111;185534
01.06.10;WA25;Salz, Schwefel, Steine, Erden usw.;199702;150985;48717
01.06.10;WA26;Erze, Schlacken, Aschen;29724;745111;-715387
01.06.10;WA27;Mineralische Brennstoffe usw.;1597708;8129124;-6531416
01.06.10;WA28;Anorganische chemische Erzeugnisse;649261;506342;142919
01.06.10;WA29;Organische chemische Erzeugnisse;1877242;1849810;27432
01.06.10;WA30;Pharmazeutische Erzeugnisse;4102135;2825633;1276502
01.06.10;WA31;Düngemittel;181067;60974;120093
01.06.10;WA32;Gerb- und Farbstoffe, Farben, Lacke usw.;798506;365734;432772
01.06.10;WA33;Etherische Öle, Riech-, Schönheitsmittel;622215;363530;258685
01.06.10;WA34;Seifen, Waschmittel usw.;450649;229220;221429
01.06.10;WA35;Eiweissstoffe, Klebstoffe, Enzyme;206980;137319;69661
01.06.10;WA36;Sprengstoffe, pyrotechnische Artikel usw.;16933;18410;-1477
01.06.10;WA37;Photochemische Erzeugnisse;85929;71873;14056
01.06.10;WA38;Verschiedene Erzeugnisse der Chemischen Industrie;1432295;929125;503170
01.06.10;WA39;Kunststoffe und Waren daraus;4195012;2472517;1722495
01.06.10;WA40;Kautschuk und Waren daraus;1055225;972223;83002
01.06.10;WA41;Häute, Felle, Leder;76913;69142;7771
01.06.10;WA42;Lederwaren, Sattlerwaren;112479;226856;-114377
01.06.10;WA43;Pelzfelle, künstliches Pelzwerk;11070;16222;-5152
01.06.10;WA44;Holz, Holzwaren, Holzkohle;599607;520723;78884
01.06.10;WA45;Kork, Korkwaren;2883;6849;-3966
01.06.10;WA46;Flechtwaren, Korbmacherwaren;3565;10413;-6848
01.06.10;WA47;Halbstoffe aus Holz usw., Papierabfall;107926;379929;-272003
01.06.10;WA48;Papier, Pappe und Waren daraus;1596525;981112;615413
01.06.10;WA49;Bücher, Zeitungen, Bilddrucke usw.;319579;165671;153908
01.06.10;WA50;Seide;5656;6402;-746
01.06.10;WA51;Wolle, feine und grobe Tierhaare;65496;68332;-2836
01.06.10;WA52;Baumwolle;87727;79818;7909
01.06.10;WA53;Andere pflanzliche Spinnstoffe, Papiergarn;2572;4829;-2257
01.06.10;WA54;Synthetisches oder künstliches Filament;169820;113445;56375
01.06.10;WA55;Synthetische oder künstliche Spinnfaser;167517;114632;52885
01.06.10;WA56;Watte, Filz, Vliesstoff usw., Tauwerk;172545;93691;78854
01.06.10;WA57;Teppiche, Fussbodenbelag aus Spinnstoff;43805;81470;-37665
01.06.10;WA58;Spezialgewebe, Spitzen, Tapisserien;44945;28501;16444
01.06.10;WA59;Getränkte, bestrichene usw. Gewebe;161695;77646;84049
01.06.10;WA60;Gewirke und Gestricke;75482;41274;34208
01.06.10;WA61;Bekleidung usw. aus Gewirken, Gestricken;412711;957993;-545282
01.06.10;WA62;Andere Bekleidung, Bekleidungszubehör;429443;946495;-517052
01.06.10;WA63;Andere Konfektion, Spinnstoffwaren usw.;157734;256762;-99028
01.06.10;WA64;Schuhe, Gamaschen, ähnliche Waren;208809;465398;-256589
01.06.10;WA65;Kopfbedeckungen und Teile davon;19646;32371;-12725
01.06.10;WA66;Schirme, Gehstöcke usw., Peitschen;7156;13239;-6083
01.06.10;WA67;Zugerichtete Federn, Daunen, künstliche Blumen;4283;12979;-8696
01.06.10;WA68;Waren aus Steinen, Gips, Zement usw.;310631;210382;100249
01.06.10;WA69;Keramische Waren;242223;176760;65463
01.06.10;WA70;Glas und Glaswaren;447046;335652;111394
01.06.10;WA71;Perlen, Edelsteine, Edelmetalle;1044356;1455578;-411222
01.06.10;WA72;Eisen und Stahl;2167255;2133440;33815
01.06.10;WA73;Waren aus Eisen oder Stahl;2057531;1247167;810364
01.06.10;WA74;Kupfer und Waren daraus;934768;794742;140026
01.06.10;WA75;Nickel und Waren daraus;75056;164457;-89401
01.06.10;WA76;Aluminium und Waren daraus;998974;1073793;-74819
01.06.10;WA78;Blei und Waren daraus;34676;23437;11239
01.06.10;WA79;Zink und Waren daraus;54749;90218;-35469
01.06.10;WA80;Zinn und Waren daraus;8037;34849;-26812
01.06.10;WA81;Andere unedle Metalle, Cermets usw.;91018;105916;-14898
01.06.10;WA82;Werkzeuge, Schneidwaren, Essbestecke;510394;298852;211542
01.06.10;WA83;Verschiedene Waren aus unedlen Metallen;551164;318634;232530
01.06.10;WA84;Maschinen, Apparate, mechanische Geräte;15074290;8989840;6084450
01.06.10;WA85;Elektrotechnische Erzeugnisse;8795244;8772371;22873
01.06.10;WA86;Schienenfahrzeuge;418390;187085;231305
01.06.10;WA87;Kraftfahrzeuge, Landfahrzeuge;14214881;5483843;8731038
01.06.10;WA88;Luftfahrzeuge, Raumfahrzeuge;2556321;2116079;440242
01.06.10;WA89;Wasserfahrzeuge;102445;1181452;-1079007
01.06.10;WA90;Optische, photografische usw. Erzeugnisse;3758501;2023796;1734705
01.06.10;WA91;Uhrmacherwaren;94034;126349;-32315
01.06.10;WA92;Musikinstrumente;45057;37194;7863
01.06.10;WA93;Waffen und Munition;41905;13393;28512
01.06.10;WA94;Möbel, Beleuchtungskörper usw.;1032214;1063731;-31517
01.06.10;WA95;Spielzeug, Spiele usw., Sportgeräte;289364;376263;-86899
01.06.10;WA96;Verschiedene Waren;169502;116770;52732
01.06.10;WA97;Kunstgegenstände, Sammlungsstücke;134983;34007;100976
01.06.10;WA98;Vollständige Fabrikationsanlagen;320489;169570;150919
01.06.10;WA99;Zusammenstellungen verschiedener Waren;1564140;1003327;560813
01.06.11;WA01;Lebende Tiere;106144;136848;-30704
01.06.11;WA02;Fleisch;611136;478846;132290
01.06.11;WA03;Fische, Krebs- und Weichtiere;104288;239758;-135470
01.06.11;WA04;Milch, Milcherzeugnisse, Eier, Honig;699251;547441;151810
01.06.11;WA05;Andere Waren tierischen Ursprungs;65650;72134;-6484
01.06.11;WA06;Pflanzen, Waren des Blumenhandels;55631;235594;-179963
01.06.11;WA07;Gemüse, Pflanzen für Ernährung;70216;353097;-282881
01.06.11;WA08;Geniessbare Früchte und Nüsse;112330;596174;-483844
01.06.11;WA09;Kaffee, Tee, Mate, Gewürze;229061;402818;-173757
01.06.11;WA10;Getreide;189242;160660;28582
01.06.11;WA11;Müllereierzeugnisse, Malz usw.;83953;45856;38097
01.06.11;WA12;Ölsamen usw., Heilpflanzen usw.;70903;260003;-189100
01.06.11;WA13;Schellack, Gummen, Harz, Pflanzensaft;36390;33268;3122
01.06.11;WA14;Flechtstoffe usw. pflanzlichen Ursprungs;1376;3203;-1827
01.06.11;WA15;Tierische und pflanzliche Fette, Öle, Wachs;215479;372885;-157406
01.06.11;WA16;Zubereitungen von Fleisch, Fisch usw.;210372;177092;33280
01.06.11;WA17;Zucker und Zuckerwaren;124451;112323;12128
01.06.11;WA18;Kakao und Zubereitungen aus Kakao;255608;248418;7190
01.06.11;WA19;Zubereitungen aus Getreide usw., Backwaren;361861;224032;137829
01.06.11;WA20;Zubereitungen von Gemüse, Früchten usw.;182021;341882;-159861
01.06.11;WA21;Verschiedene Lebensmittelzubereitungen;380317;194108;186209
01.06.11;WA22;Getränke, alkoholhaltige Flüssigkeiten, Essig;437041;519843;-82802
01.06.11;WA23;Rückstände der Lebensmittelindustrie, Futter;220459;239118;-18659
01.06.11;WA24;Tabak;316098;147887;168211
01.06.11;WA25;Salz, Schwefel, Steine, Erden usw.;194616;186624;7992
01.06.11;WA26;Erze, Schlacken, Aschen;25890;1000616;-974726
01.06.11;WA27;Mineralische Brennstoffe usw.;2125339;8743159;-6617820
01.06.11;WA28;Anorganische chemische Erzeugnisse;663456;569747;93709
01.06.11;WA29;Organische chemische Erzeugnisse;1940394;2177765;-237371
01.06.11;WA30;Pharmazeutische Erzeugnisse;4151875;2770875;1381000
01.06.11;WA31;Düngemittel;204667;142220;62447
01.06.11;WA32;Gerb- und Farbstoffe, Farben, Lacke usw.;803597;420844;382753
01.06.11;WA33;Etherische Öle, Riech-, Schönheitsmittel;591558;358964;232594
01.06.11;WA34;Seifen, Waschmittel usw.;485380;253441;231939
01.06.11;WA35;Eiweissstoffe, Klebstoffe, Enzyme;222156;162303;59853
01.06.11;WA36;Sprengstoffe, pyrotechnische Artikel usw.;12233;15254;-3021
01.06.11;WA37;Photochemische Erzeugnisse;82614;61965;20649
01.06.11;WA38;Verschiedene Erzeugnisse der Chemischen Industrie;1579656;1036945;542711
01.06.11;WA39;Kunststoffe und Waren daraus;4378585;2769198;1609387
01.06.11;WA40;Kautschuk und Waren daraus;1144882;1224115;-79233
01.06.11;WA41;Häute, Felle, Leder;93673;87779;5894
01.06.11;WA42;Lederwaren, Sattlerwaren;114769;262722;-147953
01.06.11;WA43;Pelzfelle, künstliches Pelzwerk;17273;19082;-1809
01.06.11;WA44;Holz, Holzwaren, Holzkohle;588578;589529;-951
01.06.11;WA45;Kork, Korkwaren;2464;5860;-3396
01.06.11;WA46;Flechtwaren, Korbmacherwaren;3541;10768;-7227
01.06.11;WA47;Halbstoffe aus Holz usw., Papierabfall;108673;361241;-252568
01.06.11;WA48;Papier, Pappe und Waren daraus;1571761;1012391;559370
01.06.11;WA49;Bücher, Zeitungen, Bilddrucke usw.;327632;152725;174907
01.06.11;WA50;Seide;5059;6274;-1215
01.06.11;WA51;Wolle, feine und grobe Tierhaare;72001;77025;-5024
01.06.11;WA52;Baumwolle;94606;109996;-15390
01.06.11;WA53;Andere pflanzliche Spinnstoffe, Papiergarn;3057;5997;-2940
01.06.11;WA54;Synthetisches oder künstliches Filament;169749;129405;40344
01.06.11;WA55;Synthetische oder künstliche Spinnfaser;165271;148519;16752
01.06.11;WA56;Watte, Filz, Vliesstoff usw., Tauwerk;184522;95559;88963
01.06.11;WA57;Teppiche, Fussbodenbelag aus Spinnstoff;41725;84079;-42354
01.06.11;WA58;Spezialgewebe, Spitzen, Tapisserien;41596;29428;12168
01.06.11;WA59;Getränkte, bestrichene usw. Gewebe;164089;94818;69271
01.06.11;WA60;Gewirke und Gestricke;79758;45085;34673
01.06.11;WA61;Bekleidung usw. aus Gewirken, Gestricken;456196;1087607;-631411
01.06.11;WA62;Andere Bekleidung, Bekleidungszubehör;458577;1084032;-625455
01.06.11;WA63;Andere Konfektion, Spinnstoffwaren usw.;171377;298037;-126660
01.06.11;WA64;Schuhe, Gamaschen, ähnliche Waren;259915;515984;-256069
01.06.11;WA65;Kopfbedeckungen und Teile davon;15900;30932;-15032
01.06.11;WA66;Schirme, Gehstöcke usw., Peitschen;6547;13012;-6465
01.06.11;WA67;Zugerichtete Federn, Daunen, künstliche Blumen;6208;13278;-7070
01.06.11;WA68;Waren aus Steinen, Gips, Zement usw.;318347;233321;85026
01.06.11;WA69;Keramische Waren;249515;193434;56081
01.06.11;WA70;Glas und Glaswaren;440407;350169;90238
01.06.11;WA71;Perlen, Edelsteine, Edelmetalle;1058864;1377885;-319021
01.06.11;WA72;Eisen und Stahl;2330616;2618623;-288007
01.06.11;WA73;Waren aus Eisen oder Stahl;2078361;1521329;557032
01.06.11;WA74;Kupfer und Waren daraus;975415;932940;42475
01.06.11;WA75;Nickel und Waren daraus;89365;148217;-58852
01.06.11;WA76;Aluminium und Waren daraus;1139015;1249582;-110567
01.06.11;WA78;Blei und Waren daraus;39904;26960;12944
01.06.11;WA79;Zink und Waren daraus;57404;98408;-41004
01.06.11;WA80;Zinn und Waren daraus;12821;38274;-25453
01.06.11;WA81;Andere unedle Metalle, Cermets usw.;107304;123890;-16586
01.06.11;WA82;Werkzeuge, Schneidwaren, Essbestecke;542430;360586;181844
01.06.11;WA83;Verschiedene Waren aus unedlen Metallen;546024;330318;215706
01.06.11;WA84;Maschinen, Apparate, mechanische Geräte;15553333;8921495;6631838
01.06.11;WA85;Elektrotechnische Erzeugnisse;8801521;8198203;603318
01.06.11;WA86;Schienenfahrzeuge;314235;115256;198979
01.06.11;WA87;Kraftfahrzeuge, Landfahrzeuge;14093620;6258723;7834897
01.06.11;WA88;Luftfahrzeuge, Raumfahrzeuge;2317804;2451641;-133837
01.06.11;WA89;Wasserfahrzeuge;760767;396381;364386
01.06.11;WA90;Optische, photografische usw. Erzeugnisse;3801890;2113716;1688174
01.06.11;WA91;Uhrmacherwaren;126590;143175;-16585
01.06.11;WA92;Musikinstrumente;37598;43854;-6256
01.06.11;WA93;Waffen und Munition;32790;15765;17025
01.06.11;WA94;Möbel, Beleuchtungskörper usw.;1071849;1083908;-12059
01.06.11;WA95;Spielzeug, Spiele usw., Sportgeräte;308247;379995;-71748
01.06.11;WA96;Verschiedene Waren;168700;121397;47303
01.06.11;WA97;Kunstgegenstände, Sammlungsstücke;154816;33669;121147
01.06.11;WA98;Vollständige Fabrikationsanlagen;254113;1748;252365
01.06.11;WA99;Zusammenstellungen verschiedener Waren;1329887;899500;430387
01.06.12;WA01;Lebende Tiere;121244;139240;-17996
01.06.12;WA02;Fleisch;646236;459566;186670
01.06.12;WA03;Fische, Krebs- und Weichtiere;83202;243039;-159837
01.06.12;WA04;Milch, Milcherzeugnisse, Eier, Honig;651195;482411;168784
01.06.12;WA05;Andere Waren tierischen Ursprungs;60576;79980;-19404
01.06.12;WA06;Pflanzen, Waren des Blumenhandels;50474;235429;-184955
01.06.12;WA07;Gemüse, Pflanzen für Ernährung;84959;397744;-312785
01.06.12;WA08;Geniessbare Früchte und Nüsse;125526;583322;-457796
01.06.12;WA09;Kaffee, Tee, Mate, Gewürze;200014;368141;-168127
01.06.12;WA10;Getreide;185084;159416;25668
01.06.12;WA11;Müllereierzeugnisse, Malz usw.;93086;38812;54274
01.06.12;WA12;Ölsamen usw., Heilpflanzen usw.;54885;369226;-314341
01.06.12;WA13;Schellack, Gummen, Harz, Pflanzensaft;41778;39609;2169
01.06.12;WA14;Flechtstoffe usw. pflanzlichen Ursprungs;1074;2414;-1340
01.06.12;WA15;Tierische und pflanzliche Fette, Öle, Wachs;253437;288554;-35117
01.06.12;WA16;Zubereitungen von Fleisch, Fisch usw.;221447;199126;22321
01.06.12;WA17;Zucker und Zuckerwaren;150643;154706;-4063
01.06.12;WA18;Kakao und Zubereitungen aus Kakao;213145;212419;726
01.06.12;WA19;Zubereitungen aus Getreide usw., Backwaren;403194;231827;171367
01.06.12;WA20;Zubereitungen von Gemüse, Früchten usw.;185911;366079;-180168
01.06.12;WA21;Verschiedene Lebensmittelzubereitungen;388579;216305;172274
01.06.12;WA22;Getränke, alkoholhaltige Flüssigkeiten, Essig;453786;582350;-128564
01.06.12;WA23;Rückstände der Lebensmittelindustrie, Futter;289454;282939;6515
01.06.12;WA24;Tabak;355154;144325;210829
01.06.12;WA25;Salz, Schwefel, Steine, Erden usw.;181787;159017;22770
01.06.12;WA26;Erze, Schlacken, Aschen;30130;629449;-599319
01.06.12;WA27;Mineralische Brennstoffe usw.;2107356;10484509;-8377153
01.06.12;WA28;Anorganische chemische Erzeugnisse;754784;655861;98923
01.06.12;WA29;Organische chemische Erzeugnisse;1971786;2047666;-75880
01.06.12;WA30;Pharmazeutische Erzeugnisse;4606882;3070158;1536724
01.06.12;WA31;Düngemittel;256614;123982;132632
01.06.12;WA32;Gerb- und Farbstoffe, Farben, Lacke usw.;916273;462085;454188
01.06.12;WA33;Etherische Öle, Riech-, Schönheitsmittel;675447;406848;268599
01.06.12;WA34;Seifen, Waschmittel usw.;519391;255531;263860
01.06.12;WA35;Eiweissstoffe, Klebstoffe, Enzyme;231592;160195;71397
01.06.12;WA36;Sprengstoffe, pyrotechnische Artikel usw.;19286;20334;-1048
01.06.12;WA37;Photochemische Erzeugnisse;92187;67217;24970
01.06.12;WA38;Verschiedene Erzeugnisse der Chemischen Industrie;1478608;971526;507082
01.06.12;WA39;Kunststoffe und Waren daraus;4422766;2773551;1649215
01.06.12;WA40;Kautschuk und Waren daraus;1216297;1118320;97977
01.06.12;WA41;Häute, Felle, Leder;85388;78423;6965
01.06.12;WA42;Lederwaren, Sattlerwaren;122426;256766;-134340
01.06.12;WA43;Pelzfelle, künstliches Pelzwerk;19612;18534;1078
01.06.12;WA44;Holz, Holzwaren, Holzkohle;586329;547301;39028
01.06.12;WA45;Kork, Korkwaren;2523;6777;-4254
01.06.12;WA46;Flechtwaren, Korbmacherwaren;3163;10697;-7534
01.06.12;WA47;Halbstoffe aus Holz usw., Papierabfall;90054;304232;-214178
01.06.12;WA48;Papier, Pappe und Waren daraus;1469113;975127;493986
01.06.12;WA49;Bücher, Zeitungen, Bilddrucke usw.;314226;158216;156010
01.06.12;WA50;Seide;6667;7377;-710
01.06.12;WA51;Wolle, feine und grobe Tierhaare;68579;72685;-4106
01.06.12;WA52;Baumwolle;84458;94519;-10061
01.06.12;WA53;Andere pflanzliche Spinnstoffe, Papiergarn;2936;6213;-3277
01.06.12;WA54;Synthetisches oder künstliches Filament;166458;120525;45933
01.06.12;WA55;Synthetische oder künstliche Spinnfaser;164275;132607;31668
01.06.12;WA56;Watte, Filz, Vliesstoff usw., Tauwerk;182046;101123;80923
01.06.12;WA57;Teppiche, Fussbodenbelag aus Spinnstoff;40646;76417;-35771
01.06.12;WA58;Spezialgewebe, Spitzen, Tapisserien;42783;27846;14937
01.06.12;WA59;Getränkte, bestrichene usw. Gewebe;171686;97244;74442
01.06.12;WA60;Gewirke und Gestricke;70174;41338;28836
01.06.12;WA61;Bekleidung usw. aus Gewirken, Gestricken;418872;977756;-558884
01.06.12;WA62;Andere Bekleidung, Bekleidungszubehör;443781;981617;-537836
01.06.12;WA63;Andere Konfektion, Spinnstoffwaren usw.;191292;266966;-75674
01.06.12;WA64;Schuhe, Gamaschen, ähnliche Waren;232652;540037;-307385
01.06.12;WA65;Kopfbedeckungen und Teile davon;17106;30152;-13046
01.06.12;WA66;Schirme, Gehstöcke usw., Peitschen;7480;13346;-5866
01.06.12;WA67;Zugerichtete Federn, Daunen, künstliche Blumen;6009;12944;-6935
01.06.12;WA68;Waren aus Steinen, Gips, Zement usw.;336196;228112;108084
01.06.12;WA69;Keramische Waren;243173;197676;45497
01.06.12;WA70;Glas und Glaswaren;461608;352746;108862
01.06.12;WA71;Perlen, Edelsteine, Edelmetalle;1473802;1398310;75492
01.06.12;WA72;Eisen und Stahl;2213376;2170744;42632
01.06.12;WA73;Waren aus Eisen oder Stahl;2240651;1510903;729748
01.06.12;WA74;Kupfer und Waren daraus;904596;832004;72592
01.06.12;WA75;Nickel und Waren daraus;92360;142710;-50350
01.06.12;WA76;Aluminium und Waren daraus;966048;1176306;-210258
01.06.12;WA78;Blei und Waren daraus;36100;22004;14096
01.06.12;WA79;Zink und Waren daraus;52942;96000;-43058
01.06.12;WA80;Zinn und Waren daraus;9883;26413;-16530
01.06.12;WA81;Andere unedle Metalle, Cermets usw.;121765;139191;-17426
01.06.12;WA82;Werkzeuge, Schneidwaren, Essbestecke;580143;345646;234497
01.06.12;WA83;Verschiedene Waren aus unedlen Metallen;558649;330087;228562
01.06.12;WA84;Maschinen, Apparate, mechanische Geräte;16940645;9401112;7539533
01.06.12;WA85;Elektrotechnische Erzeugnisse;9369512;8390120;979392
01.06.12;WA86;Schienenfahrzeuge;434413;144298;290115
01.06.12;WA87;Kraftfahrzeuge, Landfahrzeuge;15565193;6683076;8882117
01.06.12;WA88;Luftfahrzeuge, Raumfahrzeuge;3220130;1241203;1978927
01.06.12;WA89;Wasserfahrzeuge;364192;229795;134397
01.06.12;WA90;Optische, photografische usw. Erzeugnisse;4266907;2261260;2005647
01.06.12;WA91;Uhrmacherwaren;143580;180327;-36747
01.06.12;WA92;Musikinstrumente;41811;47325;-5514
01.06.12;WA93;Waffen und Munition;36556;18964;17592
01.06.12;WA94;Möbel, Beleuchtungskörper usw.;1158582;1142503;16079
01.06.12;WA95;Spielzeug, Spiele usw., Sportgeräte;244997;328938;-83941
01.06.12;WA96;Verschiedene Waren;286204;176963;109241
01.06.12;WA97;Kunstgegenstände, Sammlungsstücke;160985;32398;128587
01.06.12;WA98;Vollständige Fabrikationsanlagen;325688;11112;314576
01.06.12;WA99;Zusammenstellungen verschiedener Waren;1381481;926420;455061
01.06.13;WA01;Lebende Tiere;123076;176022;-52946
01.06.13;WA02;Fleisch;647777;489792;157985
01.06.13;WA03;Fische, Krebs- und Weichtiere;99666;229346;-129680
01.06.13;WA04;Milch, Milcherzeugnisse, Eier, Honig;712550;540365;172185
01.06.13;WA05;Andere Waren tierischen Ursprungs;75416;75945;-529
01.06.13;WA06;Pflanzen, Waren des Blumenhandels;54588;206852;-152264
01.06.13;WA07;Gemüse, Pflanzen für Ernährung;100637;477187;-376550
01.06.13;WA08;Geniessbare Früchte und Nüsse;126647;698748;-572101
01.06.13;WA09;Kaffee, Tee, Mate, Gewürze;187575;291452;-103877
01.06.13;WA10;Getreide;283687;165241;118446
01.06.13;WA11;Müllereierzeugnisse, Malz usw.;101447;43870;57577
01.06.13;WA12;Ölsamen usw., Heilpflanzen usw.;58273;365418;-307145
01.06.13;WA13;Schellack, Gummen, Harz, Pflanzensaft;42297;37043;5254
01.06.13;WA14;Flechtstoffe usw. pflanzlichen Ursprungs;701;3136;-2435
01.06.13;WA15;Tierische und pflanzliche Fette, Öle, Wachs;293068;308778;-15710
01.06.13;WA16;Zubereitungen von Fleisch, Fisch usw.;220649;190674;29975
01.06.13;WA17;Zucker und Zuckerwaren;149197;147739;1458
01.06.13;WA18;Kakao und Zubereitungen aus Kakao;231424;208383;23041
01.06.13;WA19;Zubereitungen aus Getreide usw., Backwaren;391915;256645;135270
01.06.13;WA20;Zubereitungen von Gemüse, Früchten usw.;194296;339902;-145606
01.06.13;WA21;Verschiedene Lebensmittelzubereitungen;388974;218378;170596
01.06.13;WA22;Getränke, alkoholhaltige Flüssigkeiten, Essig;444610;567050;-122440
01.06.13;WA23;Rückstände der Lebensmittelindustrie, Futter;322277;314325;7952
01.06.13;WA24;Tabak;315932;137316;178616
01.06.13;WA25;Salz, Schwefel, Steine, Erden usw.;179038;154158;24880
01.06.13;WA26;Erze, Schlacken, Aschen;26071;776125;-750054
01.06.13;WA27;Mineralische Brennstoffe usw.;2152684;10756097;-8603413
01.06.13;WA28;Anorganische chemische Erzeugnisse;704100;528432;175668
01.06.13;WA29;Organische chemische Erzeugnisse;1894909;1959810;-64901
01.06.13;WA30;Pharmazeutische Erzeugnisse;4560043;2769213;1790830
01.06.13;WA31;Düngemittel;170413;104424;65989
01.06.13;WA32;Gerb- und Farbstoffe, Farben, Lacke usw.;909993;465563;444430
01.06.13;WA33;Etherische Öle, Riech-, Schönheitsmittel;671258;469312;201946
01.06.13;WA34;Seifen, Waschmittel usw.;527594;256517;271077
01.06.13;WA35;Eiweissstoffe, Klebstoffe, Enzyme;241101;167788;73313
01.06.13;WA36;Sprengstoffe, pyrotechnische Artikel usw.;20349;17554;2795
01.06.13;WA37;Photochemische Erzeugnisse;90741;62894;27847
01.06.13;WA38;Verschiedene Erzeugnisse der Chemischen Industrie;1549228;987369;561859
01.06.13;WA39;Kunststoffe und Waren daraus;4472591;2735157;1737434
01.06.13;WA40;Kautschuk und Waren daraus;1154635;1113675;40960
01.06.13;WA41;Häute, Felle, Leder;95804;81954;13850
01.06.13;WA42;Lederwaren, Sattlerwaren;136040;260969;-124929
01.06.13;WA43;Pelzfelle, künstliches Pelzwerk;19566;18307;1259
01.06.13;WA44;Holz, Holzwaren, Holzkohle;564031;567941;-3910
01.06.13;WA45;Kork, Korkwaren;2537;10251;-7714
01.06.13;WA46;Flechtwaren, Korbmacherwaren;2717;8054;-5337
01.06.13;WA47;Halbstoffe aus Holz usw., Papierabfall;99337;292625;-193288
01.06.13;WA48;Papier, Pappe und Waren daraus;1404744;927562;477182
01.06.13;WA49;Bücher, Zeitungen, Bilddrucke usw.;306243;139698;166545
01.06.13;WA50;Seide;5128;5310;-182
01.06.13;WA51;Wolle, feine und grobe Tierhaare;47358;52396;-5038
01.06.13;WA52;Baumwolle;83267;81279;1988
01.06.13;WA53;Andere pflanzliche Spinnstoffe, Papiergarn;2616;4361;-1745
01.06.13;WA54;Synthetisches oder künstliches Filament;169677;119010;50667
01.06.13;WA55;Synthetische oder künstliche Spinnfaser;162157;129600;32557
01.06.13;WA56;Watte, Filz, Vliesstoff usw., Tauwerk;182658;96545;86113
01.06.13;WA57;Teppiche, Fussbodenbelag aus Spinnstoff;39310;78328;-39018
01.06.13;WA58;Spezialgewebe, Spitzen, Tapisserien;38897;23548;15349
01.06.13;WA59;Getränkte, bestrichene usw. Gewebe;167272;91537;75735
01.06.13;WA60;Gewirke und Gestricke;70435;36857;33578
01.06.13;WA61;Bekleidung usw. aus Gewirken, Gestricken;422114;955541;-533427
01.06.13;WA62;Andere Bekleidung, Bekleidungszubehör;425448;928777;-503329
01.06.13;WA63;Andere Konfektion, Spinnstoffwaren usw.;181861;254629;-72768
01.06.13;WA64;Schuhe, Gamaschen, ähnliche Waren;266042;506665;-240623
01.06.13;WA65;Kopfbedeckungen und Teile davon;19236;29365;-10129
01.06.13;WA66;Schirme, Gehstöcke usw., Peitschen;5880;10525;-4645
01.06.13;WA67;Zugerichtete Federn, Daunen, künstliche Blumen;6827;12393;-5566
01.06.13;WA68;Waren aus Steinen, Gips, Zement usw.;336263;210548;125715
01.06.13;WA69;Keramische Waren;257328;188373;68955
01.06.13;WA70;Glas und Glaswaren;454539;348228;106311
01.06.13;WA71;Perlen, Edelsteine, Edelmetalle;1057083;1524897;-467814
01.06.13;WA72;Eisen und Stahl;1927700;2026714;-99014
01.06.13;WA73;Waren aus Eisen oder Stahl;2186229;1476435;709794
01.06.13;WA74;Kupfer und Waren daraus;899204;853746;45458
01.06.13;WA75;Nickel und Waren daraus;80291;114333;-34042
01.06.13;WA76;Aluminium und Waren daraus;1063555;1134559;-71004
01.06.13;WA78;Blei und Waren daraus;34765;22445;12320
01.06.13;WA79;Zink und Waren daraus;49667;90382;-40715
01.06.13;WA80;Zinn und Waren daraus;11121;31713;-20592
01.06.13;WA81;Andere unedle Metalle, Cermets usw.;124038;129335;-5297
01.06.13;WA82;Werkzeuge, Schneidwaren, Essbestecke;594836;347007;247829
01.06.13;WA83;Verschiedene Waren aus unedlen Metallen;571408;331767;239641
01.06.13;WA84;Maschinen, Apparate, mechanische Geräte;16319343;8915856;7403487
01.06.13;WA85;Elektrotechnische Erzeugnisse;9149684;7799974;1349710
01.06.13;WA86;Schienenfahrzeuge;310668;195612;115056
01.06.13;WA87;Kraftfahrzeuge, Landfahrzeuge;15266651;6331540;8935111
01.06.13;WA88;Luftfahrzeuge, Raumfahrzeuge;3198891;2083404;1115487
01.06.13;WA89;Wasserfahrzeuge;243987;169417;74570
01.06.13;WA90;Optische, photografische usw. Erzeugnisse;4302900;2339746;1963154
01.06.13;WA91;Uhrmacherwaren;157992;184405;-26413
01.06.13;WA92;Musikinstrumente;40769;33458;7311
01.06.13;WA93;Waffen und Munition;53002;20460;32542
01.06.13;WA94;Möbel, Beleuchtungskörper usw.;1109471;1101491;7980
01.06.13;WA95;Spielzeug, Spiele usw., Sportgeräte;231411;299377;-67966
01.06.13;WA96;Verschiedene Waren;294019;187784;106235
01.06.13;WA97;Kunstgegenstände, Sammlungsstücke;65340;36640;28700
01.06.13;WA98;Vollständige Fabrikationsanlagen;220242;920;219322
01.06.13;WA99;Zusammenstellungen verschiedener Waren;1456495;777427;679068
01.06.14;WA01;Lebende Tiere;133674;167057;-33383
01.06.14;WA02;Fleisch;628119;519028;109091
01.06.14;WA03;Fische, Krebs- und Weichtiere;100901;278288;-177387
01.06.14;WA04;Milch, Milcherzeugnisse, Eier, Honig;801612;584775;216837
01.06.14;WA05;Andere Waren tierischen Ursprungs;70974;77846;-6872
01.06.14;WA06;Pflanzen, Waren des Blumenhandels;49156;207105;-157949
01.06.14;WA07;Gemüse, Pflanzen für Ernährung;81081;411285;-330204
01.06.14;WA08;Geniessbare Früchte und Nüsse;138653;693036;-554383
01.06.14;WA09;Kaffee, Tee, Mate, Gewürze;167512;350830;-183318
01.06.14;WA10;Getreide;204468;180116;24352
01.06.14;WA11;Müllereierzeugnisse, Malz usw.;115600;38217;77383
01.06.14;WA12;Ölsamen usw., Heilpflanzen usw.;65074;361667;-296593
01.06.14;WA13;Schellack, Gummen, Harz, Pflanzensaft;40833;39643;1190
01.06.14;WA14;Flechtstoffe usw. pflanzlichen Ursprungs;1039;3281;-2242
01.06.14;WA15;Tierische und pflanzliche Fette, Öle, Wachs;201078;287240;-86162
01.06.14;WA16;Zubereitungen von Fleisch, Fisch usw.;235433;190621;44812
01.06.14;WA17;Zucker und Zuckerwaren;148183;144772;3411
01.06.14;WA18;Kakao und Zubereitungen aus Kakao;291578;258975;32603
01.06.14;WA19;Zubereitungen aus Getreide usw., Backwaren;403198;263165;140033
01.06.14;WA20;Zubereitungen von Gemüse, Früchten usw.;198013;343671;-145658
01.06.14;WA21;Verschiedene Lebensmittelzubereitungen;440150;250623;189527
01.06.14;WA22;Getränke, alkoholhaltige Flüssigkeiten, Essig;469981;544856;-74875
01.06.14;WA23;Rückstände der Lebensmittelindustrie, Futter;308481;319842;-11361
01.06.14;WA24;Tabak;299392;144128;155264
01.06.14;WA25;Salz, Schwefel, Steine, Erden usw.;163158;147855;15303
01.06.14;WA26;Erze, Schlacken, Aschen;28652;623068;-594416
01.06.14;WA27;Mineralische Brennstoffe usw.;2033608;9141158;-7107550
01.06.14;WA28;Anorganische chemische Erzeugnisse;672662;578332;94330
01.06.14;WA29;Organische chemische Erzeugnisse;2012142;2080762;-68620
01.06.14;WA30;Pharmazeutische Erzeugnisse;4540837;2844500;1696337
01.06.14;WA31;Düngemittel;162018;73436;88582
01.06.14;WA32;Gerb- und Farbstoffe, Farben, Lacke usw.;888353;457017;431336
01.06.14;WA33;Etherische Öle, Riech-, Schönheitsmittel;675769;449447;226322
01.06.14;WA34;Seifen, Waschmittel usw.;539652;274878;264774
01.06.14;WA35;Eiweissstoffe, Klebstoffe, Enzyme;263680;166976;96704
01.06.14;WA36;Sprengstoffe, pyrotechnische Artikel usw.;16978;19104;-2126
01.06.14;WA37;Photochemische Erzeugnisse;89879;59287;30592
01.06.14;WA38;Verschiedene Erzeugnisse der Chemischen Industrie;1604833;1022648;582185
01.06.14;WA39;Kunststoffe und Waren daraus;4594426;2903219;1691207
01.06.14;WA40;Kautschuk und Waren daraus;1175373;1152550;22823
01.06.14;WA41;Häute, Felle, Leder;95903;82932;12971
01.06.14;WA42;Lederwaren, Sattlerwaren;139378;304508;-165130
01.06.14;WA43;Pelzfelle, künstliches Pelzwerk;14628;14854;-226
01.06.14;WA44;Holz, Holzwaren, Holzkohle;594476;601986;-7510
01.06.14;WA45;Kork, Korkwaren;2819;7852;-5033
01.06.14;WA46;Flechtwaren, Korbmacherwaren;3154;8646;-5492
01.06.14;WA47;Halbstoffe aus Holz usw., Papierabfall;90649;296366;-205717
01.06.14;WA48;Papier, Pappe und Waren daraus;1475840;980996;494844
01.06.14;WA49;Bücher, Zeitungen, Bilddrucke usw.;313878;153276;160602
01.06.14;WA50;Seide;5852;6375;-523
01.06.14;WA51;Wolle, feine und grobe Tierhaare;51234;59498;-8264
01.06.14;WA52;Baumwolle;80688;83528;-2840
01.06.14;WA53;Andere pflanzliche Spinnstoffe, Papiergarn;2704;4812;-2108
01.06.14;WA54;Synthetisches oder künstliches Filament;162772;125848;36924
01.06.14;WA55;Synthetische oder künstliche Spinnfaser;168378;136141;32237
01.06.14;WA56;Watte, Filz, Vliesstoff usw., Tauwerk;194814;114822;79992
01.06.14;WA57;Teppiche, Fussbodenbelag aus Spinnstoff;40275;77615;-37340
01.06.14;WA58;Spezialgewebe, Spitzen, Tapisserien;40338;22614;17724
01.06.14;WA59;Getränkte, bestrichene usw. Gewebe;169161;91602;77559
01.06.14;WA60;Gewirke und Gestricke;64254;39215;25039
01.06.14;WA61;Bekleidung usw. aus Gewirken, Gestricken;497520;1115318;-617798
01.06.14;WA62;Andere Bekleidung, Bekleidungszubehör;481311;1051580;-570269
01.06.14;WA63;Andere Konfektion, Spinnstoffwaren usw.;197643;288454;-90811
01.06.14;WA64;Schuhe, Gamaschen, ähnliche Waren;315287;643006;-327719
01.06.14;WA65;Kopfbedeckungen und Teile davon;20896;35488;-14592
01.06.14;WA66;Schirme, Gehstöcke usw., Peitschen;6623;13596;-6973
01.06.14;WA67;Zugerichtete Federn, Daunen, künstliche Blumen;7314;11528;-4214
01.06.14;WA68;Waren aus Steinen, Gips, Zement usw.;336667;241977;94690
01.06.14;WA69;Keramische Waren;253391;213597;39794
01.06.14;WA70;Glas und Glaswaren;468269;363419;104850
01.06.14;WA71;Perlen, Edelsteine, Edelmetalle;936948;1183765;-246817
01.06.14;WA72;Eisen und Stahl;1923626;1954815;-31189
01.06.14;WA73;Waren aus Eisen oder Stahl;2132598;1581475;551123
01.06.14;WA74;Kupfer und Waren daraus;821182;846273;-25091
01.06.14;WA75;Nickel und Waren daraus;88203;118376;-30173
01.06.14;WA76;Aluminium und Waren daraus;1056869;1127305;-70436
01.06.14;WA78;Blei und Waren daraus;34111;31426;2685
01.06.14;WA79;Zink und Waren daraus;51535;101026;-49491
01.06.14;WA80;Zinn und Waren daraus;11259;36669;-25410
01.06.14;WA81;Andere unedle Metalle, Cermets usw.;113893;132662;-18769
01.06.14;WA82;Werkzeuge, Schneidwaren, Essbestecke;596172;357373;238799
01.06.14;WA83;Verschiedene Waren aus unedlen Metallen;586724;335298;251426
01.06.14;WA84;Maschinen, Apparate, mechanische Geräte;16280099;9313673;6966426
01.06.14;WA85;Elektrotechnische Erzeugnisse;9105558;8126424;979134
01.06.14;WA86;Schienenfahrzeuge;279423;164441;114982
01.06.14;WA87;Kraftfahrzeuge, Landfahrzeuge;15856079;6862430;8993649
01.06.14;WA88;Luftfahrzeuge, Raumfahrzeuge;2628931;2891777;-262846
01.06.14;WA89;Wasserfahrzeuge;409663;202998;206665
01.06.14;WA90;Optische, photografische usw. Erzeugnisse;4334719;2423094;1911625
01.06.14;WA91;Uhrmacherwaren;162693;171449;-8756
01.06.14;WA92;Musikinstrumente;43212;36365;6847
01.06.14;WA93;Waffen und Munition;38986;15423;23563
01.06.14;WA94;Möbel, Beleuchtungskörper usw.;1146582;1298456;-151874
01.06.14;WA95;Spielzeug, Spiele usw., Sportgeräte;240759;378788;-138029
01.06.14;WA96;Verschiedene Waren;298205;197361;100844
01.06.14;WA97;Kunstgegenstände, Sammlungsstücke;77530;32344;45186
01.06.14;WA98;Vollständige Fabrikationsanlagen;252920;4072;248848
01.06.14;WA99;Zusammenstellungen verschiedener Waren;1779525;802034;977491
01.06.15;WA01;Lebende Tiere;136733;152261;-15528
01.06.15;WA02;Fleisch;604570;499359;105211
01.06.15;WA03;Fische, Krebs- und Weichtiere;132873;300271;-167398
01.06.15;WA04;Milch, Milcherzeugnisse, Eier, Honig;730056;535048;195008
01.06.15;WA05;Andere Waren tierischen Ursprungs;64054;72341;-8287
01.06.15;WA06;Pflanzen, Waren des Blumenhandels;61603;200090;-138487
01.06.15;WA07;Gemüse, Pflanzen für Ernährung;79723;451844;-372121
01.06.15;WA08;Geniessbare Früchte und Nüsse;169411;800420;-631009
01.06.15;WA09;Kaffee, Tee, Mate, Gewürze;227239;373204;-145965
01.06.15;WA10;Getreide;241755;187009;54746
01.06.15;WA11;Müllereierzeugnisse, Malz usw.;127322;43977;83345
01.06.15;WA12;Ölsamen usw., Heilpflanzen usw.;82598;353217;-270619
01.06.15;WA13;Schellack, Gummen, Harz, Pflanzensaft;44980;40017;4963
01.06.15;WA14;Flechtstoffe usw. pflanzlichen Ursprungs;882;3159;-2277
01.06.15;WA15;Tierische und pflanzliche Fette, Öle, Wachs;216697;320379;-103682
01.06.15;WA16;Zubereitungen von Fleisch, Fisch usw.;239355;226726;12629
01.06.15;WA17;Zucker und Zuckerwaren;155977;140528;15449
01.06.15;WA18;Kakao und Zubereitungen aus Kakao;331302;303048;28254
01.06.15;WA19;Zubereitungen aus Getreide usw., Backwaren;470928;307902;163026
01.06.15;WA20;Zubereitungen von Gemüse, Früchten usw.;219941;363930;-143989
01.06.15;WA21;Verschiedene Lebensmittelzubereitungen;465253;253572;211681
01.06.15;WA22;Getränke, alkoholhaltige Flüssigkeiten, Essig;536436;530779;5657
01.06.15;WA23;Rückstände der Lebensmittelindustrie, Futter;351562;323995;27567
01.06.15;WA24;Tabak;382256;150588;231668
01.06.15;WA25;Salz, Schwefel, Steine, Erden usw.;193088;151842;41246
01.06.15;WA26;Erze, Schlacken, Aschen;30811;652445;-621634
01.06.15;WA27;Mineralische Brennstoffe usw.;2474325;8092504;-5618179
01.06.15;WA28;Anorganische chemische Erzeugnisse;726937;631020;95917
01.06.15;WA29;Organische chemische Erzeugnisse;2121087;2420725;-299638
01.06.15;WA30;Pharmazeutische Erzeugnisse;6397681;3696505;2701176
01.06.15;WA31;Düngemittel;216433;123093;93340
01.06.15;WA32;Gerb- und Farbstoffe, Farben, Lacke usw.;985513;487828;497685
01.06.15;WA33;Etherische Öle, Riech-, Schönheitsmittel;683666;479089;204577
01.06.15;WA34;Seifen, Waschmittel usw.;592914;286326;306588
01.06.15;WA35;Eiweissstoffe, Klebstoffe, Enzyme;293430;184333;109097
01.06.15;WA36;Sprengstoffe, pyrotechnische Artikel usw.;17699;24425;-6726
01.06.15;WA37;Photochemische Erzeugnisse;105178;65641;39537
01.06.15;WA38;Verschiedene Erzeugnisse der Chemischen Industrie;1734932;1020966;713966
01.06.15;WA39;Kunststoffe und Waren daraus;4984219;3134491;1849728
01.06.15;WA40;Kautschuk und Waren daraus;1283341;1133729;149612
01.06.15;WA41;Häute, Felle, Leder;87554;68674;18880
01.06.15;WA42;Lederwaren, Sattlerwaren;164825;351835;-187010
01.06.15;WA43;Pelzfelle, künstliches Pelzwerk;13111;13560;-449
01.06.15;WA44;Holz, Holzwaren, Holzkohle;647121;623582;23539
01.06.15;WA45;Kork, Korkwaren;2634;9001;-6367
01.06.15;WA46;Flechtwaren, Korbmacherwaren;3204;10283;-7079
01.06.15;WA47;Halbstoffe aus Holz usw., Papierabfall;106369;326023;-219654
01.06.15;WA48;Papier, Pappe und Waren daraus;1495443;990091;505352
01.06.15;WA49;Bücher, Zeitungen, Bilddrucke usw.;346681;180649;166032
01.06.15;WA50;Seide;4976;5425;-449
01.06.15;WA51;Wolle, feine und grobe Tierhaare;51434;56896;-5462
01.06.15;WA52;Baumwolle;74598;76934;-2336
01.06.15;WA53;Andere pflanzliche Spinnstoffe, Papiergarn;3159;6184;-3025
01.06.15;WA54;Synthetisches oder künstliches Filament;177118;131465;45653
01.06.15;WA55;Synthetische oder künstliche Spinnfaser;162895;133506;29389
01.06.15;WA56;Watte, Filz, Vliesstoff usw., Tauwerk;202369;114474;87895
01.06.15;WA57;Teppiche, Fussbodenbelag aus Spinnstoff;46420;89619;-43199
01.06.15;WA58;Spezialgewebe, Spitzen, Tapisserien;46558;22287;24271
01.06.15;WA59;Getränkte, bestrichene usw. Gewebe;187657;93371;94286
01.06.15;WA60;Gewirke und Gestricke;67576;41044;26532
01.06.15;WA61;Bekleidung usw. aus Gewirken, Gestricken;545066;1185327;-640261
01.06.15;WA62;Andere Bekleidung, Bekleidungszubehör;535597;1175195;-639598
01.06.15;WA63;Andere Konfektion, Spinnstoffwaren usw.;224802;322077;-97275
01.06.15;WA64;Schuhe, Gamaschen, ähnliche Waren;342633;805338;-462705
01.06.15;WA65;Kopfbedeckungen und Teile davon;25795;37874;-12079
01.06.15;WA66;Schirme, Gehstöcke usw., Peitschen;7753;15765;-8012
01.06.15;WA67;Zugerichtete Federn, Daunen, künstliche Blumen;7822;13854;-6032
01.06.15;WA68;Waren aus Steinen, Gips, Zement usw.;385230;264453;120777
01.06.15;WA69;Keramische Waren;274418;237327;37091
01.06.15;WA70;Glas und Glaswaren;521384;408986;112398
01.06.15;WA71;Perlen, Edelsteine, Edelmetalle;931092;1210574;-279482
01.06.15;WA72;Eisen und Stahl;1960416;2081270;-120854
01.06.15;WA73;Waren aus Eisen oder Stahl;2283699;1616849;666850
01.06.15;WA74;Kupfer und Waren daraus;913492;789048;124444
01.06.15;WA75;Nickel und Waren daraus;102879;106945;-4066
01.06.15;WA76;Aluminium und Waren daraus;1276515;1366724;-90209
01.06.15;WA78;Blei und Waren daraus;45035;30280;14755
01.06.15;WA79;Zink und Waren daraus;59356;113438;-54082
01.06.15;WA80;Zinn und Waren daraus;9309;29036;-19727
01.06.15;WA81;Andere unedle Metalle, Cermets usw.;128118;156806;-28688
01.06.15;WA82;Werkzeuge, Schneidwaren, Essbestecke;679061;390991;288070
01.06.15;WA83;Verschiedene Waren aus unedlen Metallen;609494;372002;237492
01.06.15;WA84;Maschinen, Apparate, mechanische Geräte;18127692;10216643;7911049
01.06.15;WA85;Elektrotechnische Erzeugnisse;10375996;9503773;872223
01.06.15;WA86;Schienenfahrzeuge;251819;193800;58019
01.06.15;WA87;Kraftfahrzeuge, Landfahrzeuge;19258656;8036922;11221734
01.06.15;WA88;Luftfahrzeuge, Raumfahrzeuge;2999542;2011635;987907
01.06.15;WA89;Wasserfahrzeuge;503846;32621;471225
01.06.15;WA90;Optische, photografische usw. Erzeugnisse;4940335;2909924;2030411
01.06.15;WA91;Uhrmacherwaren;164811;220380;-55569
01.06.15;WA92;Musikinstrumente;47919;43579;4340
01.06.15;WA93;Waffen und Munition;43863;14908;28955
01.06.15;WA94;Möbel, Beleuchtungskörper usw.;1301982;1415626;-113644
01.06.15;WA95;Spielzeug, Spiele usw., Sportgeräte;289287;405743;-116456
01.06.15;WA96;Verschiedene Waren;270286;206967;63319
01.06.15;WA97;Kunstgegenstände, Sammlungsstücke;56396;38519;17877
01.06.15;WA98;Vollständige Fabrikationsanlagen;168212;1392;166820
01.06.15;WA99;Zusammenstellungen verschiedener Waren;1793288;853097;940191
01.06.16;WA01;Lebende Tiere;126476;169803;-43327
01.06.16;WA02;Fleisch;661565;511272;150293
01.06.16;WA03;Fische, Krebs- und Weichtiere;140781;329080;-188299
01.06.16;WA04;Milch, Milcherzeugnisse, Eier, Honig;739973;554787;185186
01.06.16;WA05;Andere Waren tierischen Ursprungs;66764;65139;1625
01.06.16;WA06;Pflanzen, Waren des Blumenhandels;69362;212130;-142768
01.06.16;WA07;Gemüse, Pflanzen für Ernährung;79526;491137;-411611
01.06.16;WA08;Geniessbare Früchte und Nüsse;180550;839578;-659028
01.06.16;WA09;Kaffee, Tee, Mate, Gewürze;214392;320722;-106330
01.06.16;WA10;Getreide;241313;194575;46738
01.06.16;WA11;Müllereierzeugnisse, Malz usw.;133934;47548;86386
01.06.16;WA12;Ölsamen usw., Heilpflanzen usw.;97149;362677;-265528
01.06.16;WA13;Schellack, Gummen, Harz, Pflanzensaft;49022;39816;9206
01.06.16;WA14;Flechtstoffe usw. pflanzlichen Ursprungs;641;3331;-2690
01.06.16;WA15;Tierische und pflanzliche Fette, Öle, Wachs;231980;329551;-97571
01.06.16;WA16;Zubereitungen von Fleisch, Fisch usw.;231173;202114;29059
01.06.16;WA17;Zucker und Zuckerwaren;163740;146088;17652
01.06.16;WA18;Kakao und Zubereitungen aus Kakao;338820;348035;-9215
01.06.16;WA19;Zubereitungen aus Getreide usw., Backwaren;491935;317938;173997
01.06.16;WA20;Zubereitungen von Gemüse, Früchten usw.;238923;378471;-139548
01.06.16;WA21;Verschiedene Lebensmittelzubereitungen;496107;283170;212937
01.06.16;WA22;Getränke, alkoholhaltige Flüssigkeiten, Essig;537760;594389;-56629
01.06.16;WA23;Rückstände der Lebensmittelindustrie, Futter;378811;307492;71319
01.06.16;WA24;Tabak;369644;135442;234202
01.06.16;WA25;Salz, Schwefel, Steine, Erden usw.;183846;154940;28906
01.06.16;WA26;Erze, Schlacken, Aschen;34517;575192;-540675
01.06.16;WA27;Mineralische Brennstoffe usw.;1579417;5610147;-4030730
01.06.16;WA28;Anorganische chemische Erzeugnisse;701799;472392;229407
01.06.16;WA29;Organische chemische Erzeugnisse;1914439;2355085;-440646
01.06.16;WA30;Pharmazeutische Erzeugnisse;6123083;3611524;2511559
01.06.16;WA31;Düngemittel;147587;74707;72880
01.06.16;WA32;Gerb- und Farbstoffe, Farben, Lacke usw.;994162;501316;492846
01.06.16;WA33;Etherische Öle, Riech-, Schönheitsmittel;783307;527624;255683
01.06.16;WA34;Seifen, Waschmittel usw.;619155;309009;310146
01.06.16;WA35;Eiweissstoffe, Klebstoffe, Enzyme;276699;166950;109749
01.06.16;WA36;Sprengstoffe, pyrotechnische Artikel usw.;19224;21886;-2662
01.06.16;WA37;Photochemische Erzeugnisse;93667;63804;29863
01.06.16;WA38;Verschiedene Erzeugnisse der Chemischen Industrie;1791590;1001070;790520
01.06.16;WA39;Kunststoffe und Waren daraus;5008127;3167522;1840605
01.06.16;WA40;Kautschuk und Waren daraus;1245379;1194516;50863
01.06.16;WA41;Häute, Felle, Leder;81088;72211;8877
01.06.16;WA42;Lederwaren, Sattlerwaren;180638;359802;-179164
01.06.16;WA43;Pelzfelle, künstliches Pelzwerk;8499;12729;-4230
01.06.16;WA44;Holz, Holzwaren, Holzkohle;647327;643828;3499
01.06.16;WA45;Kork, Korkwaren;2921;10517;-7596
01.06.16;WA46;Flechtwaren, Korbmacherwaren;4036;9320;-5284
01.06.16;WA47;Halbstoffe aus Holz usw., Papierabfall;85211;312794;-227583
01.06.16;WA48;Papier, Pappe und Waren daraus;1514000;1020022;493978
01.06.16;WA49;Bücher, Zeitungen, Bilddrucke usw.;325452;201134;124318
01.06.16;WA50;Seide;3979;4082;-103
01.06.16;WA51;Wolle, feine und grobe Tierhaare;57950;59331;-1381
01.06.16;WA52;Baumwolle;78208;76993;1215
01.06.16;WA53;Andere pflanzliche Spinnstoffe, Papiergarn;2776;5251;-2475
01.06.16;WA54;Synthetisches oder künstliches Filament;161888;134042;27846
01.06.16;WA55;Synthetische oder künstliche Spinnfaser;157947;123674;34273
01.06.16;WA56;Watte, Filz, Vliesstoff usw., Tauwerk;207751;112312;95439
01.06.16;WA57;Teppiche, Fussbodenbelag aus Spinnstoff;48243;87025;-38782
01.06.16;WA58;Spezialgewebe, Spitzen, Tapisserien;45498;25150;20348
01.06.16;WA59;Getränkte, bestrichene usw. Gewebe;207332;90814;116518
01.06.16;WA60;Gewirke und Gestricke;72918;42290;30628
01.06.16;WA61;Bekleidung usw. aus Gewirken, Gestricken;532057;1257753;-725696
01.06.16;WA62;Andere Bekleidung, Bekleidungszubehör;538299;1237395;-699096
01.06.16;WA63;Andere Konfektion, Spinnstoffwaren usw.;236417;332383;-95966
01.06.16;WA64;Schuhe, Gamaschen, ähnliche Waren;405601;822499;-416898
01.06.16;WA65;Kopfbedeckungen und Teile davon;23591;38993;-15402
01.06.16;WA66;Schirme, Gehstöcke usw., Peitschen;9888;14845;-4957
01.06.16;WA67;Zugerichtete Federn, Daunen, künstliche Blumen;8251;14049;-5798
01.06.16;WA68;Waren aus Steinen, Gips, Zement usw.;408519;277056;131463
01.06.16;WA69;Keramische Waren;279701;235430;44271
01.06.16;WA70;Glas und Glaswaren;517974;458817;59157
01.06.16;WA71;Perlen, Edelsteine, Edelmetalle;1003630;2056137;-1052507
01.06.16;WA72;Eisen und Stahl;1751769;1862896;-111127
01.06.16;WA73;Waren aus Eisen oder Stahl;2326960;1691622;635338
01.06.16;WA74;Kupfer und Waren daraus;829365;688821;140544
01.06.16;WA75;Nickel und Waren daraus;80521;102435;-21914
01.06.16;WA76;Aluminium und Waren daraus;1218350;1287673;-69323
01.06.16;WA78;Blei und Waren daraus;26863;24789;2074
01.06.16;WA79;Zink und Waren daraus;54725;100221;-45496
01.06.16;WA80;Zinn und Waren daraus;9936;24414;-14478
01.06.16;WA81;Andere unedle Metalle, Cermets usw.;116188;154919;-38731
01.06.16;WA82;Werkzeuge, Schneidwaren, Essbestecke;692018;417173;274845
01.06.16;WA83;Verschiedene Waren aus unedlen Metallen;638059;407408;230651
01.06.16;WA84;Maschinen, Apparate, mechanische Geräte;17898330;10670192;7228138
01.06.16;WA85;Elektrotechnische Erzeugnisse;10643104;10030213;612891
01.06.16;WA86;Schienenfahrzeuge;401618;177850;223768
01.06.16;WA87;Kraftfahrzeuge, Landfahrzeuge;20203815;9110156;11093659
01.06.16;WA88;Luftfahrzeuge, Raumfahrzeuge;3747696;1637734;2109962
01.06.16;WA89;Wasserfahrzeuge;213666;160542;53124
01.06.16;WA90;Optische, photografische usw. Erzeugnisse;5226684;2929417;2297267
01.06.16;WA91;Uhrmacherwaren;154138;168609;-14471
01.06.16;WA92;Musikinstrumente;46985;44055;2930
01.06.16;WA93;Waffen und Munition;51040;22113;28927
01.06.16;WA94;Möbel, Beleuchtungskörper usw.;1359931;1488666;-128735
01.06.16;WA95;Spielzeug, Spiele usw., Sportgeräte;306260;477080;-170820
01.06.16;WA96;Verschiedene Waren;343799;220200;123599
01.06.16;WA97;Kunstgegenstände, Sammlungsstücke;86947;86394;553
01.06.16;WA98;Vollständige Fabrikationsanlagen;169117;49;169068
01.06.16;WA99;Zusammenstellungen verschiedener Waren;1885706;926032;959674
01.06.17;WA01;Lebende Tiere;134893;197235;-62342
01.06.17;WA02;Fleisch;702989;571291;131698
01.06.17;WA03;Fische, Krebs- und Weichtiere;132990;311501;-178511
01.06.17;WA04;Milch, Milcherzeugnisse, Eier, Honig;825099;672446;152653
01.06.17;WA05;Andere Waren tierischen Ursprungs;78730;91134;-12404
01.06.17;WA06;Pflanzen, Waren des Blumenhandels;69368;227144;-157776
01.06.17;WA07;Gemüse, Pflanzen für Ernährung;82006;452320;-370314
01.06.17;WA08;Geniessbare Früchte und Nüsse;166076;874139;-708063
01.06.17;WA09;Kaffee, Tee, Mate, Gewürze;229816;333517;-103701
01.06.17;WA10;Getreide;170426;167926;2500
01.06.17;WA11;Müllereierzeugnisse, Malz usw.;123316;45283;78033
01.06.17;WA12;Ölsamen usw., Heilpflanzen usw.;90763;411120;-320357
01.06.17;WA13;Schellack, Gummen, Harz, Pflanzensaft;56467;41830;14637
01.06.17;WA14;Flechtstoffe usw. pflanzlichen Ursprungs;592;3247;-2655
01.06.17;WA15;Tierische und pflanzliche Fette, Öle, Wachs;246317;362276;-115959
01.06.17;WA16;Zubereitungen von Fleisch, Fisch usw.;245298;228321;16977
01.06.17;WA17;Zucker und Zuckerwaren;167654;130174;37480
01.06.17;WA18;Kakao und Zubereitungen aus Kakao;327378;332346;-4968
01.06.17;WA19;Zubereitungen aus Getreide usw., Backwaren;510667;324280;186387
01.06.17;WA20;Zubereitungen von Gemüse, Früchten usw.;254573;409317;-154744
01.06.17;WA21;Verschiedene Lebensmittelzubereitungen;505824;279990;225834
01.06.17;WA22;Getränke, alkoholhaltige Flüssigkeiten, Essig;550728;614159;-63431
01.06.17;WA23;Rückstände der Lebensmittelindustrie, Futter;315084;311329;3755
01.06.17;WA24;Tabak;337902;195161;142741
01.06.17;WA25;Salz, Schwefel, Steine, Erden usw.;175590;153441;22149
01.06.17;WA26;Erze, Schlacken, Aschen;40883;598468;-557585
01.06.17;WA27;Mineralische Brennstoffe usw.;1666339;6034042;-4367703
01.06.17;WA28;Anorganische chemische Erzeugnisse;750021;547967;202054
01.06.17;WA29;Organische chemische Erzeugnisse;1979378;2391638;-412260
01.06.17;WA30;Pharmazeutische Erzeugnisse;5824520;3818048;2006472
01.06.17;WA31;Düngemittel;140829;71372;69457
01.06.17;WA32;Gerb- und Farbstoffe, Farben, Lacke usw.;1031994;505823;526171
01.06.17;WA33;Etherische Öle, Riech-, Schönheitsmittel;761803;620192;141611
01.06.17;WA34;Seifen, Waschmittel usw.;642035;314002;328033
01.06.17;WA35;Eiweissstoffe, Klebstoffe, Enzyme;293871;172627;121244
01.06.17;WA36;Sprengstoffe, pyrotechnische Artikel usw.;17401;20888;-3487
01.06.17;WA37;Photochemische Erzeugnisse;105605;76002;29603
01.06.17;WA38;Verschiedene Erzeugnisse der Chemischen Industrie;1875191;1127591;747600
01.06.17;WA39;Kunststoffe und Waren daraus;5255699;3372172;1883527
01.06.17;WA40;Kautschuk und Waren daraus;1247434;1167923;79511
01.06.17;WA41;Häute, Felle, Leder;75547;64154;11393
01.06.17;WA42;Lederwaren, Sattlerwaren;190769;376343;-185574
01.06.17;WA43;Pelzfelle, künstliches Pelzwerk;12313;14805;-2492
01.06.17;WA44;Holz, Holzwaren, Holzkohle;680838;669768;11070
01.06.17;WA45;Kork, Korkwaren;2219;8825;-6606
01.06.17;WA46;Flechtwaren, Korbmacherwaren;3343;9439;-6096
01.06.17;WA47;Halbstoffe aus Holz usw., Papierabfall;103501;330794;-227293
01.06.17;WA48;Papier, Pappe und Waren daraus;1507435;990127;517308
01.06.17;WA49;Bücher, Zeitungen, Bilddrucke usw.;322335;210817;111518
01.06.17;WA50;Seide;3984;5124;-1140
01.06.17;WA51;Wolle, feine und grobe Tierhaare;48048;59185;-11137
01.06.17;WA52;Baumwolle;79260;78132;1128
01.06.17;WA53;Andere pflanzliche Spinnstoffe, Papiergarn;2890;5049;-2159
01.06.17;WA54;Synthetisches oder künstliches Filament;164531;136257;28274
01.06.17;WA55;Synthetische oder künstliche Spinnfaser;157521;130827;26694
01.06.17;WA56;Watte, Filz, Vliesstoff usw., Tauwerk;210810;120437;90373
01.06.17;WA57;Teppiche, Fussbodenbelag aus Spinnstoff;45709;81545;-35836
01.06.17;WA58;Spezialgewebe, Spitzen, Tapisserien;44560;22259;22301
01.06.17;WA59;Getränkte, bestrichene usw. Gewebe;218112;101601;116511
01.06.17;WA60;Gewirke und Gestricke;77846;42461;35385
01.06.17;WA61;Bekleidung usw. aus Gewirken, Gestricken;665981;1331957;-665976
01.06.17;WA62;Andere Bekleidung, Bekleidungszubehör;648449;1241917;-593468
01.06.17;WA63;Andere Konfektion, Spinnstoffwaren usw.;212764;343001;-130237
01.06.17;WA64;Schuhe, Gamaschen, ähnliche Waren;496402;877919;-381517
01.06.17;WA65;Kopfbedeckungen und Teile davon;32878;44769;-11891
01.06.17;WA66;Schirme, Gehstöcke usw., Peitschen;9931;16041;-6110
01.06.17;WA67;Zugerichtete Federn, Daunen, künstliche Blumen;8769;15141;-6372
01.06.17;WA68;Waren aus Steinen, Gips, Zement usw.;403578;275881;127697
01.06.17;WA69;Keramische Waren;291788;258381;33407
01.06.17;WA70;Glas und Glaswaren;539987;432810;107177
01.06.17;WA71;Perlen, Edelsteine, Edelmetalle;877769;1214474;-336705
01.06.17;WA72;Eisen und Stahl;2050631;2183616;-132985
01.06.17;WA73;Waren aus Eisen oder Stahl;2341633;1746998;594635
01.06.17;WA74;Kupfer und Waren daraus;903868;776308;127560
01.06.17;WA75;Nickel und Waren daraus;100861;103548;-2687
01.06.17;WA76;Aluminium und Waren daraus;1268228;1394252;-126024
01.06.17;WA78;Blei und Waren daraus;40058;44686;-4628
01.06.17;WA79;Zink und Waren daraus;62129;130114;-67985
01.06.17;WA80;Zinn und Waren daraus;9849;32428;-22579
01.06.17;WA81;Andere unedle Metalle, Cermets usw.;128832;163233;-34401
01.06.17;WA82;Werkzeuge, Schneidwaren, Essbestecke;718377;433991;284386
01.06.17;WA83;Verschiedene Waren aus unedlen Metallen;662442;399646;262796
01.06.17;WA84;Maschinen, Apparate, mechanische Geräte;19114558;11108494;8006064
01.06.17;WA85;Elektrotechnische Erzeugnisse;11337939;10412785;925154
01.06.17;WA86;Schienenfahrzeuge;370906;228649;142257
01.06.17;WA87;Kraftfahrzeuge, Landfahrzeuge;18928158;9571229;9356929
01.06.17;WA88;Luftfahrzeuge, Raumfahrzeuge;3043801;1319530;1724271
01.06.17;WA89;Wasserfahrzeuge;302765;153765;149000
01.06.17;WA90;Optische, photografische usw. Erzeugnisse;5611801;3045915;2565886
01.06.17;WA91;Uhrmacherwaren;136749;156964;-20215
01.06.17;WA92;Musikinstrumente;48029;46394;1635
01.06.17;WA93;Waffen und Munition;45653;22976;22677
01.06.17;WA94;Möbel, Beleuchtungskörper usw.;1307685;1467790;-160105
01.06.17;WA95;Spielzeug, Spiele usw., Sportgeräte;351974;536882;-184908
01.06.17;WA96;Verschiedene Waren;339279;243556;95723
01.06.17;WA97;Kunstgegenstände, Sammlungsstücke;55713;37570;18143
01.06.17;WA98;Vollständige Fabrikationsanlagen;141170;1918;139252
01.06.17;WA99;Zusammenstellungen verschiedener Waren;1494105;980021;514084
01.06.18;WA01;Lebende Tiere;118321;148643;-30322
01.06.18;WA02;Fleisch;565844;536822;29022
01.06.18;WA03;Fische, Krebs- und Weichtiere;135438;315349;-179911
01.06.18;WA04;Milch, Milcherzeugnisse, Eier, Honig;776093;648194;127899
01.06.18;WA05;Andere Waren tierischen Ursprungs;87996;80550;7446
01.06.18;WA06;Pflanzen, Waren des Blumenhandels;65906;235910;-170004
01.06.18;WA07;Gemüse, Pflanzen für Ernährung;96070;448851;-352781
01.06.18;WA08;Geniessbare Früchte und Nüsse;165557;919875;-754318
01.06.18;WA09;Kaffee, Tee, Mate, Gewürze;221408;300909;-79501
01.06.18;WA10;Getreide;146038;182346;-36308
01.06.18;WA11;Müllereierzeugnisse, Malz usw.;131284;53372;77912
01.06.18;WA12;Ölsamen usw., Heilpflanzen usw.;87834;363294;-275460
01.06.18;WA13;Schellack, Gummen, Harz, Pflanzensaft;52167;50378;1789
01.06.18;WA14;Flechtstoffe usw. pflanzlichen Ursprungs;865;3729;-2864
01.06.18;WA15;Tierische und pflanzliche Fette, Öle, Wachs;231853;317880;-86027
01.06.18;WA16;Zubereitungen von Fleisch, Fisch usw.;219263;226330;-7067
01.06.18;WA17;Zucker und Zuckerwaren;180417;127357;53060
01.06.18;WA18;Kakao und Zubereitungen aus Kakao;364644;355872;8772
01.06.18;WA19;Zubereitungen aus Getreide usw., Backwaren;518511;314711;203800
01.06.18;WA20;Zubereitungen von Gemüse, Früchten usw.;255944;392532;-136588
01.06.18;WA21;Verschiedene Lebensmittelzubereitungen;536701;295596;241105
01.06.18;WA22;Getränke, alkoholhaltige Flüssigkeiten, Essig;552080;653590;-101510
01.06.18;WA23;Rückstände der Lebensmittelindustrie, Futter;339322;356644;-17322
01.06.18;WA24;Tabak;274590;214540;60050
01.06.18;WA25;Salz, Schwefel, Steine, Erden usw.;182120;179668;2452
01.06.18;WA26;Erze, Schlacken, Aschen;46871;758192;-711321
01.06.18;WA27;Mineralische Brennstoffe usw.;2230355;7987139;-5756784
01.06.18;WA28;Anorganische chemische Erzeugnisse;781314;613527;167787
01.06.18;WA29;Organische chemische Erzeugnisse;2085697;3895320;-1809623
01.06.18;WA30;Pharmazeutische Erzeugnisse;7551967;3966944;3585023
01.06.18;WA31;Düngemittel;162881;75633;87248
01.06.18;WA32;Gerb- und Farbstoffe, Farben, Lacke usw.;1007367;516560;490807
01.06.18;WA33;Etherische Öle, Riech-, Schönheitsmittel;812636;595044;217592
01.06.18;WA34;Seifen, Waschmittel usw.;660725;345617;315108
01.06.18;WA35;Eiweissstoffe, Klebstoffe, Enzyme;293679;174052;119627
01.06.18;WA36;Sprengstoffe, pyrotechnische Artikel usw.;27346;19660;7686
01.06.18;WA37;Photochemische Erzeugnisse;109256;78806;30450
01.06.18;WA38;Verschiedene Erzeugnisse der Chemischen Industrie;1917273;1226955;690318
01.06.18;WA39;Kunststoffe und Waren daraus;5525321;3610543;1914778
01.06.18;WA40;Kautschuk und Waren daraus;1358041;1231585;126456
01.06.18;WA41;Häute, Felle, Leder;81630;64402;17228
01.06.18;WA42;Lederwaren, Sattlerwaren;208290;354443;-146153
01.06.18;WA43;Pelzfelle, künstliches Pelzwerk;10517;14699;-4182
01.06.18;WA44;Holz, Holzwaren, Holzkohle;760719;718160;42559
01.06.18;WA45;Kork, Korkwaren;2781;9097;-6316
01.06.18;WA46;Flechtwaren, Korbmacherwaren;4098;10034;-5936
01.06.18;WA47;Halbstoffe aus Holz usw., Papierabfall;100854;344705;-243851
01.06.18;WA48;Papier, Pappe und Waren daraus;1652147;1033348;618799
01.06.18;WA49;Bücher, Zeitungen, Bilddrucke usw.;337397;199987;137410
01.06.18;WA50;Seide;4140;5232;-1092
01.06.18;WA51;Wolle, feine und grobe Tierhaare;44957;54158;-9201
01.06.18;WA52;Baumwolle;69381;73185;-3804
01.06.18;WA53;Andere pflanzliche Spinnstoffe, Papiergarn;2435;4635;-2200
01.06.18;WA54;Synthetisches oder künstliches Filament;166261;131604;34657
01.06.18;WA55;Synthetische oder künstliche Spinnfaser;164199;127469;36730
01.06.18;WA56;Watte, Filz, Vliesstoff usw., Tauwerk;216358;119951;96407
01.06.18;WA57;Teppiche, Fussbodenbelag aus Spinnstoff;46075;81454;-35379
01.06.18;WA58;Spezialgewebe, Spitzen, Tapisserien;47027;21556;25471
01.06.18;WA59;Getränkte, bestrichene usw. Gewebe;218465;101054;117411
01.06.18;WA60;Gewirke und Gestricke;69725;40864;28861
01.06.18;WA61;Bekleidung usw. aus Gewirken, Gestricken;723452;1304738;-581286
01.06.18;WA62;Andere Bekleidung, Bekleidungszubehör;766660;1264586;-497926
01.06.18;WA63;Andere Konfektion, Spinnstoffwaren usw.;227135;337113;-109978
01.06.18;WA64;Schuhe, Gamaschen, ähnliche Waren;665725;939479;-273754
01.06.18;WA65;Kopfbedeckungen und Teile davon;31223;42537;-11314
01.06.18;WA66;Schirme, Gehstöcke usw., Peitschen;9494;17984;-8490
01.06.18;WA67;Zugerichtete Federn, Daunen, künstliche Blumen;9553;16267;-6714
01.06.18;WA68;Waren aus Steinen, Gips, Zement usw.;445178;292571;152607
01.06.18;WA69;Keramische Waren;287777;253586;34191
01.06.18;WA70;Glas und Glaswaren;611057;475226;135831
01.06.18;WA71;Perlen, Edelsteine, Edelmetalle;948516;1379657;-431141
01.06.18;WA72;Eisen und Stahl;2177096;2510525;-333429
01.06.18;WA73;Waren aus Eisen oder Stahl;2523324;1904018;619306
01.06.18;WA74;Kupfer und Waren daraus;990264;949772;40492
01.06.18;WA75;Nickel und Waren daraus;111724;152007;-40283
01.06.18;WA76;Aluminium und Waren daraus;1325474;1524048;-198574
01.06.18;WA78;Blei und Waren daraus;44128;34994;9134
01.06.18;WA79;Zink und Waren daraus;68465;146989;-78524
01.06.18;WA80;Zinn und Waren daraus;10097;31874;-21777
01.06.18;WA81;Andere unedle Metalle, Cermets usw.;142348;187664;-45316
01.06.18;WA82;Werkzeuge, Schneidwaren, Essbestecke;726689;445943;280746
01.06.18;WA83;Verschiedene Waren aus unedlen Metallen;663938;424484;239454
01.06.18;WA84;Maschinen, Apparate, mechanische Geräte;20306341;12029590;8276751
01.06.18;WA85;Elektrotechnische Erzeugnisse;11853221;11296371;556850
01.06.18;WA86;Schienenfahrzeuge;282181;209325;72856
01.06.18;WA87;Kraftfahrzeuge, Landfahrzeuge;19881417;10645742;9235675
01.06.18;WA88;Luftfahrzeuge, Raumfahrzeuge;3650624;1243378;2407246
01.06.18;WA89;Wasserfahrzeuge;674463;146044;528419
01.06.18;WA90;Optische, photografische usw. Erzeugnisse;5951253;3114122;2837131
01.06.18;WA91;Uhrmacherwaren;143564;157795;-14231
01.06.18;WA92;Musikinstrumente;55133;48543;6590
01.06.18;WA93;Waffen und Munition;41203;20639;20564
01.06.18;WA94;Möbel, Beleuchtungskörper usw.;1384845;1557766;-172921
01.06.18;WA95;Spielzeug, Spiele usw., Sportgeräte;383472;543504;-160032
01.06.18;WA96;Verschiedene Waren;345898;248129;97769
01.06.18;WA97;Kunstgegenstände, Sammlungsstücke;111205;51320;59885
01.06.18;WA98;Vollständige Fabrikationsanlagen;187821;1482;186339
01.06.18;WA99;Zusammenstellungen verschiedener Waren;1473129;1093248;379881
01.06.19;WA01;Lebende Tiere;130557;171328;-40771
01.06.19;WA02;Fleisch;608268;590172;18096
01.06.19;WA03;Fische, Krebs- und Weichtiere;118101;333230;-215129
01.06.19;WA04;Milch, Milcherzeugnisse, Eier, Honig;764249;645323;118926
01.06.19;WA05;Andere Waren tierischen Ursprungs;72671;83750;-11079
01.06.19;WA06;Pflanzen, Waren des Blumenhandels;62354;224122;-161768
01.06.19;WA07;Gemüse, Pflanzen für Ernährung;99308;548786;-449478
01.06.19;WA08;Geniessbare Früchte und Nüsse;168417;929717;-761300
01.06.19;WA09;Kaffee, Tee, Mate, Gewürze;217564;306712;-89148
01.06.19;WA10;Getreide;149867;221122;-71255
01.06.19;WA11;Müllereierzeugnisse, Malz usw.;141350;54227;87123
01.06.19;WA12;Ölsamen usw., Heilpflanzen usw.;84849;364090;-279241
01.06.19;WA13;Schellack, Gummen, Harz, Pflanzensaft;53649;43011;10638
01.06.19;WA14;Flechtstoffe usw. pflanzlichen Ursprungs;663;3962;-3299
01.06.19;WA15;Tierische und pflanzliche Fette, Öle, Wachs;202336;296190;-93854
01.06.19;WA16;Zubereitungen von Fleisch, Fisch usw.;285468;252444;33024
01.06.19;WA17;Zucker und Zuckerwaren;186358;126024;60334
01.06.19;WA18;Kakao und Zubereitungen aus Kakao;347956;326633;21323
01.06.19;WA19;Zubereitungen aus Getreide usw., Backwaren;505000;349757;155243
01.06.19;WA20;Zubereitungen von Gemüse, Früchten usw.;235674;398741;-163067
01.06.19;WA21;Verschiedene Lebensmittelzubereitungen;520956;303001;217955
01.06.19;WA22;Getränke, alkoholhaltige Flüssigkeiten, Essig;522387;632987;-110600
01.06.19;WA23;Rückstände der Lebensmittelindustrie, Futter;350742;328102;22640
01.06.19;WA24;Tabak;262907;191978;70929
01.06.19;WA25;Salz, Schwefel, Steine, Erden usw.;163985;173406;-9421
01.06.19;WA26;Erze, Schlacken, Aschen;49173;810467;-761294
01.06.19;WA27;Mineralische Brennstoffe usw.;2148640;8084994;-5936354
01.06.19;WA28;Anorganische chemische Erzeugnisse;787138;568888;218250
01.06.19;WA29;Organische chemische Erzeugnisse;2026267;3013872;-987605
01.06.19;WA30;Pharmazeutische Erzeugnisse;6920563;4392535;2528028
01.06.19;WA31;Düngemittel;157633;86837;70796
01.06.19;WA32;Gerb- und Farbstoffe, Farben, Lacke usw.;910466;461954;448512
01.06.19;WA33;Etherische Öle, Riech-, Schönheitsmittel;801036;546680;254356
01.06.19;WA34;Seifen, Waschmittel usw.;602172;344352;257820
01.06.19;WA35;Eiweissstoffe, Klebstoffe, Enzyme;295067;177168;117899
01.06.19;WA36;Sprengstoffe, pyrotechnische Artikel usw.;23569;23957;-388
01.06.19;WA37;Photochemische Erzeugnisse;95769;73226;22543
01.06.19;WA38;Verschiedene Erzeugnisse der Chemischen Industrie;1798984;1127073;671911
01.06.19;WA39;Kunststoffe und Waren daraus;5008461;3319849;1688612
01.06.19;WA40;Kautschuk und Waren daraus;1197082;1111924;85158
01.06.19;WA41;Häute, Felle, Leder;56146;50773;5373
01.06.19;WA42;Lederwaren, Sattlerwaren;196479;370955;-174476
01.06.19;WA43;Pelzfelle, künstliches Pelzwerk;6895;11515;-4620
01.06.19;WA44;Holz, Holzwaren, Holzkohle;732792;666701;66091
01.06.19;WA45;Kork, Korkwaren;2010;8337;-6327
01.06.19;WA46;Flechtwaren, Korbmacherwaren;3688;8706;-5018
01.06.19;WA47;Halbstoffe aus Holz usw., Papierabfall;100476;304893;-204417
01.06.19;WA48;Papier, Pappe und Waren daraus;1484307;1015891;468416
01.06.19;WA49;Bücher, Zeitungen, Bilddrucke usw.;324878;189571;135307
01.06.19;WA50;Seide;2484;2682;-198
01.06.19;WA51;Wolle, feine und grobe Tierhaare;38991;52779;-13788
01.06.19;WA52;Baumwolle;56311;62823;-6512
01.06.19;WA53;Andere pflanzliche Spinnstoffe, Papiergarn;2109;4615;-2506
01.06.19;WA54;Synthetisches oder künstliches Filament;153733;115657;38076
01.06.19;WA55;Synthetische oder künstliche Spinnfaser;150536;114734;35802
01.06.19;WA56;Watte, Filz, Vliesstoff usw., Tauwerk;199741;124443;75298
01.06.19;WA57;Teppiche, Fussbodenbelag aus Spinnstoff;42713;82439;-39726
01.06.19;WA58;Spezialgewebe, Spitzen, Tapisserien;42966;21316;21650
01.06.19;WA59;Getränkte, bestrichene usw. Gewebe;204028;92535;111493
01.06.19;WA60;Gewirke und Gestricke;56996;35403;21593
01.06.19;WA61;Bekleidung usw. aus Gewirken, Gestricken;746156;1309938;-563782
01.06.19;WA62;Andere Bekleidung, Bekleidungszubehör;775513;1252503;-476990
01.06.19;WA63;Andere Konfektion, Spinnstoffwaren usw.;229620;325907;-96287
01.06.19;WA64;Schuhe, Gamaschen, ähnliche Waren;626348;1005372;-379024
01.06.19;WA65;Kopfbedeckungen und Teile davon;31904;51058;-19154
01.06.19;WA66;Schirme, Gehstöcke usw., Peitschen;9044;17693;-8649
01.06.19;WA67;Zugerichtete Federn, Daunen, künstliche Blumen;9385;17608;-8223
01.06.19;WA68;Waren aus Steinen, Gips, Zement usw.;415078;291789;123289
01.06.19;WA69;Keramische Waren;302226;233968;68258
01.06.19;WA70;Glas und Glaswaren;530041;419390;110651
01.06.19;WA71;Perlen, Edelsteine, Edelmetalle;1150439;1230058;-79619
01.06.19;WA72;Eisen und Stahl;1912657;1962801;-50144
01.06.19;WA73;Waren aus Eisen oder Stahl;2334020;1811611;522409
01.06.19;WA74;Kupfer und Waren daraus;820291;700958;119333
01.06.19;WA75;Nickel und Waren daraus;112372;127934;-15562
01.06.19;WA76;Aluminium und Waren daraus;1247307;1318308;-71001
01.06.19;WA78;Blei und Waren daraus;31426;33174;-1748
01.06.19;WA79;Zink und Waren daraus;72472;125109;-52637
01.06.19;WA80;Zinn und Waren daraus;8573;30468;-21895
01.06.19;WA81;Andere unedle Metalle, Cermets usw.;133794;151262;-17468
01.06.19;WA82;Werkzeuge, Schneidwaren, Essbestecke;672308;434374;237934
01.06.19;WA83;Verschiedene Waren aus unedlen Metallen;615852;398494;217358
01.06.19;WA84;Maschinen, Apparate, mechanische Geräte;18991046;11385734;7605312
01.06.19;WA85;Elektrotechnische Erzeugnisse;11218080;10304896;913184
01.06.19;WA86;Schienenfahrzeuge;289907;285082;4825
01.06.19;WA87;Kraftfahrzeuge, Landfahrzeuge;17107677;10875583;6232094
01.06.19;WA88;Luftfahrzeuge, Raumfahrzeuge;3017234;1203015;1814219
01.06.19;WA89;Wasserfahrzeuge;262270;72440;189830
01.06.19;WA90;Optische, photografische usw. Erzeugnisse;5665580;3194156;2471424
01.06.19;WA91;Uhrmacherwaren;132105;165312;-33207
01.06.19;WA92;Musikinstrumente;54366;50806;3560
01.06.19;WA93;Waffen und Munition;36595;20980;15615
01.06.19;WA94;Möbel, Beleuchtungskörper usw.;1341510;1515724;-174214
01.06.19;WA95;Spielzeug, Spiele usw., Sportgeräte;391978;544445;-152467
01.06.19;WA96;Verschiedene Waren;314961;236524;78437
01.06.19;WA97;Kunstgegenstände, Sammlungsstücke;87584;59104;28480
01.06.19;WA98;Vollständige Fabrikationsanlagen;217134;3090;214044
01.06.19;WA99;Zusammenstellungen verschiedener Waren;1312826;985239;327587
01.06.20;WA01;Lebende Tiere;99217;138608;-39391
01.06.20;WA02;Fleisch;583480;484060;99420
01.06.20;WA03;Fische, Krebs- und Weichtiere;99857;305493;-205636
01.06.20;WA04;Milch, Milcherzeugnisse, Eier, Honig;799840;680380;119460
01.06.20;WA05;Andere Waren tierischen Ursprungs;72755;83726;-10971
01.06.20;WA06;Pflanzen, Waren des Blumenhandels;75530;236935;-161405
01.06.20;WA07;Gemüse, Pflanzen für Ernährung;80479;518686;-438207
01.06.20;WA08;Geniessbare Früchte und Nüsse;173955;1007898;-833943
01.06.20;WA09;Kaffee, Tee, Mate, Gewürze;209632;355657;-146025
01.06.20;WA10;Getreide;123962;208759;-84797
01.06.20;WA11;Müllereierzeugnisse, Malz usw.;134018;53735;80283
01.06.20;WA12;Ölsamen usw., Heilpflanzen usw.;92925;370639;-277714
01.06.20;WA13;Schellack, Gummen, Harz, Pflanzensaft;54110;59704;-5594
01.06.20;WA14;Flechtstoffe usw. pflanzlichen Ursprungs;776;3802;-3026
01.06.20;WA15;Tierische und pflanzliche Fette, Öle, Wachs;227864;302590;-74726
01.06.20;WA16;Zubereitungen von Fleisch, Fisch usw.;252747;229361;23386
01.06.20;WA17;Zucker und Zuckerwaren;168863;124275;44588
01.06.20;WA18;Kakao und Zubereitungen aus Kakao;366764;344361;22403
01.06.20;WA19;Zubereitungen aus Getreide usw., Backwaren;524201;339830;184371
01.06.20;WA20;Zubereitungen von Gemüse, Früchten usw.;224220;375185;-150965
01.06.20;WA21;Verschiedene Lebensmittelzubereitungen;528690;318525;210165
01.06.20;WA22;Getränke, alkoholhaltige Flüssigkeiten, Essig;457878;590589;-132711
01.06.20;WA23;Rückstände der Lebensmittelindustrie, Futter;367725;329445;38280
01.06.20;WA24;Tabak;203762;246023;-42261
01.06.20;WA25;Salz, Schwefel, Steine, Erden usw.;157049;131585;25464
01.06.20;WA26;Erze, Schlacken, Aschen;32572;513048;-480476
01.06.20;WA27;Mineralische Brennstoffe usw.;1524333;4474817;-2950484
01.06.20;WA28;Anorganische chemische Erzeugnisse;651202;414627;236575
01.06.20;WA29;Organische chemische Erzeugnisse;1817145;3264646;-1447501
01.06.20;WA30;Pharmazeutische Erzeugnisse;6980241;4876865;2103376
01.06.20;WA31;Düngemittel;164807;72868;91939
01.06.20;WA32;Gerb- und Farbstoffe, Farben, Lacke usw.;801720;462157;339563
01.06.20;WA33;Etherische Öle, Riech-, Schönheitsmittel;670321;478798;191523
01.06.20;WA34;Seifen, Waschmittel usw.;561099;326535;234564
01.06.20;WA35;Eiweissstoffe, Klebstoffe, Enzyme;270266;148983;121283
01.06.20;WA36;Sprengstoffe, pyrotechnische Artikel usw.;17470;23291;-5821
01.06.20;WA37;Photochemische Erzeugnisse;77229;51956;25273
01.06.20;WA38;Verschiedene Erzeugnisse der Chemischen Industrie;1849142;1217761;631381
01.06.20;WA39;Kunststoffe und Waren daraus;4465211;2985585;1479626
01.06.20;WA40;Kautschuk und Waren daraus;1050772;917307;133465
01.06.20;WA41;Häute, Felle, Leder;37577;31027;6550
01.06.20;WA42;Lederwaren, Sattlerwaren;170699;290513;-119814
01.06.20;WA43;Pelzfelle, künstliches Pelzwerk;2525;3382;-857
01.06.20;WA44;Holz, Holzwaren, Holzkohle;725318;655790;69528
01.06.20;WA45;Kork, Korkwaren;1852;6112;-4260
01.06.20;WA46;Flechtwaren, Korbmacherwaren;5438;9391;-3953
01.06.20;WA47;Halbstoffe aus Holz usw., Papierabfall;74779;223988;-149209
01.06.20;WA48;Papier, Pappe und Waren daraus;1311309;859077;452232
01.06.20;WA49;Bücher, Zeitungen, Bilddrucke usw.;282790;214435;68355
01.06.20;WA50;Seide;1728;3982;-2254
01.06.20;WA51;Wolle, feine und grobe Tierhaare;31145;33041;-1896
01.06.20;WA52;Baumwolle;47913;55991;-8078
01.06.20;WA53;Andere pflanzliche Spinnstoffe, Papiergarn;2042;3405;-1363
01.06.20;WA54;Synthetisches oder künstliches Filament;101399;84946;16453
01.06.20;WA55;Synthetische oder künstliche Spinnfaser;108413;90913;17500
01.06.20;WA56;Watte, Filz, Vliesstoff usw., Tauwerk;193754;116656;77098
01.06.20;WA57;Teppiche, Fussbodenbelag aus Spinnstoff;36753;72173;-35420
01.06.20;WA58;Spezialgewebe, Spitzen, Tapisserien;32027;18307;13720
01.06.20;WA59;Getränkte, bestrichene usw. Gewebe;163267;77229;86038
01.06.20;WA60;Gewirke und Gestricke;46464;31923;14541
01.06.20;WA61;Bekleidung usw. aus Gewirken, Gestricken;760919;1079979;-319060
01.06.20;WA62;Andere Bekleidung, Bekleidungszubehör;779335;1121529;-342194
01.06.20;WA63;Andere Konfektion, Spinnstoffwaren usw.;363356;1167506;-804150
01.06.20;WA64;Schuhe, Gamaschen, ähnliche Waren;530096;840090;-309994
01.06.20;WA65;Kopfbedeckungen und Teile davon;41409;51209;-9800
01.06.20;WA66;Schirme, Gehstöcke usw., Peitschen;9587;21891;-12304
01.06.20;WA67;Zugerichtete Federn, Daunen, künstliche Blumen;9764;15334;-5570
01.06.20;WA68;Waren aus Steinen, Gips, Zement usw.;369986;253904;116082
01.06.20;WA69;Keramische Waren;253635;219949;33686
01.06.20;WA70;Glas und Glaswaren;465906;352333;113573
01.06.20;WA71;Perlen, Edelsteine, Edelmetalle;1434791;1641354;-206563
01.06.20;WA72;Eisen und Stahl;1460687;1401208;59479
01.06.20;WA73;Waren aus Eisen oder Stahl;2187062;1538115;648947
01.06.20;WA74;Kupfer und Waren daraus;770920;636121;134799
01.06.20;WA75;Nickel und Waren daraus;105285;102995;2290
01.06.20;WA76;Aluminium und Waren daraus;1006837;991901;14936
01.06.20;WA78;Blei und Waren daraus;26492;19326;7166
01.06.20;WA79;Zink und Waren daraus;50036;81502;-31466
01.06.20;WA80;Zinn und Waren daraus;5972;19961;-13989
01.06.20;WA81;Andere unedle Metalle, Cermets usw.;78680;110747;-32067
01.06.20;WA82;Werkzeuge, Schneidwaren, Essbestecke;608343;373069;235274
01.06.20;WA83;Verschiedene Waren aus unedlen Metallen;517572;359216;158356
01.06.20;WA84;Maschinen, Apparate, mechanische Geräte;16946788;10542382;6404406
01.06.20;WA85;Elektrotechnische Erzeugnisse;10291447;10207776;83671
01.06.20;WA86;Schienenfahrzeuge;279438;282054;-2616
01.06.20;WA87;Kraftfahrzeuge, Landfahrzeuge;15260918;9022231;6238687
01.06.20;WA88;Luftfahrzeuge, Raumfahrzeuge;2274022;629676;1644346
01.06.20;WA89;Wasserfahrzeuge;342931;144993;197938
01.06.20;WA90;Optische, photografische usw. Erzeugnisse;5129396;3010277;2119119
01.06.20;WA91;Uhrmacherwaren;105367;157181;-51814
01.06.20;WA92;Musikinstrumente;45699;50378;-4679
01.06.20;WA93;Waffen und Munition;37039;24571;12468
01.06.20;WA94;Möbel, Beleuchtungskörper usw.;1173426;1463401;-289975
01.06.20;WA95;Spielzeug, Spiele usw., Sportgeräte;376179;565980;-189801
01.06.20;WA96;Verschiedene Waren;311558;227420;84138
01.06.20;WA97;Kunstgegenstände, Sammlungsstücke;60528;25748;34780
01.06.20;WA98;Vollständige Fabrikationsanlagen;112022;NULL;#WERT!
01.06.20;WA99;Zusammenstellungen verschiedener Waren;990793;955535;35258
01.06.21;WA01;Lebende Tiere;98035;137304;-39269
01.06.21;WA02;Fleisch;493791;512390;-18599
01.06.21;WA03;Fische, Krebs- und Weichtiere;112715;282250;-169535
01.06.21;WA04;Milch, Milcherzeugnisse, Eier, Honig;807416;761049;46367
01.06.21;WA05;Andere Waren tierischen Ursprungs;78047;89131;-11084
01.06.21;WA06;Pflanzen, Waren des Blumenhandels;76594;267154;-190560
01.06.21;WA07;Gemüse, Pflanzen für Ernährung;86388;515956;-429568
01.06.21;WA08;Geniessbare Früchte und Nüsse;165456;1006040;-840584
01.06.21;WA09;Kaffee, Tee, Mate, Gewürze;250880;365304;-114424
01.06.21;WA10;Getreide;179358;242424;-63066
01.06.21;WA11;Müllereierzeugnisse, Malz usw.;147502;68944;78558
01.06.21;WA12;Ölsamen usw., Heilpflanzen usw.;98968;512221;-413253
01.06.21;WA13;Schellack, Gummen, Harz, Pflanzensaft;63481;51920;11561
01.06.21;WA14;Flechtstoffe usw. pflanzlichen Ursprungs;1025;4606;-3581
01.06.21;WA15;Tierische und pflanzliche Fette, Öle, Wachs;302793;376862;-74069
01.06.21;WA16;Zubereitungen von Fleisch, Fisch usw.;257237;257927;-690
01.06.21;WA17;Zucker und Zuckerwaren;232439;142796;89643
01.06.21;WA18;Kakao und Zubereitungen aus Kakao;397957;356872;41085
01.06.21;WA19;Zubereitungen aus Getreide usw., Backwaren;562255;388789;173466
01.06.21;WA20;Zubereitungen von Gemüse, Früchten usw.;236808;436899;-200091
01.06.21;WA21;Verschiedene Lebensmittelzubereitungen;582291;373830;208461
01.06.21;WA22;Getränke, alkoholhaltige Flüssigkeiten, Essig;609689;686886;-77197
01.06.21;WA23;Rückstände der Lebensmittelindustrie, Futter;461223;422708;38515
01.06.21;WA24;Tabak;235116;263096;-27980
01.06.21;WA25;Salz, Schwefel, Steine, Erden usw.;180515;177021;3494
01.06.21;WA26;Erze, Schlacken, Aschen;67271;1298600;-1231329
01.06.21;WA27;Mineralische Brennstoffe usw.;2004347;7066168;-5061821
01.06.21;WA28;Anorganische chemische Erzeugnisse;1085299;588928;496371
01.06.21;WA29;Organische chemische Erzeugnisse;2431286;3293207;-861921
01.06.21;WA30;Pharmazeutische Erzeugnisse;8913936;6262273;2651663
01.06.21;WA31;Düngemittel;176200;90953;85247
01.06.21;WA32;Gerb- und Farbstoffe, Farben, Lacke usw.;1039220;535841;503379
01.06.21;WA33;Etherische Öle, Riech-, Schönheitsmittel;820298;625077;195221
01.06.21;WA34;Seifen, Waschmittel usw.;684684;378403;306281
01.06.21;WA35;Eiweissstoffe, Klebstoffe, Enzyme;372499;230795;141704
01.06.21;WA36;Sprengstoffe, pyrotechnische Artikel usw.;28959;11617;17342
01.06.21;WA37;Photochemische Erzeugnisse;91418;60792;30626
01.06.21;WA38;Verschiedene Erzeugnisse der Chemischen Industrie;2367102;1703433;663669
01.06.21;WA39;Kunststoffe und Waren daraus;6222230;4188536;2033694
01.06.21;WA40;Kautschuk und Waren daraus;1358527;1368687;-10160
01.06.21;WA41;Häute, Felle, Leder;55949;48253;7696
01.06.21;WA42;Lederwaren, Sattlerwaren;208674;342758;-134084
01.06.21;WA43;Pelzfelle, künstliches Pelzwerk;5507;9018;-3511
01.06.21;WA44;Holz, Holzwaren, Holzkohle;1045158;923786;121372
01.06.21;WA45;Kork, Korkwaren;2863;11262;-8399
01.06.21;WA46;Flechtwaren, Korbmacherwaren;5771;14104;-8333
01.06.21;WA47;Halbstoffe aus Holz usw., Papierabfall;106009;338953;-232944
01.06.21;WA48;Papier, Pappe und Waren daraus;1646925;978528;668397
01.06.21;WA49;Bücher, Zeitungen, Bilddrucke usw.;300223;238789;61434
01.06.21;WA50;Seide;2620;3255;-635
01.06.21;WA51;Wolle, feine und grobe Tierhaare;41034;41635;-601
01.06.21;WA52;Baumwolle;52113;56604;-4491
01.06.21;WA53;Andere pflanzliche Spinnstoffe, Papiergarn;3294;5714;-2420
01.06.21;WA54;Synthetisches oder künstliches Filament;138216;115854;22362
01.06.21;WA55;Synthetische oder künstliche Spinnfaser;136883;120717;16166
01.06.21;WA56;Watte, Filz, Vliesstoff usw., Tauwerk;232344;149523;82821
01.06.21;WA57;Teppiche, Fussbodenbelag aus Spinnstoff;45824;90011;-44187
01.06.21;WA58;Spezialgewebe, Spitzen, Tapisserien;42370;21533;20837
01.06.21;WA59;Getränkte, bestrichene usw. Gewebe;215495;103023;112472
01.06.21;WA60;Gewirke und Gestricke;61398;38894;22504
01.06.21;WA61;Bekleidung usw. aus Gewirken, Gestricken;912666;1466940;-554274
01.06.21;WA62;Andere Bekleidung, Bekleidungszubehör;840007;1268588;-428581
01.06.21;WA63;Andere Konfektion, Spinnstoffwaren usw.;286441;432634;-146193
01.06.21;WA64;Schuhe, Gamaschen, ähnliche Waren;698007;922605;-224598
01.06.21;WA65;Kopfbedeckungen und Teile davon;50837;69471;-18634
01.06.21;WA66;Schirme, Gehstöcke usw., Peitschen;12204;25620;-13416
01.06.21;WA67;Zugerichtete Federn, Daunen, künstliche Blumen;12144;16358;-4214
01.06.21;WA68;Waren aus Steinen, Gips, Zement usw.;459172;321404;137768
01.06.21;WA69;Keramische Waren;338006;287083;50923
01.06.21;WA70;Glas und Glaswaren;591584;437660;153924
01.06.21;WA71;Perlen, Edelsteine, Edelmetalle;2016255;3215414;-1199159
01.06.21;WA72;Eisen und Stahl;2407678;2576606;-168928
01.06.21;WA73;Waren aus Eisen oder Stahl;2446101;2091762;354339
01.06.21;WA74;Kupfer und Waren daraus;1260227;1028204;232023
01.06.21;WA75;Nickel und Waren daraus;119195;133237;-14042
01.06.21;WA76;Aluminium und Waren daraus;1395605;1489527;-93922
01.06.21;WA78;Blei und Waren daraus;54020;40958;13062
01.06.21;WA79;Zink und Waren daraus;67090;122168;-55078
01.06.21;WA80;Zinn und Waren daraus;12280;50605;-38325
01.06.21;WA81;Andere unedle Metalle, Cermets usw.;106560;139005;-32445
01.06.21;WA82;Werkzeuge, Schneidwaren, Essbestecke;773968;501973;271995
01.06.21;WA83;Verschiedene Waren aus unedlen Metallen;685463;446469;238994
01.06.21;WA84;Maschinen, Apparate, mechanische Geräte;19874786;12935712;6939074
01.06.21;WA85;Elektrotechnische Erzeugnisse;12675784;12446477;229307
01.06.21;WA86;Schienenfahrzeuge;289846;241527;48319
01.06.21;WA87;Kraftfahrzeuge, Landfahrzeuge;18072814;10202302;7870512
01.06.21;WA88;Luftfahrzeuge, Raumfahrzeuge;2517572;1062936;1454636
01.06.21;WA89;Wasserfahrzeuge;818124;309540;508584
01.06.21;WA90;Optische, photografische usw. Erzeugnisse;6063259;3673943;2389316
01.06.21;WA91;Uhrmacherwaren;152051;208836;-56785
01.06.21;WA92;Musikinstrumente;60765;64853;-4088
01.06.21;WA93;Waffen und Munition;51004;20115;30889
01.06.21;WA94;Möbel, Beleuchtungskörper usw.;1459181;1817226;-358045
01.06.21;WA95;Spielzeug, Spiele usw., Sportgeräte;450451;743671;-293220
01.06.21;WA96;Verschiedene Waren;338113;265655;72458
01.06.21;WA97;Kunstgegenstände, Sammlungsstücke;139801;116594;23207
01.06.21;WA98;Vollständige Fabrikationsanlagen;26173;NULL;#WERT!
01.06.21;WA99;Zusammenstellungen verschiedener Waren;1247602;971069;276533
01.06.22;WA01;Lebende Tiere;130053;110960;19093
01.06.22;WA02;Fleisch;646599;628868;17731
01.06.22;WA03;Fische, Krebs- und Weichtiere;141241;367157;-225916
01.06.22;WA04;Milch, Milcherzeugnisse, Eier, Honig;1123603;925537;198066
01.06.22;WA05;Andere Waren tierischen Ursprungs;88656;104043;-15387
01.06.22;WA06;Pflanzen, Waren des Blumenhandels;69330;234576;-165246
01.06.22;WA07;Gemüse, Pflanzen für Ernährung;100744;546126;-445382
01.06.22;WA08;Geniessbare Früchte und Nüsse;176758;1085431;-908673
01.06.22;WA09;Kaffee, Tee, Mate, Gewürze;325293;531196;-205903
01.06.22;WA10;Getreide;397256;372556;24700
01.06.22;WA11;Müllereierzeugnisse, Malz usw.;179237;82108;97129
01.06.22;WA12;Ölsamen usw., Heilpflanzen usw.;138789;761761;-622972
01.06.22;WA13;Schellack, Gummen, Harz, Pflanzensaft;63154;75064;-11910
01.06.22;WA14;Flechtstoffe usw. pflanzlichen Ursprungs;1019;4240;-3221
01.06.22;WA15;Tierische und pflanzliche Fette, Öle, Wachs;443226;648884;-205658
01.06.22;WA16;Zubereitungen von Fleisch, Fisch usw.;308284;313734;-5450
01.06.22;WA17;Zucker und Zuckerwaren;274851;159672;115179
01.06.22;WA18;Kakao und Zubereitungen aus Kakao;433910;370429;63481
01.06.22;WA19;Zubereitungen aus Getreide usw., Backwaren;676391;470568;205823
01.06.22;WA20;Zubereitungen von Gemüse, Früchten usw.;270955;461886;-190931
01.06.22;WA21;Verschiedene Lebensmittelzubereitungen;698484;403874;294610
01.06.22;WA22;Getränke, alkoholhaltige Flüssigkeiten, Essig;637817;822929;-185112
01.06.22;WA23;Rückstände der Lebensmittelindustrie, Futter;541311;455105;86206
01.06.22;WA24;Tabak;238943;302824;-63881
01.06.22;WA25;Salz, Schwefel, Steine, Erden usw.;228297;197109;31188
01.06.22;WA26;Erze, Schlacken, Aschen;86659;1079404;-992745
01.06.22;WA27;Mineralische Brennstoffe usw.;5032964;16742729;-11709765
01.06.22;WA28;Anorganische chemische Erzeugnisse;1412316;887494;524822
01.06.22;WA29;Organische chemische Erzeugnisse;2909152;6436575;-3527423
01.06.22;WA30;Pharmazeutische Erzeugnisse;10157495;6152002;4005493
01.06.22;WA31;Düngemittel;449626;199867;249759
01.06.22;WA32;Gerb- und Farbstoffe, Farben, Lacke usw.;1133583;603332;530251
01.06.22;WA33;Etherische Öle, Riech-, Schönheitsmittel;969446;664156;305290
01.06.22;WA34;Seifen, Waschmittel usw.;809703;442792;366911
01.06.22;WA35;Eiweissstoffe, Klebstoffe, Enzyme;426246;263448;162798
01.06.22;WA36;Sprengstoffe, pyrotechnische Artikel usw.;30608;12591;18017
01.06.22;WA37;Photochemische Erzeugnisse;99497;59288;40209
01.06.22;WA38;Verschiedene Erzeugnisse der Chemischen Industrie;2763518;1907999;855519
01.06.22;WA39;Kunststoffe und Waren daraus;7039043;4852596;2186447
01.06.22;WA40;Kautschuk und Waren daraus;1461365;1442008;19357
01.06.22;WA41;Häute, Felle, Leder;59417;44926;14491
01.06.22;WA42;Lederwaren, Sattlerwaren;255432;399129;-143697
01.06.22;WA43;Pelzfelle, künstliches Pelzwerk;4238;9144;-4906
01.06.22;WA44;Holz, Holzwaren, Holzkohle;1165484;1051423;114061
01.06.22;WA45;Kork, Korkwaren;2184;9829;-7645
01.06.22;WA46;Flechtwaren, Korbmacherwaren;6227;18292;-12065
01.06.22;WA47;Halbstoffe aus Holz usw., Papierabfall;136220;448476;-312256
01.06.22;WA48;Papier, Pappe und Waren daraus;2176001;1336689;839312
01.06.22;WA49;Bücher, Zeitungen, Bilddrucke usw.;316943;238712;78231
01.06.22;WA50;Seide;2104;2820;-716
01.06.22;WA51;Wolle, feine und grobe Tierhaare;48189;45457;2732
01.06.22;WA52;Baumwolle;60965;74842;-13877
01.06.22;WA53;Andere pflanzliche Spinnstoffe, Papiergarn;3072;6668;-3596
01.06.22;WA54;Synthetisches oder künstliches Filament;154625;126749;27876
01.06.22;WA55;Synthetische oder künstliche Spinnfaser;138718;140764;-2046
01.06.22;WA56;Watte, Filz, Vliesstoff usw., Tauwerk;249425;164511;84914
01.06.22;WA57;Teppiche, Fussbodenbelag aus Spinnstoff;46047;89049;-43002
01.06.22;WA58;Spezialgewebe, Spitzen, Tapisserien;45994;22716;23278
01.06.22;WA59;Getränkte, bestrichene usw. Gewebe;234642;103896;130746
01.06.22;WA60;Gewirke und Gestricke;68315;42489;25826
01.06.22;WA61;Bekleidung usw. aus Gewirken, Gestricken;1040682;1868801;-828119
01.06.22;WA62;Andere Bekleidung, Bekleidungszubehör;935651;1534336;-598685
01.06.22;WA63;Andere Konfektion, Spinnstoffwaren usw.;274675;456278;-181603
01.06.22;WA64;Schuhe, Gamaschen, ähnliche Waren;801541;1141673;-340132
01.06.22;WA65;Kopfbedeckungen und Teile davon;65534;80855;-15321
01.06.22;WA66;Schirme, Gehstöcke usw., Peitschen;13993;38094;-24101
01.06.22;WA67;Zugerichtete Federn, Daunen, künstliche Blumen;12290;25667;-13377
01.06.22;WA68;Waren aus Steinen, Gips, Zement usw.;496048;344188;151860
01.06.22;WA69;Keramische Waren;371827;308690;63137
01.06.22;WA70;Glas und Glaswaren;689432;486909;202523
01.06.22;WA71;Perlen, Edelsteine, Edelmetalle;1824423;2454153;-629730
01.06.22;WA72;Eisen und Stahl;3282851;3557307;-274456
01.06.22;WA73;Waren aus Eisen oder Stahl;2969658;2629628;340030
01.06.22;WA74;Kupfer und Waren daraus;1389580;1494502;-104922
01.06.22;WA75;Nickel und Waren daraus;177479;233592;-56113
01.06.22;WA76;Aluminium und Waren daraus;1860271;2362646;-502375
01.06.22;WA78;Blei und Waren daraus;34599;49384;-14785
01.06.22;WA79;Zink und Waren daraus;80711;179692;-98981
01.06.22;WA80;Zinn und Waren daraus;15199;68328;-53129
01.06.22;WA81;Andere unedle Metalle, Cermets usw.;152917;214921;-62004
01.06.22;WA82;Werkzeuge, Schneidwaren, Essbestecke;798998;538039;260959
01.06.22;WA83;Verschiedene Waren aus unedlen Metallen;734963;503899;231064
01.06.22;WA84;Maschinen, Apparate, mechanische Geräte;20820279;13926012;6894267
01.06.22;WA85;Elektrotechnische Erzeugnisse;14295497;15802823;-1507326
01.06.22;WA86;Schienenfahrzeuge;268927;294440;-25513
01.06.22;WA87;Kraftfahrzeuge, Landfahrzeuge;21755591;11288778;10466813
01.06.22;WA88;Luftfahrzeuge, Raumfahrzeuge;2619711;1179287;1440424
01.06.22;WA89;Wasserfahrzeuge;969059;299606;669453
01.06.22;WA90;Optische, photografische usw. Erzeugnisse;6482042;3743040;2739002
01.06.22;WA91;Uhrmacherwaren;153921;228008;-74087
01.06.22;WA92;Musikinstrumente;76074;58106;17968
01.06.22;WA93;Waffen und Munition;60131;33322;26809
01.06.22;WA94;Möbel, Beleuchtungskörper usw.;1493958;1931190;-437232
01.06.22;WA95;Spielzeug, Spiele usw., Sportgeräte;435863;734416;-298553
01.06.22;WA96;Verschiedene Waren;364836;297472;67364
01.06.22;WA97;Kunstgegenstände, Sammlungsstücke;92947;175529;-82582
01.06.22;WA98;Vollständige Fabrikationsanlagen;48412;NULL;#WERT!
01.06.22;WA99;Zusammenstellungen verschiedener Waren;1548756;987719;561037
01.06.23;WA01;Lebende Tiere;128795;170845;-42050
01.06.23;WA02;Fleisch;650904;669599;-18695
01.06.23;WA03;Fische, Krebs- und Weichtiere;126746;345666;-218920
01.06.23;WA04;Milch, Milcherzeugnisse, Eier, Honig;1092112;900080;192032
01.06.23;WA05;Andere Waren tierischen Ursprungs;86855;104231;-17376
01.06.23;WA06;Pflanzen, Waren des Blumenhandels;65960;224660;-158700
01.06.23;WA07;Gemüse, Pflanzen für Ernährung;132361;659304;-526943
01.06.23;WA08;Geniessbare Früchte und Nüsse;193500;1120967;-927467
01.06.23;WA09;Kaffee, Tee, Mate, Gewürze;336573;470234;-133661
01.06.23;WA10;Getreide;246472;332574;-86102
01.06.23;WA11;Müllereierzeugnisse, Malz usw.;224762;97219;127543
01.06.23;WA12;Ölsamen usw., Heilpflanzen usw.;113639;525450;-411811
01.06.23;WA13;Schellack, Gummen, Harz, Pflanzensaft;62663;54540;8123
01.06.23;WA14;Flechtstoffe usw. pflanzlichen Ursprungs;1443;4259;-2816
01.06.23;WA15;Tierische und pflanzliche Fette, Öle, Wachs;355611;434821;-79210
01.06.23;WA16;Zubereitungen von Fleisch, Fisch usw.;339703;336922;2781
01.06.23;WA17;Zucker und Zuckerwaren;304953;227455;77498
01.06.23;WA18;Kakao und Zubereitungen aus Kakao;537625;441705;95920
01.06.23;WA19;Zubereitungen aus Getreide usw., Backwaren;828524;575017;253507
01.06.23;WA20;Zubereitungen von Gemüse, Früchten usw.;305535;549557;-244022
01.06.23;WA21;Verschiedene Lebensmittelzubereitungen;792223;504555;287668
01.06.23;WA22;Getränke, alkoholhaltige Flüssigkeiten, Essig;686047;818477;-132430
01.06.23;WA23;Rückstände der Lebensmittelindustrie, Futter;601827;471063;130764
01.06.23;WA24;Tabak;280687;492335;-211648
01.06.23;WA25;Salz, Schwefel, Steine, Erden usw.;227333;185241;42092
01.06.23;WA26;Erze, Schlacken, Aschen;61729;906528;-844799
01.06.23;WA27;Mineralische Brennstoffe usw.;2504048;9461751;-6957703
01.06.23;WA28;Anorganische chemische Erzeugnisse;1295572;672280;623292
01.06.23;WA29;Organische chemische Erzeugnisse;2467971;2953150;-485179
01.06.23;WA30;Pharmazeutische Erzeugnisse;9360357;6217683;3142674
01.06.23;WA31;Düngemittel;212627;127744;84883
01.06.23;WA32;Gerb- und Farbstoffe, Farben, Lacke usw.;1038031;495466;542565
01.06.23;WA33;Etherische Öle, Riech-, Schönheitsmittel;1086464;747328;339136
01.06.23;WA34;Seifen, Waschmittel usw.;768912;450796;318116
01.06.23;WA35;Eiweissstoffe, Klebstoffe, Enzyme;408195;246260;161935
01.06.23;WA36;Sprengstoffe, pyrotechnische Artikel usw.;41300;29044;12256
01.06.23;WA37;Photochemische Erzeugnisse;91104;49805;41299
01.06.23;WA38;Verschiedene Erzeugnisse der Chemischen Industrie;2890431;1708937;1181494
01.06.23;WA39;Kunststoffe und Waren daraus;6099885;4033308;2066577
01.06.23;WA40;Kautschuk und Waren daraus;1487849;1383461;104388
01.06.23;WA41;Häute, Felle, Leder;52363;47401;4962
01.06.23;WA42;Lederwaren, Sattlerwaren;257486;409295;-151809
01.06.23;WA43;Pelzfelle, künstliches Pelzwerk;3218;6553;-3335
01.06.23;WA44;Holz, Holzwaren, Holzkohle;889316;749639;139677
01.06.23;WA45;Kork, Korkwaren;2169;7666;-5497
01.06.23;WA46;Flechtwaren, Korbmacherwaren;5845;11863;-6018
01.06.23;WA47;Halbstoffe aus Holz usw., Papierabfall;114994;326065;-211071
01.06.23;WA48;Papier, Pappe und Waren daraus;1750230;1130078;620152
01.06.23;WA49;Bücher, Zeitungen, Bilddrucke usw.;295708;205190;90518
01.06.23;WA50;Seide;4503;3526;977
01.06.23;WA51;Wolle, feine und grobe Tierhaare;41292;44847;-3555
01.06.23;WA52;Baumwolle;60413;65900;-5487
01.06.23;WA53;Andere pflanzliche Spinnstoffe, Papiergarn;2666;4551;-1885
01.06.23;WA54;Synthetisches oder künstliches Filament;148086;118372;29714
01.06.23;WA55;Synthetische oder künstliche Spinnfaser;133607;127738;5869
01.06.23;WA56;Watte, Filz, Vliesstoff usw., Tauwerk;233403;158634;74769
01.06.23;WA57;Teppiche, Fussbodenbelag aus Spinnstoff;49654;94847;-45193
01.06.23;WA58;Spezialgewebe, Spitzen, Tapisserien;48189;23010;25179
01.06.23;WA59;Getränkte, bestrichene usw. Gewebe;246576;120364;126212
01.06.23;WA60;Gewirke und Gestricke;64218;38925;25293
01.06.23;WA61;Bekleidung usw. aus Gewirken, Gestricken;1051966;1608510;-556544
01.06.23;WA62;Andere Bekleidung, Bekleidungszubehör;970258;1458778;-488520
01.06.23;WA63;Andere Konfektion, Spinnstoffwaren usw.;289530;390433;-100903
01.06.23;WA64;Schuhe, Gamaschen, ähnliche Waren;910835;1077641;-166806
01.06.23;WA65;Kopfbedeckungen und Teile davon;68840;77813;-8973
01.06.23;WA66;Schirme, Gehstöcke usw., Peitschen;13405;21532;-8127
01.06.23;WA67;Zugerichtete Federn, Daunen, künstliche Blumen;12369;21006;-8637
01.06.23;WA68;Waren aus Steinen, Gips, Zement usw.;490874;334187;156687
01.06.23;WA69;Keramische Waren;348302;271704;76598
01.06.23;WA70;Glas und Glaswaren;717254;509235;208019
01.06.23;WA71;Perlen, Edelsteine, Edelmetalle;1724539;1971630;-247091
01.06.23;WA72;Eisen und Stahl;2764963;2605689;159274
01.06.23;WA73;Waren aus Eisen oder Stahl;3127972;2475563;652409
01.06.23;WA74;Kupfer und Waren daraus;1234922;936813;298109
01.06.23;WA75;Nickel und Waren daraus;210806;224246;-13440
01.06.23;WA76;Aluminium und Waren daraus;1663745;1877233;-213488
01.06.23;WA78;Blei und Waren daraus;45392;47344;-1952
01.06.23;WA79;Zink und Waren daraus;59488;154162;-94674
01.06.23;WA80;Zinn und Waren daraus;16666;40375;-23709
01.06.23;WA81;Andere unedle Metalle, Cermets usw.;152389;196529;-44140
01.06.23;WA82;Werkzeuge, Schneidwaren, Essbestecke;826306;498435;327871
01.06.23;WA83;Verschiedene Waren aus unedlen Metallen;738688;494732;243956
01.06.23;WA84;Maschinen, Apparate, mechanische Geräte;23136244;14575130;8561114
01.06.23;WA85;Elektrotechnische Erzeugnisse;15606382;17926754;-2320372
01.06.23;WA86;Schienenfahrzeuge;226578;298290;-71712
01.06.23;WA87;Kraftfahrzeuge, Landfahrzeuge;25248032;14180610;11067422
01.06.23;WA88;Luftfahrzeuge, Raumfahrzeuge;3154501;1051286;2103215
01.06.23;WA89;Wasserfahrzeuge;760696;560116;200580
01.06.23;WA90;Optische, photografische usw. Erzeugnisse;6964213;4050599;2913614
01.06.23;WA91;Uhrmacherwaren;160839;225687;-64848
01.06.23;WA92;Musikinstrumente;82765;62331;20434
01.06.23;WA93;Waffen und Munition;68481;41518;26963
01.06.23;WA94;Möbel, Beleuchtungskörper usw.;1539091;1805094;-266003
01.06.23;WA95;Spielzeug, Spiele usw., Sportgeräte;470467;642977;-172510
01.06.23;WA96;Verschiedene Waren;385513;312293;73220
01.06.23;WA97;Kunstgegenstände, Sammlungsstücke;92075;80143;11932
01.06.23;WA98;Vollständige Fabrikationsanlagen;103835;1428;102407
01.06.23;WA99;Zusammenstellungen verschiedener Waren;2040150;1178707;861443
01.06.24;WA01;Lebende Tiere;112291;147673;-35382
01.06.24;WA02;Fleisch;594860;615255;-20395
01.06.24;WA03;Fische, Krebs- und Weichtiere;105497;313548;-208051
01.06.24;WA04;Milch, Milcherzeugnisse, Eier, Honig;1032909;933952;98957
01.06.24;WA05;Andere Waren tierischen Ursprungs;69766;86049;-16283
01.06.24;WA06;Pflanzen, Waren des Blumenhandels;61842;229234;-167392
01.06.24;WA07;Gemüse, Pflanzen für Ernährung;144428;650355;-505927
01.06.24;WA08;Geniessbare Früchte und Nüsse;165602;1124355;-958753
01.06.24;WA09;Kaffee, Tee, Mate, Gewürze;310915;518884;-207969
01.06.24;WA10;Getreide;266584;271546;-4962
01.06.24;WA11;Müllereierzeugnisse, Malz usw.;185190;83627;101563
01.06.24;WA12;Ölsamen usw., Heilpflanzen usw.;121579;469383;-347804
01.06.24;WA13;Schellack, Gummen, Harz, Pflanzensaft;58671;54014;4657
01.06.24;WA14;Flechtstoffe usw. pflanzlichen Ursprungs;1063;3962;-2899
01.06.24;WA15;Tierische und pflanzliche Fette, Öle, Wachs;245462;404623;-159161
01.06.24;WA16;Zubereitungen von Fleisch, Fisch usw.;300478;292347;8131
01.06.24;WA17;Zucker und Zuckerwaren;301528;213872;87656
01.06.24;WA18;Kakao und Zubereitungen aus Kakao;692116;688272;3844
01.06.24;WA19;Zubereitungen aus Getreide usw., Backwaren;763860;558855;205005
01.06.24;WA20;Zubereitungen von Gemüse, Früchten usw.;292543;581687;-289144
01.06.24;WA21;Verschiedene Lebensmittelzubereitungen;789923;489959;299964
01.06.24;WA22;Getränke, alkoholhaltige Flüssigkeiten, Essig;654463;768563;-114100
01.06.24;WA23;Rückstände der Lebensmittelindustrie, Futter;526022;416361;109661
01.06.24;WA24;Tabak;269932;459777;-189845
01.06.24;WA25;Salz, Schwefel, Steine, Erden usw.;214104;165909;48195
01.06.24;WA26;Erze, Schlacken, Aschen;67767;614985;-547218
01.06.24;WA27;Mineralische Brennstoffe usw.;2682253;8738748;-6056495
01.06.24;WA28;Anorganische chemische Erzeugnisse;1026575;719056;307519
01.06.24;WA29;Organische chemische Erzeugnisse;2323748;2658649;-334901
01.06.24;WA30;Pharmazeutische Erzeugnisse;9265441;5520415;3745026
01.06.24;WA31;Düngemittel;220794;116631;104163
01.06.24;WA32;Gerb- und Farbstoffe, Farben, Lacke usw.;1011863;457151;554712
01.06.24;WA33;Etherische Öle, Riech-, Schönheitsmittel;990638;744075;246563
01.06.24;WA34;Seifen, Waschmittel usw.;757607;427567;330040
01.06.24;WA35;Eiweissstoffe, Klebstoffe, Enzyme;384269;255601;128668
01.06.24;WA36;Sprengstoffe, pyrotechnische Artikel usw.;51771;28725;23046
01.06.24;WA37;Photochemische Erzeugnisse;86249;56034;30215
01.06.24;WA38;Verschiedene Erzeugnisse der Chemischen Industrie;2682667;1604521;1078146
01.06.24;WA39;Kunststoffe und Waren daraus;5780732;3837737;1942995
01.06.24;WA40;Kautschuk und Waren daraus;1377453;1267553;109900
01.06.24;WA41;Häute, Felle, Leder;44579;37199;7380
01.06.24;WA42;Lederwaren, Sattlerwaren;247762;381681;-133919
01.06.24;WA43;Pelzfelle, künstliches Pelzwerk;3704;6483;-2779
01.06.24;WA44;Holz, Holzwaren, Holzkohle;808255;672995;135260
01.06.24;WA45;Kork, Korkwaren;2498;6887;-4389
01.06.24;WA46;Flechtwaren, Korbmacherwaren;5386;11286;-5900
01.06.24;WA47;Halbstoffe aus Holz usw., Papierabfall;114483;386162;-271679
01.06.24;WA48;Papier, Pappe und Waren daraus;1663518;1080583;582935
01.06.24;WA49;Bücher, Zeitungen, Bilddrucke usw.;262169;188293;73876
01.06.24;WA50;Seide;1319;3901;-2582
01.06.24;WA51;Wolle, feine und grobe Tierhaare;33581;37448;-3867
01.06.24;WA52;Baumwolle;45603;50118;-4515
01.06.24;WA53;Andere pflanzliche Spinnstoffe, Papiergarn;2123;5061;-2938
01.06.24;WA54;Synthetisches oder künstliches Filament;122848;112163;10685
01.06.24;WA55;Synthetische oder künstliche Spinnfaser;120331;115256;5075
01.06.24;WA56;Watte, Filz, Vliesstoff usw., Tauwerk;220649;147843;72806
01.06.24;WA57;Teppiche, Fussbodenbelag aus Spinnstoff;47649;87115;-39466
01.06.24;WA58;Spezialgewebe, Spitzen, Tapisserien;42979;22842;20137
01.06.24;WA59;Getränkte, bestrichene usw. Gewebe;218112;108808;109304
01.06.24;WA60;Gewirke und Gestricke;55588;35889;19699
01.06.24;WA61;Bekleidung usw. aus Gewirken, Gestricken;970351;1465955;-495604
01.06.24;WA62;Andere Bekleidung, Bekleidungszubehör;932271;1325759;-393488
01.06.24;WA63;Andere Konfektion, Spinnstoffwaren usw.;250513;381251;-130738
01.06.24;WA64;Schuhe, Gamaschen, ähnliche Waren;899584;999176;-99592
01.06.24;WA65;Kopfbedeckungen und Teile davon;57111;72740;-15629
01.06.24;WA66;Schirme, Gehstöcke usw., Peitschen;10802;24922;-14120
01.06.24;WA67;Zugerichtete Federn, Daunen, künstliche Blumen;10641;19075;-8434
01.06.24;WA68;Waren aus Steinen, Gips, Zement usw.;464082;312353;151729
01.06.24;WA69;Keramische Waren;325878;237762;88116
01.06.24;WA70;Glas und Glaswaren;649881;463825;186056
01.06.24;WA71;Perlen, Edelsteine, Edelmetalle;1887430;1708309;179121
01.06.24;WA72;Eisen und Stahl;2467493;2342598;124895
01.06.24;WA73;Waren aus Eisen oder Stahl;2739572;2114383;625189
01.06.24;WA74;Kupfer und Waren daraus;1197864;1098628;99236
01.06.24;WA75;Nickel und Waren daraus;165576;182599;-17023
01.06.24;WA76;Aluminium und Waren daraus;1575241;1723924;-148683
01.06.24;WA78;Blei und Waren daraus;42869;62309;-19440
01.06.24;WA79;Zink und Waren daraus;73640;121698;-48058
01.06.24;WA80;Zinn und Waren daraus;11038;47426;-36388
01.06.24;WA81;Andere unedle Metalle, Cermets usw.;136836;181250;-44414
01.06.24;WA82;Werkzeuge, Schneidwaren, Essbestecke;754332;469371;284961
01.06.24;WA83;Verschiedene Waren aus unedlen Metallen;689858;458339;231519
01.06.24;WA84;Maschinen, Apparate, mechanische Geräte;21074515;13034355;8040160
01.06.24;WA85;Elektrotechnische Erzeugnisse;13943875;15080619;-1136744
01.06.24;WA86;Schienenfahrzeuge;250355;296308;-45953
01.06.24;WA87;Kraftfahrzeuge, Landfahrzeuge;22344122;11520468;10823654
01.06.24;WA88;Luftfahrzeuge, Raumfahrzeuge;2588198;969155;1619043
01.06.24;WA89;Wasserfahrzeuge;342869;1311571;-968702
01.06.24;WA90;Optische, photografische usw. Erzeugnisse;6569463;3754171;2815292
01.06.24;WA91;Uhrmacherwaren;154615;212931;-58316
01.06.24;WA92;Musikinstrumente;73704;51727;21977
01.06.24;WA93;Waffen und Munition;55507;28432;27075
01.06.24;WA94;Möbel, Beleuchtungskörper usw.;1416412;1706187;-289775
01.06.24;WA95;Spielzeug, Spiele usw., Sportgeräte;368228;514485;-146257
01.06.24;WA96;Verschiedene Waren;345022;285454;59568
01.06.24;WA97;Kunstgegenstände, Sammlungsstücke;53173;72205;-19032
01.06.24;WA98;Vollständige Fabrikationsanlagen;83961;62;83899
01.06.24;WA99;Zusammenstellungen verschiedener Waren;1460326;1129485;330841
01.06.25;WA01;Lebende Tiere;NULL;NULL;#WERT!
01.06.25;WA02;Fleisch;NULL;NULL;#WERT!
01.06.25;WA03;Fische, Krebs- und Weichtiere;NULL;NULL;#WERT!
01.06.25;WA04;Milch, Milcherzeugnisse, Eier, Honig;NULL;NULL;#WERT!
01.06.25;WA05;Andere Waren tierischen Ursprungs;NULL;NULL;#WERT!
01.06.25;WA06;Pflanzen, Waren des Blumenhandels;NULL;NULL;#WERT!
01.06.25;WA07;Gemüse, Pflanzen für Ernährung;NULL;NULL;#WERT!
01.06.25;WA08;Geniessbare Früchte und Nüsse;NULL;NULL;#WERT!
01.06.25;WA09;Kaffee, Tee, Mate, Gewürze;NULL;NULL;#WERT!
01.06.25;WA10;Getreide;NULL;NULL;#WERT!
01.06.25;WA11;Müllereierzeugnisse, Malz usw.;NULL;NULL;#WERT!
01.06.25;WA12;Ölsamen usw., Heilpflanzen usw.;NULL;NULL;#WERT!
01.06.25;WA13;Schellack, Gummen, Harz, Pflanzensaft;NULL;NULL;#WERT!
01.06.25;WA14;Flechtstoffe usw. pflanzlichen Ursprungs;NULL;NULL;#WERT!
01.06.25;WA15;Tierische und pflanzliche Fette, Öle, Wachs;NULL;NULL;#WERT!
01.06.25;WA16;Zubereitungen von Fleisch, Fisch usw.;NULL;NULL;#WERT!
01.06.25;WA17;Zucker und Zuckerwaren;NULL;NULL;#WERT!
01.06.25;WA18;Kakao und Zubereitungen aus Kakao;NULL;NULL;#WERT!
01.06.25;WA19;Zubereitungen aus Getreide usw., Backwaren;NULL;NULL;#WERT!
01.06.25;WA20;Zubereitungen von Gemüse, Früchten usw.;NULL;NULL;#WERT!
01.06.25;WA21;Verschiedene Lebensmittelzubereitungen;NULL;NULL;#WERT!
01.06.25;WA22;Getränke, alkoholhaltige Flüssigkeiten, Essig;NULL;NULL;#WERT!
01.06.25;WA23;Rückstände der Lebensmittelindustrie, Futter;NULL;NULL;#WERT!
01.06.25;WA24;Tabak;NULL;NULL;#WERT!
01.06.25;WA25;Salz, Schwefel, Steine, Erden usw.;NULL;NULL;#WERT!
01.06.25;WA26;Erze, Schlacken, Aschen;NULL;NULL;#WERT!
01.06.25;WA27;Mineralische Brennstoffe usw.;NULL;NULL;#WERT!
01.06.25;WA28;Anorganische chemische Erzeugnisse;NULL;NULL;#WERT!
01.06.25;WA29;Organische chemische Erzeugnisse;NULL;NULL;#WERT!
01.06.25;WA30;Pharmazeutische Erzeugnisse;NULL;NULL;#WERT!
01.06.25;WA31;Düngemittel;NULL;NULL;#WERT!
01.06.25;WA32;Gerb- und Farbstoffe, Farben, Lacke usw.;NULL;NULL;#WERT!
01.06.25;WA33;Etherische Öle, Riech-, Schönheitsmittel;NULL;NULL;#WERT!
01.06.25;WA34;Seifen, Waschmittel usw.;NULL;NULL;#WERT!
01.06.25;WA35;Eiweissstoffe, Klebstoffe, Enzyme;NULL;NULL;#WERT!
01.06.25;WA36;Sprengstoffe, pyrotechnische Artikel usw.;NULL;NULL;#WERT!
01.06.25;WA37;Photochemische Erzeugnisse;NULL;NULL;#WERT!
01.06.25;WA38;Verschiedene Erzeugnisse der Chemischen Industrie;NULL;NULL;#WERT!
01.06.25;WA39;Kunststoffe und Waren daraus;NULL;NULL;#WERT!
01.06.25;WA40;Kautschuk und Waren daraus;NULL;NULL;#WERT!
01.06.25;WA41;Häute, Felle, Leder;NULL;NULL;#WERT!
01.06.25;WA42;Lederwaren, Sattlerwaren;NULL;NULL;#WERT!
01.06.25;WA43;Pelzfelle, künstliches Pelzwerk;NULL;NULL;#WERT!
01.06.25;WA44;Holz, Holzwaren, Holzkohle;NULL;NULL;#WERT!
01.06.25;WA45;Kork, Korkwaren;NULL;NULL;#WERT!
01.06.25;WA46;Flechtwaren, Korbmacherwaren;NULL;NULL;#WERT!
01.06.25;WA47;Halbstoffe aus Holz usw., Papierabfall;NULL;NULL;#WERT!
01.06.25;WA48;Papier, Pappe und Waren daraus;NULL;NULL;#WERT!
01.06.25;WA49;Bücher, Zeitungen, Bilddrucke usw.;NULL;NULL;#WERT!
01.06.25;WA50;Seide;NULL;NULL;#WERT!
01.06.25;WA51;Wolle, feine und grobe Tierhaare;NULL;NULL;#WERT!
01.06.25;WA52;Baumwolle;NULL;NULL;#WERT!
01.06.25;WA53;Andere pflanzliche Spinnstoffe, Papiergarn;NULL;NULL;#WERT!
01.06.25;WA54;Synthetisches oder künstliches Filament;NULL;NULL;#WERT!
01.06.25;WA55;Synthetische oder künstliche Spinnfaser;NULL;NULL;#WERT!
01.06.25;WA56;Watte, Filz, Vliesstoff usw., Tauwerk;NULL;NULL;#WERT!
01.06.25;WA57;Teppiche, Fussbodenbelag aus Spinnstoff;NULL;NULL;#WERT!
01.06.25;WA58;Spezialgewebe, Spitzen, Tapisserien;NULL;NULL;#WERT!
01.06.25;WA59;Getränkte, bestrichene usw. Gewebe;NULL;NULL;#WERT!
01.06.25;WA60;Gewirke und Gestricke;NULL;NULL;#WERT!
01.06.25;WA61;Bekleidung usw. aus Gewirken, Gestricken;NULL;NULL;#WERT!
01.06.25;WA62;Andere Bekleidung, Bekleidungszubehör;NULL;NULL;#WERT!
01.06.25;WA63;Andere Konfektion, Spinnstoffwaren usw.;NULL;NULL;#WERT!
01.06.25;WA64;Schuhe, Gamaschen, ähnliche Waren;NULL;NULL;#WERT!
01.06.25;WA65;Kopfbedeckungen und Teile davon;NULL;NULL;#WERT!
01.06.25;WA66;Schirme, Gehstöcke usw., Peitschen;NULL;NULL;#WERT!
01.06.25;WA67;Zugerichtete Federn, Daunen, künstliche Blumen;NULL;NULL;#WERT!
01.06.25;WA68;Waren aus Steinen, Gips, Zement usw.;NULL;NULL;#WERT!
01.06.25;WA69;Keramische Waren;NULL;NULL;#WERT!
01.06.25;WA70;Glas und Glaswaren;NULL;NULL;#WERT!
01.06.25;WA71;Perlen, Edelsteine, Edelmetalle;NULL;NULL;#WERT!
01.06.25;WA72;Eisen und Stahl;NULL;NULL;#WERT!
01.06.25;WA73;Waren aus Eisen oder Stahl;NULL;NULL;#WERT!
01.06.25;WA74;Kupfer und Waren daraus;NULL;NULL;#WERT!
01.06.25;WA75;Nickel und Waren daraus;NULL;NULL;#WERT!
01.06.25;WA76;Aluminium und Waren daraus;NULL;NULL;#WERT!
01.06.25;WA78;Blei und Waren daraus;NULL;NULL;#WERT!
01.06.25;WA79;Zink und Waren daraus;NULL;NULL;#WERT!
01.06.25;WA80;Zinn und Waren daraus;NULL;NULL;#WERT!
01.06.25;WA81;Andere unedle Metalle, Cermets usw.;NULL;NULL;#WERT!
01.06.25;WA82;Werkzeuge, Schneidwaren, Essbestecke;NULL;NULL;#WERT!
01.06.25;WA83;Verschiedene Waren aus unedlen Metallen;NULL;NULL;#WERT!
01.06.25;WA84;Maschinen, Apparate, mechanische Geräte;NULL;NULL;#WERT!
01.06.25;WA85;Elektrotechnische Erzeugnisse;NULL;NULL;#WERT!
01.06.25;WA86;Schienenfahrzeuge;NULL;NULL;#WERT!
01.06.25;WA87;Kraftfahrzeuge, Landfahrzeuge;NULL;NULL;#WERT!
01.06.25;WA88;Luftfahrzeuge, Raumfahrzeuge;NULL;NULL;#WERT!
01.06.25;WA89;Wasserfahrzeuge;NULL;NULL;#WERT!
01.06.25;WA90;Optische, photografische usw. Erzeugnisse;NULL;NULL;#WERT!
01.06.25;WA91;Uhrmacherwaren;NULL;NULL;#WERT!
01.06.25;WA92;Musikinstrumente;NULL;NULL;#WERT!
01.06.25;WA93;Waffen und Munition;NULL;NULL;#WERT!
01.06.25;WA94;Möbel, Beleuchtungskörper usw.;NULL;NULL;#WERT!
01.06.25;WA95;Spielzeug, Spiele usw., Sportgeräte;NULL;NULL;#WERT!
01.06.25;WA96;Verschiedene Waren;NULL;NULL;#WERT!
01.06.25;WA97;Kunstgegenstände, Sammlungsstücke;NULL;NULL;#WERT!
01.06.25;WA98;Vollständige Fabrikationsanlagen;NULL;NULL;#WERT!
01.06.25;WA99;Zusammenstellungen verschiedener Waren;NULL;NULL;#WERT!
01.07.08;WA01;Lebende Tiere;78306;109497;-31191
01.07.08;WA02;Fleisch;523910;410612;113298
01.07.08;WA03;Fische, Krebs- und Weichtiere;66905;193491;-126586
01.07.08;WA04;Milch, Milcherzeugnisse, Eier, Honig;599509;528588;70921
01.07.08;WA05;Andere Waren tierischen Ursprungs;49467;68064;-18597
01.07.08;WA06;Pflanzen, Waren des Blumenhandels;38333;175661;-137328
01.07.08;WA07;Gemüse, Pflanzen für Ernährung;73510;350307;-276797
01.07.08;WA08;Geniessbare Früchte und Nüsse;103082;604400;-501318
01.07.08;WA09;Kaffee, Tee, Mate, Gewürze;128651;227130;-98479
01.07.08;WA10;Getreide;193010;130051;62959
01.07.08;WA11;Müllereierzeugnisse, Malz usw.;70511;40020;30491
01.07.08;WA12;Ölsamen usw., Heilpflanzen usw.;80640;299490;-218850
01.07.08;WA13;Schellack, Gummen, Harz, Pflanzensaft;48206;33173;15033
01.07.08;WA14;Flechtstoffe usw. pflanzlichen Ursprungs;892;2575;-1683
01.07.08;WA15;Tierische und pflanzliche Fette, Öle, Wachs;170505;289160;-118655
01.07.08;WA16;Zubereitungen von Fleisch, Fisch usw.;196143;146902;49241
01.07.08;WA17;Zucker und Zuckerwaren;101139;118004;-16865
01.07.08;WA18;Kakao und Zubereitungen aus Kakao;189709;180571;9138
01.07.08;WA19;Zubereitungen aus Getreide usw., Backwaren;297328;214048;83280
01.07.08;WA20;Zubereitungen von Gemüse, Früchten usw.;178007;303908;-125901
01.07.08;WA21;Verschiedene Lebensmittelzubereitungen;334240;215709;118531
01.07.08;WA22;Getränke, alkoholhaltige Flüssigkeiten, Essig;374435;455137;-80702
01.07.08;WA23;Rückstände der Lebensmittelindustrie, Futter;211764;229304;-17540
01.07.08;WA24;Tabak;339480;125899;213581
01.07.08;WA25;Salz, Schwefel, Steine, Erden usw.;203112;149340;53772
01.07.08;WA26;Erze, Schlacken, Aschen;26113;735848;-709735
01.07.08;WA27;Mineralische Brennstoffe usw.;2534598;11133668;-8599070
01.07.08;WA28;Anorganische chemische Erzeugnisse;719995;725006;-5011
01.07.08;WA29;Organische chemische Erzeugnisse;2173526;1916937;256589
01.07.08;WA30;Pharmazeutische Erzeugnisse;4006375;2853969;1152406
01.07.08;WA31;Düngemittel;265885;131809;134076
01.07.08;WA32;Gerb- und Farbstoffe, Farben, Lacke usw.;778229;335807;442422
01.07.08;WA33;Etherische Öle, Riech-, Schönheitsmittel;561421;346320;215101
01.07.08;WA34;Seifen, Waschmittel usw.;453175;234431;218744
01.07.08;WA35;Eiweissstoffe, Klebstoffe, Enzyme;176892;134614;42278
01.07.08;WA36;Sprengstoffe, pyrotechnische Artikel usw.;15997;15134;863
01.07.08;WA37;Photochemische Erzeugnisse;99972;78838;21134
01.07.08;WA38;Verschiedene Erzeugnisse der Chemischen Industrie;1336949;926359;410590
01.07.08;WA39;Kunststoffe und Waren daraus;4035058;2407576;1627482
01.07.08;WA40;Kautschuk und Waren daraus;875399;826281;49118
01.07.08;WA41;Häute, Felle, Leder;61260;58868;2392
01.07.08;WA42;Lederwaren, Sattlerwaren;129898;231687;-101789
01.07.08;WA43;Pelzfelle, künstliches Pelzwerk;16524;20840;-4316
01.07.08;WA44;Holz, Holzwaren, Holzkohle;615690;444737;170953
01.07.08;WA45;Kork, Korkwaren;4197;11612;-7415
01.07.08;WA46;Flechtwaren, Korbmacherwaren;3691;12700;-9009
01.07.08;WA47;Halbstoffe aus Holz usw., Papierabfall;99228;279738;-180510
01.07.08;WA48;Papier, Pappe und Waren daraus;1561722;1042310;519412
01.07.08;WA49;Bücher, Zeitungen, Bilddrucke usw.;419296;165072;254224
01.07.08;WA50;Seide;6753;7465;-712
01.07.08;WA51;Wolle, feine und grobe Tierhaare;75075;69605;5470
01.07.08;WA52;Baumwolle;86638;78581;8057
01.07.08;WA53;Andere pflanzliche Spinnstoffe, Papiergarn;2889;5857;-2968
01.07.08;WA54;Synthetisches oder künstliches Filament;180309;122985;57324
01.07.08;WA55;Synthetische oder künstliche Spinnfaser;143846;101027;42819
01.07.08;WA56;Watte, Filz, Vliesstoff usw., Tauwerk;168548;94184;74364
01.07.08;WA57;Teppiche, Fussbodenbelag aus Spinnstoff;44184;68957;-24773
01.07.08;WA58;Spezialgewebe, Spitzen, Tapisserien;42704;25715;16989
01.07.08;WA59;Getränkte, bestrichene usw. Gewebe;142249;103935;38314
01.07.08;WA60;Gewirke und Gestricke;66250;34912;31338
01.07.08;WA61;Bekleidung usw. aus Gewirken, Gestricken;464573;1018981;-554408
01.07.08;WA62;Andere Bekleidung, Bekleidungszubehör;618237;1106965;-488728
01.07.08;WA63;Andere Konfektion, Spinnstoffwaren usw.;138253;217896;-79643
01.07.08;WA64;Schuhe, Gamaschen, ähnliche Waren;281010;542154;-261144
01.07.08;WA65;Kopfbedeckungen und Teile davon;18167;29533;-11366
01.07.08;WA66;Schirme, Gehstöcke usw., Peitschen;9995;11800;-1805
01.07.08;WA67;Zugerichtete Federn, Daunen, künstliche Blumen;4261;14062;-9801
01.07.08;WA68;Waren aus Steinen, Gips, Zement usw.;289837;197390;92447
01.07.08;WA69;Keramische Waren;289420;176364;113056
01.07.08;WA70;Glas und Glaswaren;419424;319744;99680
01.07.08;WA71;Perlen, Edelsteine, Edelmetalle;755573;839194;-83621
01.07.08;WA72;Eisen und Stahl;2522450;2984676;-462226
01.07.08;WA73;Waren aus Eisen oder Stahl;2308764;1599477;709287
01.07.08;WA74;Kupfer und Waren daraus;928744;867409;61335
01.07.08;WA75;Nickel und Waren daraus;79239;208538;-129299
01.07.08;WA76;Aluminium und Waren daraus;1074370;1135208;-60838
01.07.08;WA78;Blei und Waren daraus;30333;21985;8348
01.07.08;WA79;Zink und Waren daraus;50162;82791;-32629
01.07.08;WA80;Zinn und Waren daraus;8206;28213;-20007
01.07.08;WA81;Andere unedle Metalle, Cermets usw.;79371;145577;-66206
01.07.08;WA82;Werkzeuge, Schneidwaren, Essbestecke;531782;340443;191339
01.07.08;WA83;Verschiedene Waren aus unedlen Metallen;541660;305707;235953
01.07.08;WA84;Maschinen, Apparate, mechanische Geräte;16373760;8930024;7443736
01.07.08;WA85;Elektrotechnische Erzeugnisse;8432136;7236902;1195234
01.07.08;WA86;Schienenfahrzeuge;267301;154294;113007
01.07.08;WA87;Kraftfahrzeuge, Landfahrzeuge;13847470;5506596;8340874
01.07.08;WA88;Luftfahrzeuge, Raumfahrzeuge;1490178;1401502;88676
01.07.08;WA89;Wasserfahrzeuge;485217;735294;-250077
01.07.08;WA90;Optische, photografische usw. Erzeugnisse;3336751;1721385;1615366
01.07.08;WA91;Uhrmacherwaren;93245;102953;-9708
01.07.08;WA92;Musikinstrumente;36239;32937;3302
01.07.08;WA93;Waffen und Munition;31822;12223;19599
01.07.08;WA94;Möbel, Beleuchtungskörper usw.;1027763;911628;116135
01.07.08;WA95;Spielzeug, Spiele usw., Sportgeräte;550488;583839;-33351
01.07.08;WA96;Verschiedene Waren;172635;105917;66718
01.07.08;WA97;Kunstgegenstände, Sammlungsstücke;47195;41391;5804
01.07.08;WA98;Vollständige Fabrikationsanlagen;479114;2337;476777
01.07.08;WA99;Zusammenstellungen verschiedener Waren;1370505;870572;499933
01.07.09;WA01;Lebende Tiere;81707;133038;-51331
01.07.09;WA02;Fleisch;539520;364780;174740
01.07.09;WA03;Fische, Krebs- und Weichtiere;79657;198087;-118430
01.07.09;WA04;Milch, Milcherzeugnisse, Eier, Honig;505841;383832;122009
01.07.09;WA05;Andere Waren tierischen Ursprungs;50724;52428;-1704
01.07.09;WA06;Pflanzen, Waren des Blumenhandels;33747;153933;-120186
01.07.09;WA07;Gemüse, Pflanzen für Ernährung;71393;295530;-224137
01.07.09;WA08;Geniessbare Früchte und Nüsse;96498;473111;-376613
01.07.09;WA09;Kaffee, Tee, Mate, Gewürze;128460;209514;-81054
01.07.09;WA10;Getreide;224289;129421;94868
01.07.09;WA11;Müllereierzeugnisse, Malz usw.;78335;37086;41249
01.07.09;WA12;Ölsamen usw., Heilpflanzen usw.;57361;256404;-199043
01.07.09;WA13;Schellack, Gummen, Harz, Pflanzensaft;37276;26421;10855
01.07.09;WA14;Flechtstoffe usw. pflanzlichen Ursprungs;655;1595;-940
01.07.09;WA15;Tierische und pflanzliche Fette, Öle, Wachs;119305;182816;-63511
01.07.09;WA16;Zubereitungen von Fleisch, Fisch usw.;200224;159598;40626
01.07.09;WA17;Zucker und Zuckerwaren;130570;119590;10980
01.07.09;WA18;Kakao und Zubereitungen aus Kakao;187234;237749;-50515
01.07.09;WA19;Zubereitungen aus Getreide usw., Backwaren;341534;208509;133025
01.07.09;WA20;Zubereitungen von Gemüse, Früchten usw.;185156;288570;-103414
01.07.09;WA21;Verschiedene Lebensmittelzubereitungen;344105;249874;94231
01.07.09;WA22;Getränke, alkoholhaltige Flüssigkeiten, Essig;380843;465001;-84158
01.07.09;WA23;Rückstände der Lebensmittelindustrie, Futter;210892;236538;-25646
01.07.09;WA24;Tabak;323300;160150;163150
01.07.09;WA25;Salz, Schwefel, Steine, Erden usw.;159435;118373;41062
01.07.09;WA26;Erze, Schlacken, Aschen;13882;286065;-272183
01.07.09;WA27;Mineralische Brennstoffe usw.;1505175;6265120;-4759945
01.07.09;WA28;Anorganische chemische Erzeugnisse;551329;411617;139712
01.07.09;WA29;Organische chemische Erzeugnisse;1556022;1586163;-30141
01.07.09;WA30;Pharmazeutische Erzeugnisse;4169612;2896889;1272723
01.07.09;WA31;Düngemittel;134798;79590;55208
01.07.09;WA32;Gerb- und Farbstoffe, Farben, Lacke usw.;685682;272026;413656
01.07.09;WA33;Etherische Öle, Riech-, Schönheitsmittel;582103;345281;236822
01.07.09;WA34;Seifen, Waschmittel usw.;425225;222736;202489
01.07.09;WA35;Eiweissstoffe, Klebstoffe, Enzyme;180748;121668;59080
01.07.09;WA36;Sprengstoffe, pyrotechnische Artikel usw.;14220;17666;-3446
01.07.09;WA37;Photochemische Erzeugnisse;102385;66707;35678
01.07.09;WA38;Verschiedene Erzeugnisse der Chemischen Industrie;1118978;750368;368610
01.07.09;WA39;Kunststoffe und Waren daraus;3420257;1883534;1536723
01.07.09;WA40;Kautschuk und Waren daraus;786842;693212;93630
01.07.09;WA41;Häute, Felle, Leder;54543;47760;6783
01.07.09;WA42;Lederwaren, Sattlerwaren;118928;202862;-83934
01.07.09;WA43;Pelzfelle, künstliches Pelzwerk;14460;13590;870
01.07.09;WA44;Holz, Holzwaren, Holzkohle;507244;387423;119821
01.07.09;WA45;Kork, Korkwaren;3286;10100;-6814
01.07.09;WA46;Flechtwaren, Korbmacherwaren;3380;9677;-6297
01.07.09;WA47;Halbstoffe aus Holz usw., Papierabfall;74339;183941;-109602
01.07.09;WA48;Papier, Pappe und Waren daraus;1447525;890123;557402
01.07.09;WA49;Bücher, Zeitungen, Bilddrucke usw.;346570;190284;156286
01.07.09;WA50;Seide;4563;4257;306
01.07.09;WA51;Wolle, feine und grobe Tierhaare;43410;42590;820
01.07.09;WA52;Baumwolle;67545;52229;15316
01.07.09;WA53;Andere pflanzliche Spinnstoffe, Papiergarn;2670;4532;-1862
01.07.09;WA54;Synthetisches oder künstliches Filament;155568;88562;67006
01.07.09;WA55;Synthetische oder künstliche Spinnfaser;137661;84091;53570
01.07.09;WA56;Watte, Filz, Vliesstoff usw., Tauwerk;150097;78624;71473
01.07.09;WA57;Teppiche, Fussbodenbelag aus Spinnstoff;37000;70886;-33886
01.07.09;WA58;Spezialgewebe, Spitzen, Tapisserien;39032;24380;14652
01.07.09;WA59;Getränkte, bestrichene usw. Gewebe;132030;80220;51810
01.07.09;WA60;Gewirke und Gestricke;60236;27855;32381
01.07.09;WA61;Bekleidung usw. aus Gewirken, Gestricken;492648;1059778;-567130
01.07.09;WA62;Andere Bekleidung, Bekleidungszubehör;584897;1104309;-519412
01.07.09;WA63;Andere Konfektion, Spinnstoffwaren usw.;145519;193246;-47727
01.07.09;WA64;Schuhe, Gamaschen, ähnliche Waren;275775;540485;-264710
01.07.09;WA65;Kopfbedeckungen und Teile davon;17149;29947;-12798
01.07.09;WA66;Schirme, Gehstöcke usw., Peitschen;18016;7972;10044
01.07.09;WA67;Zugerichtete Federn, Daunen, künstliche Blumen;4533;11591;-7058
01.07.09;WA68;Waren aus Steinen, Gips, Zement usw.;244262;162642;81620
01.07.09;WA69;Keramische Waren;211311;149440;61871
01.07.09;WA70;Glas und Glaswaren;392775;285668;107107
01.07.09;WA71;Perlen, Edelsteine, Edelmetalle;674460;861697;-187237
01.07.09;WA72;Eisen und Stahl;1366855;1138325;228530
01.07.09;WA73;Waren aus Eisen oder Stahl;1713138;1023613;689525
01.07.09;WA74;Kupfer und Waren daraus;624317;428844;195473
01.07.09;WA75;Nickel und Waren daraus;46077;66911;-20834
01.07.09;WA76;Aluminium und Waren daraus;858427;657304;201123
01.07.09;WA78;Blei und Waren daraus;22838;12870;9968
01.07.09;WA79;Zink und Waren daraus;42261;53763;-11502
01.07.09;WA80;Zinn und Waren daraus;6648;13266;-6618
01.07.09;WA81;Andere unedle Metalle, Cermets usw.;55258;72309;-17051
01.07.09;WA82;Werkzeuge, Schneidwaren, Essbestecke;417368;244696;172672
01.07.09;WA83;Verschiedene Waren aus unedlen Metallen;468672;260603;208069
01.07.09;WA84;Maschinen, Apparate, mechanische Geräte;13156171;6781781;6374390
01.07.09;WA85;Elektrotechnische Erzeugnisse;6914306;5913869;1000437
01.07.09;WA86;Schienenfahrzeuge;301693;122298;179395
01.07.09;WA87;Kraftfahrzeuge, Landfahrzeuge;10220679;4651987;5568692
01.07.09;WA88;Luftfahrzeuge, Raumfahrzeuge;1604569;1001212;603357
01.07.09;WA89;Wasserfahrzeuge;136295;349897;-213602
01.07.09;WA90;Optische, photografische usw. Erzeugnisse;3095089;1589230;1505859
01.07.09;WA91;Uhrmacherwaren;90886;103206;-12320
01.07.09;WA92;Musikinstrumente;32997;29874;3123
01.07.09;WA93;Waffen und Munition;38665;13599;25066
01.07.09;WA94;Möbel, Beleuchtungskörper usw.;896679;826039;70640
01.07.09;WA95;Spielzeug, Spiele usw., Sportgeräte;377478;649310;-271832
01.07.09;WA96;Verschiedene Waren;161684;98657;63027
01.07.09;WA97;Kunstgegenstände, Sammlungsstücke;30282;26518;3764
01.07.09;WA98;Vollständige Fabrikationsanlagen;373422;1488;371934
01.07.09;WA99;Zusammenstellungen verschiedener Waren;1247918;912876;335042
01.07.10;WA01;Lebende Tiere;90784;126150;-35366
01.07.10;WA02;Fleisch;510781;367890;142891
01.07.10;WA03;Fische, Krebs- und Weichtiere;76314;195748;-119434
01.07.10;WA04;Milch, Milcherzeugnisse, Eier, Honig;598170;465440;132730
01.07.10;WA05;Andere Waren tierischen Ursprungs;48647;58377;-9730
01.07.10;WA06;Pflanzen, Waren des Blumenhandels;38551;168950;-130399
01.07.10;WA07;Gemüse, Pflanzen für Ernährung;69995;355900;-285905
01.07.10;WA08;Geniessbare Früchte und Nüsse;115119;581818;-466699
01.07.10;WA09;Kaffee, Tee, Mate, Gewürze;147301;280888;-133587
01.07.10;WA10;Getreide;139885;116220;23665
01.07.10;WA11;Müllereierzeugnisse, Malz usw.;79242;30651;48591
01.07.10;WA12;Ölsamen usw., Heilpflanzen usw.;72334;251330;-178996
01.07.10;WA13;Schellack, Gummen, Harz, Pflanzensaft;40833;31895;8938
01.07.10;WA14;Flechtstoffe usw. pflanzlichen Ursprungs;673;2545;-1872
01.07.10;WA15;Tierische und pflanzliche Fette, Öle, Wachs;139563;208297;-68734
01.07.10;WA16;Zubereitungen von Fleisch, Fisch usw.;194581;159251;35330
01.07.10;WA17;Zucker und Zuckerwaren;122765;116346;6419
01.07.10;WA18;Kakao und Zubereitungen aus Kakao;232395;256043;-23648
01.07.10;WA19;Zubereitungen aus Getreide usw., Backwaren;341199;207040;134159
01.07.10;WA20;Zubereitungen von Gemüse, Früchten usw.;156763;308006;-151243
01.07.10;WA21;Verschiedene Lebensmittelzubereitungen;340410;247535;92875
01.07.10;WA22;Getränke, alkoholhaltige Flüssigkeiten, Essig;435677;513933;-78256
01.07.10;WA23;Rückstände der Lebensmittelindustrie, Futter;202245;213922;-11677
01.07.10;WA24;Tabak;314494;137898;176596
01.07.10;WA25;Salz, Schwefel, Steine, Erden usw.;177360;174163;3197
01.07.10;WA26;Erze, Schlacken, Aschen;29774;876020;-846246
01.07.10;WA27;Mineralische Brennstoffe usw.;1572396;7562637;-5990241
01.07.10;WA28;Anorganische chemische Erzeugnisse;651528;567763;83765
01.07.10;WA29;Organische chemische Erzeugnisse;1956529;1731858;224671
01.07.10;WA30;Pharmazeutische Erzeugnisse;4093626;2899873;1193753
01.07.10;WA31;Düngemittel;169772;85394;84378
01.07.10;WA32;Gerb- und Farbstoffe, Farben, Lacke usw.;760385;388441;371944
01.07.10;WA33;Etherische Öle, Riech-, Schönheitsmittel;604273;367771;236502
01.07.10;WA34;Seifen, Waschmittel usw.;457098;225860;231238
01.07.10;WA35;Eiweissstoffe, Klebstoffe, Enzyme;204684;134421;70263
01.07.10;WA36;Sprengstoffe, pyrotechnische Artikel usw.;14585;17512;-2927
01.07.10;WA37;Photochemische Erzeugnisse;84671;60129;24542
01.07.10;WA38;Verschiedene Erzeugnisse der Chemischen Industrie;1325668;898530;427138
01.07.10;WA39;Kunststoffe und Waren daraus;4000285;2475708;1524577
01.07.10;WA40;Kautschuk und Waren daraus;975809;958056;17753
01.07.10;WA41;Häute, Felle, Leder;63459;67153;-3694
01.07.10;WA42;Lederwaren, Sattlerwaren;119109;246165;-127056
01.07.10;WA43;Pelzfelle, künstliches Pelzwerk;16391;16136;255
01.07.10;WA44;Holz, Holzwaren, Holzkohle;577972;499885;78087
01.07.10;WA45;Kork, Korkwaren;2673;11597;-8924
01.07.10;WA46;Flechtwaren, Korbmacherwaren;3593;12576;-8983
01.07.10;WA47;Halbstoffe aus Holz usw., Papierabfall;96588;350604;-254016
01.07.10;WA48;Papier, Pappe und Waren daraus;1551533;977904;573629
01.07.10;WA49;Bücher, Zeitungen, Bilddrucke usw.;346700;165190;181510
01.07.10;WA50;Seide;5692;5621;71
01.07.10;WA51;Wolle, feine und grobe Tierhaare;58495;64769;-6274
01.07.10;WA52;Baumwolle;73299;70279;3020
01.07.10;WA53;Andere pflanzliche Spinnstoffe, Papiergarn;2303;4850;-2547
01.07.10;WA54;Synthetisches oder künstliches Filament;151531;123035;28496
01.07.10;WA55;Synthetische oder künstliche Spinnfaser;158496;126460;32036
01.07.10;WA56;Watte, Filz, Vliesstoff usw., Tauwerk;170834;103138;67696
01.07.10;WA57;Teppiche, Fussbodenbelag aus Spinnstoff;38641;76164;-37523
01.07.10;WA58;Spezialgewebe, Spitzen, Tapisserien;40104;26930;13174
01.07.10;WA59;Getränkte, bestrichene usw. Gewebe;152056;79596;72460
01.07.10;WA60;Gewirke und Gestricke;69405;34701;34704
01.07.10;WA61;Bekleidung usw. aus Gewirken, Gestricken;513817;1147969;-634152
01.07.10;WA62;Andere Bekleidung, Bekleidungszubehör;551868;1131133;-579265
01.07.10;WA63;Andere Konfektion, Spinnstoffwaren usw.;141437;243853;-102416
01.07.10;WA64;Schuhe, Gamaschen, ähnliche Waren;276862;614600;-337738
01.07.10;WA65;Kopfbedeckungen und Teile davon;20005;39286;-19281
01.07.10;WA66;Schirme, Gehstöcke usw., Peitschen;5602;9772;-4170
01.07.10;WA67;Zugerichtete Federn, Daunen, künstliche Blumen;5505;16295;-10790
01.07.10;WA68;Waren aus Steinen, Gips, Zement usw.;292385;204623;87762
01.07.10;WA69;Keramische Waren;235378;177537;57841
01.07.10;WA70;Glas und Glaswaren;414971;332752;82219
01.07.10;WA71;Perlen, Edelsteine, Edelmetalle;978751;1015410;-36659
01.07.10;WA72;Eisen und Stahl;1866091;2087621;-221530
01.07.10;WA73;Waren aus Eisen oder Stahl;1868372;1286873;581499
01.07.10;WA74;Kupfer und Waren daraus;894057;792426;101631
01.07.10;WA75;Nickel und Waren daraus;64528;150059;-85531
01.07.10;WA76;Aluminium und Waren daraus;887981;1048087;-160106
01.07.10;WA78;Blei und Waren daraus;33781;16907;16874
01.07.10;WA79;Zink und Waren daraus;52209;97291;-45082
01.07.10;WA80;Zinn und Waren daraus;9120;27161;-18041
01.07.10;WA81;Andere unedle Metalle, Cermets usw.;86422;107408;-20986
01.07.10;WA82;Werkzeuge, Schneidwaren, Essbestecke;469940;307657;162283
01.07.10;WA83;Verschiedene Waren aus unedlen Metallen;511743;307596;204147
01.07.10;WA84;Maschinen, Apparate, mechanische Geräte;14841243;8226002;6615241
01.07.10;WA85;Elektrotechnische Erzeugnisse;8407303;7870378;536925
01.07.10;WA86;Schienenfahrzeuge;306142;152989;153153
01.07.10;WA87;Kraftfahrzeuge, Landfahrzeuge;12800209;4981627;7818582
01.07.10;WA88;Luftfahrzeuge, Raumfahrzeuge;2152375;2931606;-779231
01.07.10;WA89;Wasserfahrzeuge;575069;684117;-109048
01.07.10;WA90;Optische, photografische usw. Erzeugnisse;3606563;1963243;1643320
01.07.10;WA91;Uhrmacherwaren;142061;142001;60
01.07.10;WA92;Musikinstrumente;36688;47833;-11145
01.07.10;WA93;Waffen und Munition;32705;14987;17718
01.07.10;WA94;Möbel, Beleuchtungskörper usw.;977026;948790;28236
01.07.10;WA95;Spielzeug, Spiele usw., Sportgeräte;321091;362097;-41006
01.07.10;WA96;Verschiedene Waren;168476;115028;53448
01.07.10;WA97;Kunstgegenstände, Sammlungsstücke;41970;34342;7628
01.07.10;WA98;Vollständige Fabrikationsanlagen;390180;2186;387994
01.07.10;WA99;Zusammenstellungen verschiedener Waren;1084378;855221;229157
01.07.11;WA01;Lebende Tiere;95107;129068;-33961
01.07.11;WA02;Fleisch;607423;437732;169691
01.07.11;WA03;Fische, Krebs- und Weichtiere;95631;216041;-120410
01.07.11;WA04;Milch, Milcherzeugnisse, Eier, Honig;598429;468545;129884
01.07.11;WA05;Andere Waren tierischen Ursprungs;57827;69450;-11623
01.07.11;WA06;Pflanzen, Waren des Blumenhandels;37446;182021;-144575
01.07.11;WA07;Gemüse, Pflanzen für Ernährung;66382;278654;-212272
01.07.11;WA08;Geniessbare Früchte und Nüsse;106436;567659;-461223
01.07.11;WA09;Kaffee, Tee, Mate, Gewürze;173065;359843;-186778
01.07.11;WA10;Getreide;134106;150922;-16816
01.07.11;WA11;Müllereierzeugnisse, Malz usw.;71056;43664;27392
01.07.11;WA12;Ölsamen usw., Heilpflanzen usw.;69122;262536;-193414
01.07.11;WA13;Schellack, Gummen, Harz, Pflanzensaft;39531;35286;4245
01.07.11;WA14;Flechtstoffe usw. pflanzlichen Ursprungs;863;2140;-1277
01.07.11;WA15;Tierische und pflanzliche Fette, Öle, Wachs;198425;340123;-141698
01.07.11;WA16;Zubereitungen von Fleisch, Fisch usw.;197440;157773;39667
01.07.11;WA17;Zucker und Zuckerwaren;117244;122579;-5335
01.07.11;WA18;Kakao und Zubereitungen aus Kakao;210116;235358;-25242
01.07.11;WA19;Zubereitungen aus Getreide usw., Backwaren;344659;222762;121897
01.07.11;WA20;Zubereitungen von Gemüse, Früchten usw.;160050;328138;-168088
01.07.11;WA21;Verschiedene Lebensmittelzubereitungen;336731;166776;169955
01.07.11;WA22;Getränke, alkoholhaltige Flüssigkeiten, Essig;397629;547509;-149880
01.07.11;WA23;Rückstände der Lebensmittelindustrie, Futter;235243;271379;-36136
01.07.11;WA24;Tabak;335231;158746;176485
01.07.11;WA25;Salz, Schwefel, Steine, Erden usw.;187679;172543;15136
01.07.11;WA26;Erze, Schlacken, Aschen;29141;812227;-783086
01.07.11;WA27;Mineralische Brennstoffe usw.;2208001;11149155;-8941154
01.07.11;WA28;Anorganische chemische Erzeugnisse;655783;627913;27870
01.07.11;WA29;Organische chemische Erzeugnisse;1848596;2194306;-345710
01.07.11;WA30;Pharmazeutische Erzeugnisse;3881055;2860940;1020115
01.07.11;WA31;Düngemittel;213504;122834;90670
01.07.11;WA32;Gerb- und Farbstoffe, Farben, Lacke usw.;803807;412903;390904
01.07.11;WA33;Etherische Öle, Riech-, Schönheitsmittel;653974;378330;275644
01.07.11;WA34;Seifen, Waschmittel usw.;475611;233526;242085
01.07.11;WA35;Eiweissstoffe, Klebstoffe, Enzyme;208572;151510;57062
01.07.11;WA36;Sprengstoffe, pyrotechnische Artikel usw.;14599;14703;-104
01.07.11;WA37;Photochemische Erzeugnisse;89256;64386;24870
01.07.11;WA38;Verschiedene Erzeugnisse der Chemischen Industrie;1452000;982665;469335
01.07.11;WA39;Kunststoffe und Waren daraus;4092790;2618869;1473921
01.07.11;WA40;Kautschuk und Waren daraus;1132829;1208692;-75863
01.07.11;WA41;Häute, Felle, Leder;74010;71861;2149
01.07.11;WA42;Lederwaren, Sattlerwaren;139119;258191;-119072
01.07.11;WA43;Pelzfelle, künstliches Pelzwerk;21322;21935;-613
01.07.11;WA44;Holz, Holzwaren, Holzkohle;559564;512761;46803
01.07.11;WA45;Kork, Korkwaren;3147;10915;-7768
01.07.11;WA46;Flechtwaren, Korbmacherwaren;3494;10130;-6636
01.07.11;WA47;Halbstoffe aus Holz usw., Papierabfall;103434;318519;-215085
01.07.11;WA48;Papier, Pappe und Waren daraus;1542312;968980;573332
01.07.11;WA49;Bücher, Zeitungen, Bilddrucke usw.;325953;152744;173209
01.07.11;WA50;Seide;5043;5763;-720
01.07.11;WA51;Wolle, feine und grobe Tierhaare;62330;73716;-11386
01.07.11;WA52;Baumwolle;82454;91937;-9483
01.07.11;WA53;Andere pflanzliche Spinnstoffe, Papiergarn;2775;5735;-2960
01.07.11;WA54;Synthetisches oder künstliches Filament;156358;117014;39344
01.07.11;WA55;Synthetische oder künstliche Spinnfaser;149442;133736;15706
01.07.11;WA56;Watte, Filz, Vliesstoff usw., Tauwerk;178680;108318;70362
01.07.11;WA57;Teppiche, Fussbodenbelag aus Spinnstoff;41512;78749;-37237
01.07.11;WA58;Spezialgewebe, Spitzen, Tapisserien;40881;27972;12909
01.07.11;WA59;Getränkte, bestrichene usw. Gewebe;162792;96181;66611
01.07.11;WA60;Gewirke und Gestricke;71499;37694;33805
01.07.11;WA61;Bekleidung usw. aus Gewirken, Gestricken;552514;1262126;-709612
01.07.11;WA62;Andere Bekleidung, Bekleidungszubehör;610449;1267661;-657212
01.07.11;WA63;Andere Konfektion, Spinnstoffwaren usw.;168653;298520;-129867
01.07.11;WA64;Schuhe, Gamaschen, ähnliche Waren;330905;666395;-335490
01.07.11;WA65;Kopfbedeckungen und Teile davon;24646;38797;-14151
01.07.11;WA66;Schirme, Gehstöcke usw., Peitschen;5864;10521;-4657
01.07.11;WA67;Zugerichtete Federn, Daunen, künstliche Blumen;6745;14494;-7749
01.07.11;WA68;Waren aus Steinen, Gips, Zement usw.;314605;225198;89407
01.07.11;WA69;Keramische Waren;245534;182651;62883
01.07.11;WA70;Glas und Glaswaren;428449;333682;94767
01.07.11;WA71;Perlen, Edelsteine, Edelmetalle;1168044;1518495;-350451
01.07.11;WA72;Eisen und Stahl;2059012;2426100;-367088
01.07.11;WA73;Waren aus Eisen oder Stahl;2046875;1474306;572569
01.07.11;WA74;Kupfer und Waren daraus;1001880;1065111;-63231
01.07.11;WA75;Nickel und Waren daraus;86290;194852;-108562
01.07.11;WA76;Aluminium und Waren daraus;1091786;1219174;-127388
01.07.11;WA78;Blei und Waren daraus;39027;32927;6100
01.07.11;WA79;Zink und Waren daraus;57468;107522;-50054
01.07.11;WA80;Zinn und Waren daraus;11337;48933;-37596
01.07.11;WA81;Andere unedle Metalle, Cermets usw.;101850;124607;-22757
01.07.11;WA82;Werkzeuge, Schneidwaren, Essbestecke;530289;339159;191130
01.07.11;WA83;Verschiedene Waren aus unedlen Metallen;526895;311025;215870
01.07.11;WA84;Maschinen, Apparate, mechanische Geräte;15762439;8988230;6774209
01.07.11;WA85;Elektrotechnische Erzeugnisse;8634179;7795705;838474
01.07.11;WA86;Schienenfahrzeuge;250324;136954;113370
01.07.11;WA87;Kraftfahrzeuge, Landfahrzeuge;14460267;5736285;8723982
01.07.11;WA88;Luftfahrzeuge, Raumfahrzeuge;1464080;890223;573857
01.07.11;WA89;Wasserfahrzeuge;280844;775749;-494905
01.07.11;WA90;Optische, photografische usw. Erzeugnisse;3778184;2091599;1686585
01.07.11;WA91;Uhrmacherwaren;137192;149632;-12440
01.07.11;WA92;Musikinstrumente;37486;32482;5004
01.07.11;WA93;Waffen und Munition;39061;18540;20521
01.07.11;WA94;Möbel, Beleuchtungskörper usw.;1072010;990292;81718
01.07.11;WA95;Spielzeug, Spiele usw., Sportgeräte;294989;331911;-36922
01.07.11;WA96;Verschiedene Waren;160456;119811;40645
01.07.11;WA97;Kunstgegenstände, Sammlungsstücke;47206;29953;17253
01.07.11;WA98;Vollständige Fabrikationsanlagen;208056;1222;206834
01.07.11;WA99;Zusammenstellungen verschiedener Waren;1177415;902993;274422
01.07.12;WA01;Lebende Tiere;115174;135050;-19876
01.07.12;WA02;Fleisch;639419;449584;189835
01.07.12;WA03;Fische, Krebs- und Weichtiere;80547;234937;-154390
01.07.12;WA04;Milch, Milcherzeugnisse, Eier, Honig;675639;511424;164215
01.07.12;WA05;Andere Waren tierischen Ursprungs;64172;84171;-19999
01.07.12;WA06;Pflanzen, Waren des Blumenhandels;43891;187780;-143889
01.07.12;WA07;Gemüse, Pflanzen für Ernährung;71139;342392;-271253
01.07.12;WA08;Geniessbare Früchte und Nüsse;102689;646201;-543512
01.07.12;WA09;Kaffee, Tee, Mate, Gewürze;194123;378112;-183989
01.07.12;WA10;Getreide;129072;151712;-22640
01.07.12;WA11;Müllereierzeugnisse, Malz usw.;100062;42506;57556
01.07.12;WA12;Ölsamen usw., Heilpflanzen usw.;76298;341843;-265545
01.07.12;WA13;Schellack, Gummen, Harz, Pflanzensaft;41556;32475;9081
01.07.12;WA14;Flechtstoffe usw. pflanzlichen Ursprungs;772;2590;-1818
01.07.12;WA15;Tierische und pflanzliche Fette, Öle, Wachs;263066;312698;-49632
01.07.12;WA16;Zubereitungen von Fleisch, Fisch usw.;217488;192080;25408
01.07.12;WA17;Zucker und Zuckerwaren;163325;155949;7376
01.07.12;WA18;Kakao und Zubereitungen aus Kakao;267842;245050;22792
01.07.12;WA19;Zubereitungen aus Getreide usw., Backwaren;368742;232785;135957
01.07.12;WA20;Zubereitungen von Gemüse, Früchten usw.;184895;341679;-156784
01.07.12;WA21;Verschiedene Lebensmittelzubereitungen;402932;213483;189449
01.07.12;WA22;Getränke, alkoholhaltige Flüssigkeiten, Essig;478203;586869;-108666
01.07.12;WA23;Rückstände der Lebensmittelindustrie, Futter;294790;310175;-15385
01.07.12;WA24;Tabak;341467;175612;165855
01.07.12;WA25;Salz, Schwefel, Steine, Erden usw.;180724;165567;15157
01.07.12;WA26;Erze, Schlacken, Aschen;43949;900686;-856737
01.07.12;WA27;Mineralische Brennstoffe usw.;2199547;10009610;-7810063
01.07.12;WA28;Anorganische chemische Erzeugnisse;693318;630168;63150
01.07.12;WA29;Organische chemische Erzeugnisse;2047578;2077360;-29782
01.07.12;WA30;Pharmazeutische Erzeugnisse;4692303;2908262;1784041
01.07.12;WA31;Düngemittel;207938;115408;92530
01.07.12;WA32;Gerb- und Farbstoffe, Farben, Lacke usw.;871218;445259;425959
01.07.12;WA33;Etherische Öle, Riech-, Schönheitsmittel;718277;421479;296798
01.07.12;WA34;Seifen, Waschmittel usw.;523509;270759;252750
01.07.12;WA35;Eiweissstoffe, Klebstoffe, Enzyme;237084;163372;73712
01.07.12;WA36;Sprengstoffe, pyrotechnische Artikel usw.;14586;20443;-5857
01.07.12;WA37;Photochemische Erzeugnisse;94078;66498;27580
01.07.12;WA38;Verschiedene Erzeugnisse der Chemischen Industrie;1489175;1012617;476558
01.07.12;WA39;Kunststoffe und Waren daraus;4301250;2747551;1553699
01.07.12;WA40;Kautschuk und Waren daraus;1160666;1181094;-20428
01.07.12;WA41;Häute, Felle, Leder;83827;67006;16821
01.07.12;WA42;Lederwaren, Sattlerwaren;147917;275611;-127694
01.07.12;WA43;Pelzfelle, künstliches Pelzwerk;22989;22470;519
01.07.12;WA44;Holz, Holzwaren, Holzkohle;574001;557106;16895
01.07.12;WA45;Kork, Korkwaren;2511;10765;-8254
01.07.12;WA46;Flechtwaren, Korbmacherwaren;3139;10397;-7258
01.07.12;WA47;Halbstoffe aus Holz usw., Papierabfall;96142;285902;-189760
01.07.12;WA48;Papier, Pappe und Waren daraus;1354428;952648;401780
01.07.12;WA49;Bücher, Zeitungen, Bilddrucke usw.;323662;157139;166523
01.07.12;WA50;Seide;6048;5865;183
01.07.12;WA51;Wolle, feine und grobe Tierhaare;47359;56100;-8741
01.07.12;WA52;Baumwolle;73522;79936;-6414
01.07.12;WA53;Andere pflanzliche Spinnstoffe, Papiergarn;3005;5777;-2772
01.07.12;WA54;Synthetisches oder künstliches Filament;149293;115483;33810
01.07.12;WA55;Synthetische oder künstliche Spinnfaser;151726;134897;16829
01.07.12;WA56;Watte, Filz, Vliesstoff usw., Tauwerk;179904;102968;76936
01.07.12;WA57;Teppiche, Fussbodenbelag aus Spinnstoff;40825;82214;-41389
01.07.12;WA58;Spezialgewebe, Spitzen, Tapisserien;40189;28440;11749
01.07.12;WA59;Getränkte, bestrichene usw. Gewebe;167215;95818;71397
01.07.12;WA60;Gewirke und Gestricke;59675;39763;19912
01.07.12;WA61;Bekleidung usw. aus Gewirken, Gestricken;575256;1251091;-675835
01.07.12;WA62;Andere Bekleidung, Bekleidungszubehör;621793;1260680;-638887
01.07.12;WA63;Andere Konfektion, Spinnstoffwaren usw.;177946;271787;-93841
01.07.12;WA64;Schuhe, Gamaschen, ähnliche Waren;323263;732135;-408872
01.07.12;WA65;Kopfbedeckungen und Teile davon;22863;36278;-13415
01.07.12;WA66;Schirme, Gehstöcke usw., Peitschen;6133;11144;-5011
01.07.12;WA67;Zugerichtete Federn, Daunen, künstliche Blumen;7958;16915;-8957
01.07.12;WA68;Waren aus Steinen, Gips, Zement usw.;318226;236776;81450
01.07.12;WA69;Keramische Waren;240067;196852;43215
01.07.12;WA70;Glas und Glaswaren;425026;328118;96908
01.07.12;WA71;Perlen, Edelsteine, Edelmetalle;1147439;1479866;-332427
01.07.12;WA72;Eisen und Stahl;1982164;2155957;-173793
01.07.12;WA73;Waren aus Eisen oder Stahl;2118751;1489563;629188
01.07.12;WA74;Kupfer und Waren daraus;991329;996702;-5373
01.07.12;WA75;Nickel und Waren daraus;93827;142118;-48291
01.07.12;WA76;Aluminium und Waren daraus;1131613;1214803;-83190
01.07.12;WA78;Blei und Waren daraus;31445;25396;6049
01.07.12;WA79;Zink und Waren daraus;54697;96361;-41664
01.07.12;WA80;Zinn und Waren daraus;9406;30789;-21383
01.07.12;WA81;Andere unedle Metalle, Cermets usw.;119841;146515;-26674
01.07.12;WA82;Werkzeuge, Schneidwaren, Essbestecke;585970;367618;218352
01.07.12;WA83;Verschiedene Waren aus unedlen Metallen;530677;330819;199858
01.07.12;WA84;Maschinen, Apparate, mechanische Geräte;16625334;9006856;7618478
01.07.12;WA85;Elektrotechnische Erzeugnisse;9218730;7848419;1370311
01.07.12;WA86;Schienenfahrzeuge;315408;163763;151645
01.07.12;WA87;Kraftfahrzeuge, Landfahrzeuge;16445938;5920174;10525764
01.07.12;WA88;Luftfahrzeuge, Raumfahrzeuge;2376641;2116149;260492
01.07.12;WA89;Wasserfahrzeuge;217152;112861;104291
01.07.12;WA90;Optische, photografische usw. Erzeugnisse;4124669;2301875;1822794
01.07.12;WA91;Uhrmacherwaren;148528;195977;-47449
01.07.12;WA92;Musikinstrumente;37551;37496;55
01.07.12;WA93;Waffen und Munition;43267;19547;23720
01.07.12;WA94;Möbel, Beleuchtungskörper usw.;1098576;1060567;38009
01.07.12;WA95;Spielzeug, Spiele usw., Sportgeräte;300985;377759;-76774
01.07.12;WA96;Verschiedene Waren;286240;210871;75369
01.07.12;WA97;Kunstgegenstände, Sammlungsstücke;52087;37172;14915
01.07.12;WA98;Vollständige Fabrikationsanlagen;418290;5354;412936
01.07.12;WA99;Zusammenstellungen verschiedener Waren;1553406;871423;681983
01.07.13;WA01;Lebende Tiere;127225;148242;-21017
01.07.13;WA02;Fleisch;646775;473925;172850
01.07.13;WA03;Fische, Krebs- und Weichtiere;98973;243962;-144989
01.07.13;WA04;Milch, Milcherzeugnisse, Eier, Honig;787725;517132;270593
01.07.13;WA05;Andere Waren tierischen Ursprungs;73757;75770;-2013
01.07.13;WA06;Pflanzen, Waren des Blumenhandels;43832;146919;-103087
01.07.13;WA07;Gemüse, Pflanzen für Ernährung;88584;399454;-310870
01.07.13;WA08;Geniessbare Früchte und Nüsse;127797;707651;-579854
01.07.13;WA09;Kaffee, Tee, Mate, Gewürze;180365;308540;-128175
01.07.13;WA10;Getreide;240077;163460;76617
01.07.13;WA11;Müllereierzeugnisse, Malz usw.;100277;46448;53829
01.07.13;WA12;Ölsamen usw., Heilpflanzen usw.;80526;407106;-326580
01.07.13;WA13;Schellack, Gummen, Harz, Pflanzensaft;43894;41976;1918
01.07.13;WA14;Flechtstoffe usw. pflanzlichen Ursprungs;460;2683;-2223
01.07.13;WA15;Tierische und pflanzliche Fette, Öle, Wachs;269066;342531;-73465
01.07.13;WA16;Zubereitungen von Fleisch, Fisch usw.;244645;192490;52155
01.07.13;WA17;Zucker und Zuckerwaren;158977;155393;3584
01.07.13;WA18;Kakao und Zubereitungen aus Kakao;288877;241660;47217
01.07.13;WA19;Zubereitungen aus Getreide usw., Backwaren;411050;272684;138366
01.07.13;WA20;Zubereitungen von Gemüse, Früchten usw.;203838;362596;-158758
01.07.13;WA21;Verschiedene Lebensmittelzubereitungen;420106;232962;187144
01.07.13;WA22;Getränke, alkoholhaltige Flüssigkeiten, Essig;487436;590084;-102648
01.07.13;WA23;Rückstände der Lebensmittelindustrie, Futter;286105;293304;-7199
01.07.13;WA24;Tabak;303168;158798;144370
01.07.13;WA25;Salz, Schwefel, Steine, Erden usw.;180843;154651;26192
01.07.13;WA26;Erze, Schlacken, Aschen;23029;687735;-664706
01.07.13;WA27;Mineralische Brennstoffe usw.;2125604;10484282;-8358678
01.07.13;WA28;Anorganische chemische Erzeugnisse;638847;591222;47625
01.07.13;WA29;Organische chemische Erzeugnisse;2160695;2241980;-81285
01.07.13;WA30;Pharmazeutische Erzeugnisse;4838202;3193310;1644892
01.07.13;WA31;Düngemittel;185872;95602;90270
01.07.13;WA32;Gerb- und Farbstoffe, Farben, Lacke usw.;912117;491457;420660
01.07.13;WA33;Etherische Öle, Riech-, Schönheitsmittel;733204;462690;270514
01.07.13;WA34;Seifen, Waschmittel usw.;562110;283141;278969
01.07.13;WA35;Eiweissstoffe, Klebstoffe, Enzyme;253399;162326;91073
01.07.13;WA36;Sprengstoffe, pyrotechnische Artikel usw.;18056;23168;-5112
01.07.13;WA37;Photochemische Erzeugnisse;92028;62700;29328
01.07.13;WA38;Verschiedene Erzeugnisse der Chemischen Industrie;1570387;964403;605984
01.07.13;WA39;Kunststoffe und Waren daraus;4522396;2847679;1674717
01.07.13;WA40;Kautschuk und Waren daraus;1166747;1151414;15333
01.07.13;WA41;Häute, Felle, Leder;84752;77424;7328
01.07.13;WA42;Lederwaren, Sattlerwaren;145383;299584;-154201
01.07.13;WA43;Pelzfelle, künstliches Pelzwerk;19244;18657;587
01.07.13;WA44;Holz, Holzwaren, Holzkohle;587695;558109;29586
01.07.13;WA45;Kork, Korkwaren;2198;6419;-4221
01.07.13;WA46;Flechtwaren, Korbmacherwaren;3429;9432;-6003
01.07.13;WA47;Halbstoffe aus Holz usw., Papierabfall;94811;287855;-193044
01.07.13;WA48;Papier, Pappe und Waren daraus;1427682;971474;456208
01.07.13;WA49;Bücher, Zeitungen, Bilddrucke usw.;327054;134787;192267
01.07.13;WA50;Seide;4680;5514;-834
01.07.13;WA51;Wolle, feine und grobe Tierhaare;46343;57564;-11221
01.07.13;WA52;Baumwolle;74803;76781;-1978
01.07.13;WA53;Andere pflanzliche Spinnstoffe, Papiergarn;2501;4854;-2353
01.07.13;WA54;Synthetisches oder künstliches Filament;151545;114812;36733
01.07.13;WA55;Synthetische oder künstliche Spinnfaser;165333;134450;30883
01.07.13;WA56;Watte, Filz, Vliesstoff usw., Tauwerk;183674;100961;82713
01.07.13;WA57;Teppiche, Fussbodenbelag aus Spinnstoff;42278;76112;-33834
01.07.13;WA58;Spezialgewebe, Spitzen, Tapisserien;40450;24342;16108
01.07.13;WA59;Getränkte, bestrichene usw. Gewebe;168108;91180;76928
01.07.13;WA60;Gewirke und Gestricke;65320;36643;28677
01.07.13;WA61;Bekleidung usw. aus Gewirken, Gestricken;583975;1336127;-752152
01.07.13;WA62;Andere Bekleidung, Bekleidungszubehör;611503;1291364;-679861
01.07.13;WA63;Andere Konfektion, Spinnstoffwaren usw.;187406;273237;-85831
01.07.13;WA64;Schuhe, Gamaschen, ähnliche Waren;360821;792261;-431440
01.07.13;WA65;Kopfbedeckungen und Teile davon;22015;37915;-15900
01.07.13;WA66;Schirme, Gehstöcke usw., Peitschen;4448;10533;-6085
01.07.13;WA67;Zugerichtete Federn, Daunen, künstliche Blumen;6797;14095;-7298
01.07.13;WA68;Waren aus Steinen, Gips, Zement usw.;342906;231282;111624
01.07.13;WA69;Keramische Waren;247481;188965;58516
01.07.13;WA70;Glas und Glaswaren;452966;348725;104241
01.07.13;WA71;Perlen, Edelsteine, Edelmetalle;1062990;1361070;-298080
01.07.13;WA72;Eisen und Stahl;1790546;1943600;-153054
01.07.13;WA73;Waren aus Eisen oder Stahl;2153527;1530784;622743
01.07.13;WA74;Kupfer und Waren daraus;859442;863572;-4130
01.07.13;WA75;Nickel und Waren daraus;92174;101039;-8865
01.07.13;WA76;Aluminium und Waren daraus;1079122;1100580;-21458
01.07.13;WA78;Blei und Waren daraus;35951;28538;7413
01.07.13;WA79;Zink und Waren daraus;49735;90537;-40802
01.07.13;WA80;Zinn und Waren daraus;9254;25289;-16035
01.07.13;WA81;Andere unedle Metalle, Cermets usw.;106882;124046;-17164
01.07.13;WA82;Werkzeuge, Schneidwaren, Essbestecke;583560;353289;230271
01.07.13;WA83;Verschiedene Waren aus unedlen Metallen;559280;322982;236298
01.07.13;WA84;Maschinen, Apparate, mechanische Geräte;16636235;9137966;7498269
01.07.13;WA85;Elektrotechnische Erzeugnisse;9040492;8009932;1030560
01.07.13;WA86;Schienenfahrzeuge;331676;153757;177919
01.07.13;WA87;Kraftfahrzeuge, Landfahrzeuge;15784314;6032547;9751767
01.07.13;WA88;Luftfahrzeuge, Raumfahrzeuge;2265729;1471285;794444
01.07.13;WA89;Wasserfahrzeuge;45808;444529;-398721
01.07.13;WA90;Optische, photografische usw. Erzeugnisse;4299955;2367547;1932408
01.07.13;WA91;Uhrmacherwaren;155493;187434;-31941
01.07.13;WA92;Musikinstrumente;39588;34751;4837
01.07.13;WA93;Waffen und Munition;48058;20035;28023
01.07.13;WA94;Möbel, Beleuchtungskörper usw.;1100086;1108914;-8828
01.07.13;WA95;Spielzeug, Spiele usw., Sportgeräte;236309;316114;-79805
01.07.13;WA96;Verschiedene Waren;286728;198919;87809
01.07.13;WA97;Kunstgegenstände, Sammlungsstücke;49346;51805;-2459
01.07.13;WA98;Vollständige Fabrikationsanlagen;253925;1734;252191
01.07.13;WA99;Zusammenstellungen verschiedener Waren;1514225;814493;699732
01.07.14;WA01;Lebende Tiere;131456;167999;-36543
01.07.14;WA02;Fleisch;670138;494139;175999
01.07.14;WA03;Fische, Krebs- und Weichtiere;105481;253520;-148039
01.07.14;WA04;Milch, Milcherzeugnisse, Eier, Honig;804568;550102;254466
01.07.14;WA05;Andere Waren tierischen Ursprungs;66969;77572;-10603
01.07.14;WA06;Pflanzen, Waren des Blumenhandels;47496;155460;-107964
01.07.14;WA07;Gemüse, Pflanzen für Ernährung;77906;367611;-289705
01.07.14;WA08;Geniessbare Früchte und Nüsse;137831;697808;-559977
01.07.14;WA09;Kaffee, Tee, Mate, Gewürze;208064;340991;-132927
01.07.14;WA10;Getreide;176167;178263;-2096
01.07.14;WA11;Müllereierzeugnisse, Malz usw.;113826;42171;71655
01.07.14;WA12;Ölsamen usw., Heilpflanzen usw.;105187;464847;-359660
01.07.14;WA13;Schellack, Gummen, Harz, Pflanzensaft;44962;39908;5054
01.07.14;WA14;Flechtstoffe usw. pflanzlichen Ursprungs;542;3451;-2909
01.07.14;WA15;Tierische und pflanzliche Fette, Öle, Wachs;186725;314747;-128022
01.07.14;WA16;Zubereitungen von Fleisch, Fisch usw.;250420;205480;44940
01.07.14;WA17;Zucker und Zuckerwaren;164191;142435;21756
01.07.14;WA18;Kakao und Zubereitungen aus Kakao;333842;280898;52944
01.07.14;WA19;Zubereitungen aus Getreide usw., Backwaren;439745;271249;168496
01.07.14;WA20;Zubereitungen von Gemüse, Früchten usw.;208481;365928;-157447
01.07.14;WA21;Verschiedene Lebensmittelzubereitungen;437573;240830;196743
01.07.14;WA22;Getränke, alkoholhaltige Flüssigkeiten, Essig;494575;559845;-65270
01.07.14;WA23;Rückstände der Lebensmittelindustrie, Futter;331602;289336;42266
01.07.14;WA24;Tabak;344041;164360;179681
01.07.14;WA25;Salz, Schwefel, Steine, Erden usw.;171953;163216;8737
01.07.14;WA26;Erze, Schlacken, Aschen;33017;581356;-548339
01.07.14;WA27;Mineralische Brennstoffe usw.;2125703;8951659;-6825956
01.07.14;WA28;Anorganische chemische Erzeugnisse;706818;542629;164189
01.07.14;WA29;Organische chemische Erzeugnisse;2222101;1928731;293370
01.07.14;WA30;Pharmazeutische Erzeugnisse;5009194;2979051;2030143
01.07.14;WA31;Düngemittel;194127;98674;95453
01.07.14;WA32;Gerb- und Farbstoffe, Farben, Lacke usw.;955295;501536;453759
01.07.14;WA33;Etherische Öle, Riech-, Schönheitsmittel;698635;500922;197713
01.07.14;WA34;Seifen, Waschmittel usw.;582227;297300;284927
01.07.14;WA35;Eiweissstoffe, Klebstoffe, Enzyme;277308;180825;96483
01.07.14;WA36;Sprengstoffe, pyrotechnische Artikel usw.;19286;21631;-2345
01.07.14;WA37;Photochemische Erzeugnisse;91135;58473;32662
01.07.14;WA38;Verschiedene Erzeugnisse der Chemischen Industrie;1638186;1029996;608190
01.07.14;WA39;Kunststoffe und Waren daraus;4713990;3055479;1658511
01.07.14;WA40;Kautschuk und Waren daraus;1196188;1248309;-52121
01.07.14;WA41;Häute, Felle, Leder;98026;76978;21048
01.07.14;WA42;Lederwaren, Sattlerwaren;173140;333597;-160457
01.07.14;WA43;Pelzfelle, künstliches Pelzwerk;17718;18357;-639
01.07.14;WA44;Holz, Holzwaren, Holzkohle;628681;601058;27623
01.07.14;WA45;Kork, Korkwaren;2339;6922;-4583
01.07.14;WA46;Flechtwaren, Korbmacherwaren;3244;10108;-6864
01.07.14;WA47;Halbstoffe aus Holz usw., Papierabfall;103021;299743;-196722
01.07.14;WA48;Papier, Pappe und Waren daraus;1496242;995966;500276
01.07.14;WA49;Bücher, Zeitungen, Bilddrucke usw.;345679;153200;192479
01.07.14;WA50;Seide;4930;5992;-1062
01.07.14;WA51;Wolle, feine und grobe Tierhaare;46945;53730;-6785
01.07.14;WA52;Baumwolle;72305;79556;-7251
01.07.14;WA53;Andere pflanzliche Spinnstoffe, Papiergarn;2463;5087;-2624
01.07.14;WA54;Synthetisches oder künstliches Filament;157196;126277;30919
01.07.14;WA55;Synthetische oder künstliche Spinnfaser;158058;126900;31158
01.07.14;WA56;Watte, Filz, Vliesstoff usw., Tauwerk;202576;109365;93211
01.07.14;WA57;Teppiche, Fussbodenbelag aus Spinnstoff;44425;77115;-32690
01.07.14;WA58;Spezialgewebe, Spitzen, Tapisserien;40355;22852;17503
01.07.14;WA59;Getränkte, bestrichene usw. Gewebe;172397;83934;88463
01.07.14;WA60;Gewirke und Gestricke;65797;37622;28175
01.07.14;WA61;Bekleidung usw. aus Gewirken, Gestricken;631035;1439314;-808279
01.07.14;WA62;Andere Bekleidung, Bekleidungszubehör;668335;1427200;-758865
01.07.14;WA63;Andere Konfektion, Spinnstoffwaren usw.;205728;307300;-101572
01.07.14;WA64;Schuhe, Gamaschen, ähnliche Waren;417430;852952;-435522
01.07.14;WA65;Kopfbedeckungen und Teile davon;25163;44750;-19587
01.07.14;WA66;Schirme, Gehstöcke usw., Peitschen;8257;14295;-6038
01.07.14;WA67;Zugerichtete Federn, Daunen, künstliche Blumen;7630;15544;-7914
01.07.14;WA68;Waren aus Steinen, Gips, Zement usw.;371313;251281;120032
01.07.14;WA69;Keramische Waren;264923;210781;54142
01.07.14;WA70;Glas und Glaswaren;489067;389589;99478
01.07.14;WA71;Perlen, Edelsteine, Edelmetalle;925671;1087821;-162150
01.07.14;WA72;Eisen und Stahl;1940560;2130499;-189939
01.07.14;WA73;Waren aus Eisen oder Stahl;2198332;1627006;571326
01.07.14;WA74;Kupfer und Waren daraus;900431;869575;30856
01.07.14;WA75;Nickel und Waren daraus;93845;105541;-11696
01.07.14;WA76;Aluminium und Waren daraus;1145309;1174397;-29088
01.07.14;WA78;Blei und Waren daraus;43432;26882;16550
01.07.14;WA79;Zink und Waren daraus;58654;113255;-54601
01.07.14;WA80;Zinn und Waren daraus;12247;41612;-29365
01.07.14;WA81;Andere unedle Metalle, Cermets usw.;126745;133727;-6982
01.07.14;WA82;Werkzeuge, Schneidwaren, Essbestecke;632392;394740;237652
01.07.14;WA83;Verschiedene Waren aus unedlen Metallen;586001;369173;216828
01.07.14;WA84;Maschinen, Apparate, mechanische Geräte;17358975;9690851;7668124
01.07.14;WA85;Elektrotechnische Erzeugnisse;9436651;8383571;1053080
01.07.14;WA86;Schienenfahrzeuge;336811;206853;129958
01.07.14;WA87;Kraftfahrzeuge, Landfahrzeuge;18149258;6860503;11288755
01.07.14;WA88;Luftfahrzeuge, Raumfahrzeuge;3207015;1093531;2113484
01.07.14;WA89;Wasserfahrzeuge;169165;124989;44176
01.07.14;WA90;Optische, photografische usw. Erzeugnisse;4412080;2545975;1866105
01.07.14;WA91;Uhrmacherwaren;151001;198100;-47099
01.07.14;WA92;Musikinstrumente;45245;41476;3769
01.07.14;WA93;Waffen und Munition;33289;16014;17275
01.07.14;WA94;Möbel, Beleuchtungskörper usw.;1167450;1287783;-120333
01.07.14;WA95;Spielzeug, Spiele usw., Sportgeräte;396975;333076;63899
01.07.14;WA96;Verschiedene Waren;317768;212742;105026
01.07.14;WA97;Kunstgegenstände, Sammlungsstücke;39675;53417;-13742
01.07.14;WA98;Vollständige Fabrikationsanlagen;264357;635;263722
01.07.14;WA99;Zusammenstellungen verschiedener Waren;2383649;804850;1578799
01.07.15;WA01;Lebende Tiere;133695;153259;-19564
01.07.15;WA02;Fleisch;630997;479353;151644
01.07.15;WA03;Fische, Krebs- und Weichtiere;103098;283391;-180293
01.07.15;WA04;Milch, Milcherzeugnisse, Eier, Honig;714903;571508;143395
01.07.15;WA05;Andere Waren tierischen Ursprungs;67113;71733;-4620
01.07.15;WA06;Pflanzen, Waren des Blumenhandels;49026;157513;-108487
01.07.15;WA07;Gemüse, Pflanzen für Ernährung;79995;404762;-324767
01.07.15;WA08;Geniessbare Früchte und Nüsse;155910;845893;-689983
01.07.15;WA09;Kaffee, Tee, Mate, Gewürze;189957;322639;-132682
01.07.15;WA10;Getreide;260246;176303;83943
01.07.15;WA11;Müllereierzeugnisse, Malz usw.;126501;42777;83724
01.07.15;WA12;Ölsamen usw., Heilpflanzen usw.;114708;422996;-308288
01.07.15;WA13;Schellack, Gummen, Harz, Pflanzensaft;50500;41379;9121
01.07.15;WA14;Flechtstoffe usw. pflanzlichen Ursprungs;659;3837;-3178
01.07.15;WA15;Tierische und pflanzliche Fette, Öle, Wachs;269122;334941;-65819
01.07.15;WA16;Zubereitungen von Fleisch, Fisch usw.;247066;200807;46259
01.07.15;WA17;Zucker und Zuckerwaren;161822;140980;20842
01.07.15;WA18;Kakao und Zubereitungen aus Kakao;357519;343906;13613
01.07.15;WA19;Zubereitungen aus Getreide usw., Backwaren;468648;324681;143967
01.07.15;WA20;Zubereitungen von Gemüse, Früchten usw.;205433;415353;-209920
01.07.15;WA21;Verschiedene Lebensmittelzubereitungen;463517;255169;208348
01.07.15;WA22;Getränke, alkoholhaltige Flüssigkeiten, Essig;523513;610738;-87225
01.07.15;WA23;Rückstände der Lebensmittelindustrie, Futter;329246;326092;3154
01.07.15;WA24;Tabak;397492;162544;234948
01.07.15;WA25;Salz, Schwefel, Steine, Erden usw.;185441;164965;20476
01.07.15;WA26;Erze, Schlacken, Aschen;25941;589427;-563486
01.07.15;WA27;Mineralische Brennstoffe usw.;2413655;7814803;-5401148
01.07.15;WA28;Anorganische chemische Erzeugnisse;728323;629267;99056
01.07.15;WA29;Organische chemische Erzeugnisse;2140976;2334650;-193674
01.07.15;WA30;Pharmazeutische Erzeugnisse;6111811;3554257;2557554
01.07.15;WA31;Düngemittel;204497;103611;100886
01.07.15;WA32;Gerb- und Farbstoffe, Farben, Lacke usw.;948219;486137;462082
01.07.15;WA33;Etherische Öle, Riech-, Schönheitsmittel;809487;630553;178934
01.07.15;WA34;Seifen, Waschmittel usw.;629125;328325;300800
01.07.15;WA35;Eiweissstoffe, Klebstoffe, Enzyme;270946;187619;83327
01.07.15;WA36;Sprengstoffe, pyrotechnische Artikel usw.;17657;27901;-10244
01.07.15;WA37;Photochemische Erzeugnisse;105723;64635;41088
01.07.15;WA38;Verschiedene Erzeugnisse der Chemischen Industrie;1715874;1046178;669696
01.07.15;WA39;Kunststoffe und Waren daraus;4958046;3273577;1684469
01.07.15;WA40;Kautschuk und Waren daraus;1214536;1209569;4967
01.07.15;WA41;Häute, Felle, Leder;103597;78322;25275
01.07.15;WA42;Lederwaren, Sattlerwaren;182335;373358;-191023
01.07.15;WA43;Pelzfelle, künstliches Pelzwerk;12991;14823;-1832
01.07.15;WA44;Holz, Holzwaren, Holzkohle;643848;626177;17671
01.07.15;WA45;Kork, Korkwaren;2608;10431;-7823
01.07.15;WA46;Flechtwaren, Korbmacherwaren;3890;11377;-7487
01.07.15;WA47;Halbstoffe aus Holz usw., Papierabfall;108569;320261;-211692
01.07.15;WA48;Papier, Pappe und Waren daraus;1577463;1076879;500584
01.07.15;WA49;Bücher, Zeitungen, Bilddrucke usw.;359611;184899;174712
01.07.15;WA50;Seide;4725;4995;-270
01.07.15;WA51;Wolle, feine und grobe Tierhaare;46890;49536;-2646
01.07.15;WA52;Baumwolle;74930;72963;1967
01.07.15;WA53;Andere pflanzliche Spinnstoffe, Papiergarn;2647;5343;-2696
01.07.15;WA54;Synthetisches oder künstliches Filament;160964;131314;29650
01.07.15;WA55;Synthetische oder künstliche Spinnfaser;153661;127035;26626
01.07.15;WA56;Watte, Filz, Vliesstoff usw., Tauwerk;201222;126093;75129
01.07.15;WA57;Teppiche, Fussbodenbelag aus Spinnstoff;42102;85113;-43011
01.07.15;WA58;Spezialgewebe, Spitzen, Tapisserien;45547;23252;22295
01.07.15;WA59;Getränkte, bestrichene usw. Gewebe;188243;94316;93927
01.07.15;WA60;Gewirke und Gestricke;66557;40036;26521
01.07.15;WA61;Bekleidung usw. aus Gewirken, Gestricken;668117;1546952;-878835
01.07.15;WA62;Andere Bekleidung, Bekleidungszubehör;665481;1492564;-827083
01.07.15;WA63;Andere Konfektion, Spinnstoffwaren usw.;220915;320441;-99526
01.07.15;WA64;Schuhe, Gamaschen, ähnliche Waren;463384;1008066;-544682
01.07.15;WA65;Kopfbedeckungen und Teile davon;26925;41630;-14705
01.07.15;WA66;Schirme, Gehstöcke usw., Peitschen;7337;17462;-10125
01.07.15;WA67;Zugerichtete Federn, Daunen, künstliche Blumen;7565;17037;-9472
01.07.15;WA68;Waren aus Steinen, Gips, Zement usw.;374449;272739;101710
01.07.15;WA69;Keramische Waren;257744;234112;23632
01.07.15;WA70;Glas und Glaswaren;503255;418454;84801
01.07.15;WA71;Perlen, Edelsteine, Edelmetalle;968245;1306125;-337880
01.07.15;WA72;Eisen und Stahl;1728238;2032958;-304720
01.07.15;WA73;Waren aus Eisen oder Stahl;2282647;1665034;617613
01.07.15;WA74;Kupfer und Waren daraus;906472;820287;86185
01.07.15;WA75;Nickel und Waren daraus;99204;106301;-7097
01.07.15;WA76;Aluminium und Waren daraus;1265046;1351375;-86329
01.07.15;WA78;Blei und Waren daraus;30619;22562;8057
01.07.15;WA79;Zink und Waren daraus;50983;116681;-65698
01.07.15;WA80;Zinn und Waren daraus;9600;32496;-22896
01.07.15;WA81;Andere unedle Metalle, Cermets usw.;122662;144753;-22091
01.07.15;WA82;Werkzeuge, Schneidwaren, Essbestecke;701622;410918;290704
01.07.15;WA83;Verschiedene Waren aus unedlen Metallen;607537;393420;214117
01.07.15;WA84;Maschinen, Apparate, mechanische Geräte;18052217;10418655;7633562
01.07.15;WA85;Elektrotechnische Erzeugnisse;10266032;9529426;736606
01.07.15;WA86;Schienenfahrzeuge;239973;197760;42213
01.07.15;WA87;Kraftfahrzeuge, Landfahrzeuge;20211016;7883985;12327031
01.07.15;WA88;Luftfahrzeuge, Raumfahrzeuge;3870220;1209923;2660297
01.07.15;WA89;Wasserfahrzeuge;313390;76547;236843
01.07.15;WA90;Optische, photografische usw. Erzeugnisse;4881723;2893207;1988516
01.07.15;WA91;Uhrmacherwaren;219617;245951;-26334
01.07.15;WA92;Musikinstrumente;47730;42784;4946
01.07.15;WA93;Waffen und Munition;44616;16331;28285
01.07.15;WA94;Möbel, Beleuchtungskörper usw.;1224705;1362896;-138191
01.07.15;WA95;Spielzeug, Spiele usw., Sportgeräte;290939;449835;-158896
01.07.15;WA96;Verschiedene Waren;375064;232610;142454
01.07.15;WA97;Kunstgegenstände, Sammlungsstücke;73278;54671;18607
01.07.15;WA98;Vollständige Fabrikationsanlagen;225701;1494;224207
01.07.15;WA99;Zusammenstellungen verschiedener Waren;1864256;906430;957826
01.07.16;WA01;Lebende Tiere;126391;177598;-51207
01.07.16;WA02;Fleisch;636301;461961;174340
01.07.16;WA03;Fische, Krebs- und Weichtiere;118981;284092;-165111
01.07.16;WA04;Milch, Milcherzeugnisse, Eier, Honig;619701;525112;94589
01.07.16;WA05;Andere Waren tierischen Ursprungs;67526;68247;-721
01.07.16;WA06;Pflanzen, Waren des Blumenhandels;48167;185913;-137746
01.07.16;WA07;Gemüse, Pflanzen für Ernährung;81137;436048;-354911
01.07.16;WA08;Geniessbare Früchte und Nüsse;174706;841451;-666745
01.07.16;WA09;Kaffee, Tee, Mate, Gewürze;216399;300185;-83786
01.07.16;WA10;Getreide;205206;139057;66149
01.07.16;WA11;Müllereierzeugnisse, Malz usw.;116811;43277;73534
01.07.16;WA12;Ölsamen usw., Heilpflanzen usw.;106991;372363;-265372
01.07.16;WA13;Schellack, Gummen, Harz, Pflanzensaft;47908;40936;6972
01.07.16;WA14;Flechtstoffe usw. pflanzlichen Ursprungs;601;3491;-2890
01.07.16;WA15;Tierische und pflanzliche Fette, Öle, Wachs;237675;354267;-116592
01.07.16;WA16;Zubereitungen von Fleisch, Fisch usw.;218633;205321;13312
01.07.16;WA17;Zucker und Zuckerwaren;158820;124560;34260
01.07.16;WA18;Kakao und Zubereitungen aus Kakao;422778;368221;54557
01.07.16;WA19;Zubereitungen aus Getreide usw., Backwaren;476794;321622;155172
01.07.16;WA20;Zubereitungen von Gemüse, Früchten usw.;211939;379681;-167742
01.07.16;WA21;Verschiedene Lebensmittelzubereitungen;440666;267276;173390
01.07.16;WA22;Getränke, alkoholhaltige Flüssigkeiten, Essig;512694;585627;-72933
01.07.16;WA23;Rückstände der Lebensmittelindustrie, Futter;322092;323304;-1212
01.07.16;WA24;Tabak;342644;144841;197803
01.07.16;WA25;Salz, Schwefel, Steine, Erden usw.;163278;147747;15531
01.07.16;WA26;Erze, Schlacken, Aschen;33437;454807;-421370
01.07.16;WA27;Mineralische Brennstoffe usw.;1853286;5792058;-3938772
01.07.16;WA28;Anorganische chemische Erzeugnisse;649409;481867;167542
01.07.16;WA29;Organische chemische Erzeugnisse;1868822;2040615;-171793
01.07.16;WA30;Pharmazeutische Erzeugnisse;5886434;3629145;2257289
01.07.16;WA31;Düngemittel;114742;75486;39256
01.07.16;WA32;Gerb- und Farbstoffe, Farben, Lacke usw.;850345;486822;363523
01.07.16;WA33;Etherische Öle, Riech-, Schönheitsmittel;743843;612745;131098
01.07.16;WA34;Seifen, Waschmittel usw.;577949;305080;272869
01.07.16;WA35;Eiweissstoffe, Klebstoffe, Enzyme;260761;164708;96053
01.07.16;WA36;Sprengstoffe, pyrotechnische Artikel usw.;17266;30531;-13265
01.07.16;WA37;Photochemische Erzeugnisse;111626;67294;44332
01.07.16;WA38;Verschiedene Erzeugnisse der Chemischen Industrie;1640284;1021126;619158
01.07.16;WA39;Kunststoffe und Waren daraus;4537579;3030626;1506953
01.07.16;WA40;Kautschuk und Waren daraus;1128919;1085814;43105
01.07.16;WA41;Häute, Felle, Leder;78024;63757;14267
01.07.16;WA42;Lederwaren, Sattlerwaren;180457;345267;-164810
01.07.16;WA43;Pelzfelle, künstliches Pelzwerk;9212;13127;-3915
01.07.16;WA44;Holz, Holzwaren, Holzkohle;637827;617800;20027
01.07.16;WA45;Kork, Korkwaren;2616;9367;-6751
01.07.16;WA46;Flechtwaren, Korbmacherwaren;3174;9331;-6157
01.07.16;WA47;Halbstoffe aus Holz usw., Papierabfall;122053;275945;-153892
01.07.16;WA48;Papier, Pappe und Waren daraus;1394751;999103;395648
01.07.16;WA49;Bücher, Zeitungen, Bilddrucke usw.;313557;202740;110817
01.07.16;WA50;Seide;3359;3730;-371
01.07.16;WA51;Wolle, feine und grobe Tierhaare;38388;53040;-14652
01.07.16;WA52;Baumwolle;62392;66633;-4241
01.07.16;WA53;Andere pflanzliche Spinnstoffe, Papiergarn;2718;5075;-2357
01.07.16;WA54;Synthetisches oder künstliches Filament;136501;116376;20125
01.07.16;WA55;Synthetische oder künstliche Spinnfaser;143394;125257;18137
01.07.16;WA56;Watte, Filz, Vliesstoff usw., Tauwerk;191821;112070;79751
01.07.16;WA57;Teppiche, Fussbodenbelag aus Spinnstoff;40455;80889;-40434
01.07.16;WA58;Spezialgewebe, Spitzen, Tapisserien;39417;21525;17892
01.07.16;WA59;Getränkte, bestrichene usw. Gewebe;183868;100746;83122
01.07.16;WA60;Gewirke und Gestricke;63712;35438;28274
01.07.16;WA61;Bekleidung usw. aus Gewirken, Gestricken;623791;1402334;-778543
01.07.16;WA62;Andere Bekleidung, Bekleidungszubehör;633890;1373343;-739453
01.07.16;WA63;Andere Konfektion, Spinnstoffwaren usw.;214380;307055;-92675
01.07.16;WA64;Schuhe, Gamaschen, ähnliche Waren;481444;921397;-439953
01.07.16;WA65;Kopfbedeckungen und Teile davon;28564;46327;-17763
01.07.16;WA66;Schirme, Gehstöcke usw., Peitschen;6454;13219;-6765
01.07.16;WA67;Zugerichtete Federn, Daunen, künstliche Blumen;8759;17497;-8738
01.07.16;WA68;Waren aus Steinen, Gips, Zement usw.;362873;266221;96652
01.07.16;WA69;Keramische Waren;254635;221578;33057
01.07.16;WA70;Glas und Glaswaren;489057;410473;78584
01.07.16;WA71;Perlen, Edelsteine, Edelmetalle;967166;1187304;-220138
01.07.16;WA72;Eisen und Stahl;1581983;1723410;-141427
01.07.16;WA73;Waren aus Eisen oder Stahl;2126436;1595121;531315
01.07.16;WA74;Kupfer und Waren daraus;745869;755131;-9262
01.07.16;WA75;Nickel und Waren daraus;67354;94582;-27228
01.07.16;WA76;Aluminium und Waren daraus;1144516;1242946;-98430
01.07.16;WA78;Blei und Waren daraus;25898;30455;-4557
01.07.16;WA79;Zink und Waren daraus;50311;125138;-74827
01.07.16;WA80;Zinn und Waren daraus;7685;36406;-28721
01.07.16;WA81;Andere unedle Metalle, Cermets usw.;113856;142115;-28259
01.07.16;WA82;Werkzeuge, Schneidwaren, Essbestecke;659012;409594;249418
01.07.16;WA83;Verschiedene Waren aus unedlen Metallen;588870;364050;224820
01.07.16;WA84;Maschinen, Apparate, mechanische Geräte;15886278;9825842;6060436
01.07.16;WA85;Elektrotechnische Erzeugnisse;9525961;9048655;477306
01.07.16;WA86;Schienenfahrzeuge;365296;204801;160495
01.07.16;WA87;Kraftfahrzeuge, Landfahrzeuge;17435755;7643334;9792421
01.07.16;WA88;Luftfahrzeuge, Raumfahrzeuge;2517516;1760105;757411
01.07.16;WA89;Wasserfahrzeuge;279705;115329;164376
01.07.16;WA90;Optische, photografische usw. Erzeugnisse;4468231;2852277;1615954
01.07.16;WA91;Uhrmacherwaren;158456;172929;-14473
01.07.16;WA92;Musikinstrumente;38697;41223;-2526
01.07.16;WA93;Waffen und Munition;48829;20081;28748
01.07.16;WA94;Möbel, Beleuchtungskörper usw.;1216433;1338009;-121576
01.07.16;WA95;Spielzeug, Spiele usw., Sportgeräte;285369;400303;-114934
01.07.16;WA96;Verschiedene Waren;306493;226341;80152
01.07.16;WA97;Kunstgegenstände, Sammlungsstücke;56876;52870;4006
01.07.16;WA98;Vollständige Fabrikationsanlagen;168503;420;168083
01.07.16;WA99;Zusammenstellungen verschiedener Waren;1893180;938827;954353
01.07.17;WA01;Lebende Tiere;121147;166585;-45438
01.07.17;WA02;Fleisch;654720;540225;114495
01.07.17;WA03;Fische, Krebs- und Weichtiere;130006;322913;-192907
01.07.17;WA04;Milch, Milcherzeugnisse, Eier, Honig;773023;633007;140016
01.07.17;WA05;Andere Waren tierischen Ursprungs;72739;84040;-11301
01.07.17;WA06;Pflanzen, Waren des Blumenhandels;49976;167171;-117195
01.07.17;WA07;Gemüse, Pflanzen für Ernährung;83474;446210;-362736
01.07.17;WA08;Geniessbare Früchte und Nüsse;157658;918560;-760902
01.07.17;WA09;Kaffee, Tee, Mate, Gewürze;224405;324166;-99761
01.07.17;WA10;Getreide;140197;162872;-22675
01.07.17;WA11;Müllereierzeugnisse, Malz usw.;116535;48415;68120
01.07.17;WA12;Ölsamen usw., Heilpflanzen usw.;107917;360773;-252856
01.07.17;WA13;Schellack, Gummen, Harz, Pflanzensaft;48782;43455;5327
01.07.17;WA14;Flechtstoffe usw. pflanzlichen Ursprungs;729;3696;-2967
01.07.17;WA15;Tierische und pflanzliche Fette, Öle, Wachs;221875;347430;-125555
01.07.17;WA16;Zubereitungen von Fleisch, Fisch usw.;240939;221479;19460
01.07.17;WA17;Zucker und Zuckerwaren;181844;148330;33514
01.07.17;WA18;Kakao und Zubereitungen aus Kakao;369199;308910;60289
01.07.17;WA19;Zubereitungen aus Getreide usw., Backwaren;508754;356824;151930
01.07.17;WA20;Zubereitungen von Gemüse, Früchten usw.;227716;431148;-203432
01.07.17;WA21;Verschiedene Lebensmittelzubereitungen;476847;289502;187345
01.07.17;WA22;Getränke, alkoholhaltige Flüssigkeiten, Essig;532408;641496;-109088
01.07.17;WA23;Rückstände der Lebensmittelindustrie, Futter;323048;334578;-11530
01.07.17;WA24;Tabak;333626;186849;146777
01.07.17;WA25;Salz, Schwefel, Steine, Erden usw.;172289;161402;10887
01.07.17;WA26;Erze, Schlacken, Aschen;44564;725659;-681095
01.07.17;WA27;Mineralische Brennstoffe usw.;1677579;6154187;-4476608
01.07.17;WA28;Anorganische chemische Erzeugnisse;684006;537944;146062
01.07.17;WA29;Organische chemische Erzeugnisse;2037687;2313515;-275828
01.07.17;WA30;Pharmazeutische Erzeugnisse;6360230;3907224;2453006
01.07.17;WA31;Düngemittel;145719;80470;65249
01.07.17;WA32;Gerb- und Farbstoffe, Farben, Lacke usw.;955961;488553;467408
01.07.17;WA33;Etherische Öle, Riech-, Schönheitsmittel;753348;628447;124901
01.07.17;WA34;Seifen, Waschmittel usw.;627113;331466;295647
01.07.17;WA35;Eiweissstoffe, Klebstoffe, Enzyme;280653;190631;90022
01.07.17;WA36;Sprengstoffe, pyrotechnische Artikel usw.;17521;24443;-6922
01.07.17;WA37;Photochemische Erzeugnisse;104187;87646;16541
01.07.17;WA38;Verschiedene Erzeugnisse der Chemischen Industrie;1707669;1095937;611732
01.07.17;WA39;Kunststoffe und Waren daraus;5020839;3367842;1652997
01.07.17;WA40;Kautschuk und Waren daraus;1259684;1196060;63624
01.07.17;WA41;Häute, Felle, Leder;87273;68821;18452
01.07.17;WA42;Lederwaren, Sattlerwaren;197341;375270;-177929
01.07.17;WA43;Pelzfelle, künstliches Pelzwerk;10260;16497;-6237
01.07.17;WA44;Holz, Holzwaren, Holzkohle;679531;647031;32500
01.07.17;WA45;Kork, Korkwaren;2722;8476;-5754
01.07.17;WA46;Flechtwaren, Korbmacherwaren;3462;9012;-5550
01.07.17;WA47;Halbstoffe aus Holz usw., Papierabfall;105005;330262;-225257
01.07.17;WA48;Papier, Pappe und Waren daraus;1495921;1000670;495251
01.07.17;WA49;Bücher, Zeitungen, Bilddrucke usw.;333108;211924;121184
01.07.17;WA50;Seide;3389;3099;290
01.07.17;WA51;Wolle, feine und grobe Tierhaare;36352;50168;-13816
01.07.17;WA52;Baumwolle;63816;69229;-5413
01.07.17;WA53;Andere pflanzliche Spinnstoffe, Papiergarn;2301;4679;-2378
01.07.17;WA54;Synthetisches oder künstliches Filament;151310;126738;24572
01.07.17;WA55;Synthetische oder künstliche Spinnfaser;146309;117328;28981
01.07.17;WA56;Watte, Filz, Vliesstoff usw., Tauwerk;201533;122531;79002
01.07.17;WA57;Teppiche, Fussbodenbelag aus Spinnstoff;40581;83633;-43052
01.07.17;WA58;Spezialgewebe, Spitzen, Tapisserien;43280;21852;21428
01.07.17;WA59;Getränkte, bestrichene usw. Gewebe;203786;97783;106003
01.07.17;WA60;Gewirke und Gestricke;65817;37964;27853
01.07.17;WA61;Bekleidung usw. aus Gewirken, Gestricken;718137;1483845;-765708
01.07.17;WA62;Andere Bekleidung, Bekleidungszubehör;733873;1414691;-680818
01.07.17;WA63;Andere Konfektion, Spinnstoffwaren usw.;210446;325566;-115120
01.07.17;WA64;Schuhe, Gamaschen, ähnliche Waren;583565;1002717;-419152
01.07.17;WA65;Kopfbedeckungen und Teile davon;34788;50120;-15332
01.07.17;WA66;Schirme, Gehstöcke usw., Peitschen;8035;17670;-9635
01.07.17;WA67;Zugerichtete Federn, Daunen, künstliche Blumen;8279;19156;-10877
01.07.17;WA68;Waren aus Steinen, Gips, Zement usw.;402816;278246;124570
01.07.17;WA69;Keramische Waren;267100;216461;50639
01.07.17;WA70;Glas und Glaswaren;527965;424653;103312
01.07.17;WA71;Perlen, Edelsteine, Edelmetalle;807215;1541150;-733935
01.07.17;WA72;Eisen und Stahl;1738368;2192745;-454377
01.07.17;WA73;Waren aus Eisen oder Stahl;2224780;1756647;468133
01.07.17;WA74;Kupfer und Waren daraus;811041;849275;-38234
01.07.17;WA75;Nickel und Waren daraus;95876;95076;800
01.07.17;WA76;Aluminium und Waren daraus;1189079;1306879;-117800
01.07.17;WA78;Blei und Waren daraus;26103;40038;-13935
01.07.17;WA79;Zink und Waren daraus;70153;139734;-69581
01.07.17;WA80;Zinn und Waren daraus;8715;40349;-31634
01.07.17;WA81;Andere unedle Metalle, Cermets usw.;126772;167416;-40644
01.07.17;WA82;Werkzeuge, Schneidwaren, Essbestecke;695298;427494;267804
01.07.17;WA83;Verschiedene Waren aus unedlen Metallen;616257;379407;236850
01.07.17;WA84;Maschinen, Apparate, mechanische Geräte;18169131;10824987;7344144
01.07.17;WA85;Elektrotechnische Erzeugnisse;10564737;10361188;203549
01.07.17;WA86;Schienenfahrzeuge;424621;250754;173867
01.07.17;WA87;Kraftfahrzeuge, Landfahrzeuge;18271892;8334783;9937109
01.07.17;WA88;Luftfahrzeuge, Raumfahrzeuge;2508093;1547512;960581
01.07.17;WA89;Wasserfahrzeuge;426543;154335;272208
01.07.17;WA90;Optische, photografische usw. Erzeugnisse;5210365;2893602;2316763
01.07.17;WA91;Uhrmacherwaren;132770;175134;-42364
01.07.17;WA92;Musikinstrumente;48805;46582;2223
01.07.17;WA93;Waffen und Munition;36291;21257;15034
01.07.17;WA94;Möbel, Beleuchtungskörper usw.;1218487;1356282;-137795
01.07.17;WA95;Spielzeug, Spiele usw., Sportgeräte;348916;467747;-118831
01.07.17;WA96;Verschiedene Waren;324812;232287;92525
01.07.17;WA97;Kunstgegenstände, Sammlungsstücke;50903;37672;13231
01.07.17;WA98;Vollständige Fabrikationsanlagen;162281;24543;137738
01.07.17;WA99;Zusammenstellungen verschiedener Waren;1499376;1015922;483454
01.07.18;WA01;Lebende Tiere;121152;135708;-14556
01.07.18;WA02;Fleisch;614454;567005;47449
01.07.18;WA03;Fische, Krebs- und Weichtiere;144226;331095;-186869
01.07.18;WA04;Milch, Milcherzeugnisse, Eier, Honig;756476;666056;90420
01.07.18;WA05;Andere Waren tierischen Ursprungs;72771;90702;-17931
01.07.18;WA06;Pflanzen, Waren des Blumenhandels;53406;184823;-131417
01.07.18;WA07;Gemüse, Pflanzen für Ernährung;81762;464944;-383182
01.07.18;WA08;Geniessbare Früchte und Nüsse;163401;950630;-787229
01.07.18;WA09;Kaffee, Tee, Mate, Gewürze;230508;323522;-93014
01.07.18;WA10;Getreide;130060;185630;-55570
01.07.18;WA11;Müllereierzeugnisse, Malz usw.;128680;59830;68850
01.07.18;WA12;Ölsamen usw., Heilpflanzen usw.;109568;383468;-273900
01.07.18;WA13;Schellack, Gummen, Harz, Pflanzensaft;54332;50665;3667
01.07.18;WA14;Flechtstoffe usw. pflanzlichen Ursprungs;804;4081;-3277
01.07.18;WA15;Tierische und pflanzliche Fette, Öle, Wachs;206342;327828;-121486
01.07.18;WA16;Zubereitungen von Fleisch, Fisch usw.;293333;277669;15664
01.07.18;WA17;Zucker und Zuckerwaren;201152;147314;53838
01.07.18;WA18;Kakao und Zubereitungen aus Kakao;387829;355125;32704
01.07.18;WA19;Zubereitungen aus Getreide usw., Backwaren;549719;391046;158673
01.07.18;WA20;Zubereitungen von Gemüse, Früchten usw.;256023;448620;-192597
01.07.18;WA21;Verschiedene Lebensmittelzubereitungen;487973;307966;180007
01.07.18;WA22;Getränke, alkoholhaltige Flüssigkeiten, Essig;551082;694082;-143000
01.07.18;WA23;Rückstände der Lebensmittelindustrie, Futter;354789;365151;-10362
01.07.18;WA24;Tabak;319418;209118;110300
01.07.18;WA25;Salz, Schwefel, Steine, Erden usw.;179233;182305;-3072
01.07.18;WA26;Erze, Schlacken, Aschen;34166;723434;-689268
01.07.18;WA27;Mineralische Brennstoffe usw.;2384220;8361201;-5976981
01.07.18;WA28;Anorganische chemische Erzeugnisse;755518;567740;187778
01.07.18;WA29;Organische chemische Erzeugnisse;2138433;3724649;-1586216
01.07.18;WA30;Pharmazeutische Erzeugnisse;7425598;4417271;3008327
01.07.18;WA31;Düngemittel;145569;72725;72844
01.07.18;WA32;Gerb- und Farbstoffe, Farben, Lacke usw.;1005983;524210;481773
01.07.18;WA33;Etherische Öle, Riech-, Schönheitsmittel;833823;647533;186290
01.07.18;WA34;Seifen, Waschmittel usw.;669854;360598;309256
01.07.18;WA35;Eiweissstoffe, Klebstoffe, Enzyme;298449;183106;115343
01.07.18;WA36;Sprengstoffe, pyrotechnische Artikel usw.;21412;32477;-11065
01.07.18;WA37;Photochemische Erzeugnisse;112537;82486;30051
01.07.18;WA38;Verschiedene Erzeugnisse der Chemischen Industrie;1850171;1224245;625926
01.07.18;WA39;Kunststoffe und Waren daraus;5289355;3695696;1593659
01.07.18;WA40;Kautschuk und Waren daraus;1273517;1205085;68432
01.07.18;WA41;Häute, Felle, Leder;75516;59124;16392
01.07.18;WA42;Lederwaren, Sattlerwaren;214348;396473;-182125
01.07.18;WA43;Pelzfelle, künstliches Pelzwerk;10103;14218;-4115
01.07.18;WA44;Holz, Holzwaren, Holzkohle;743687;705133;38554
01.07.18;WA45;Kork, Korkwaren;2510;9090;-6580
01.07.18;WA46;Flechtwaren, Korbmacherwaren;3134;10180;-7046
01.07.18;WA47;Halbstoffe aus Holz usw., Papierabfall;109225;351689;-242464
01.07.18;WA48;Papier, Pappe und Waren daraus;1650377;1122257;528120
01.07.18;WA49;Bücher, Zeitungen, Bilddrucke usw.;340483;226466;114017
01.07.18;WA50;Seide;3404;3818;-414
01.07.18;WA51;Wolle, feine und grobe Tierhaare;37976;53363;-15387
01.07.18;WA52;Baumwolle;59121;70302;-11181
01.07.18;WA53;Andere pflanzliche Spinnstoffe, Papiergarn;2330;5169;-2839
01.07.18;WA54;Synthetisches oder künstliches Filament;152059;130809;21250
01.07.18;WA55;Synthetische oder künstliche Spinnfaser;150279;121317;28962
01.07.18;WA56;Watte, Filz, Vliesstoff usw., Tauwerk;208438;138520;69918
01.07.18;WA57;Teppiche, Fussbodenbelag aus Spinnstoff;48307;88464;-40157
01.07.18;WA58;Spezialgewebe, Spitzen, Tapisserien;41486;22510;18976
01.07.18;WA59;Getränkte, bestrichene usw. Gewebe;209669;97961;111708
01.07.18;WA60;Gewirke und Gestricke;63360;40872;22488
01.07.18;WA61;Bekleidung usw. aus Gewirken, Gestricken;812129;1664002;-851873
01.07.18;WA62;Andere Bekleidung, Bekleidungszubehör;862091;1578388;-716297
01.07.18;WA63;Andere Konfektion, Spinnstoffwaren usw.;234756;354699;-119943
01.07.18;WA64;Schuhe, Gamaschen, ähnliche Waren;664960;1044910;-379950
01.07.18;WA65;Kopfbedeckungen und Teile davon;35877;54134;-18257
01.07.18;WA66;Schirme, Gehstöcke usw., Peitschen;10323;18173;-7850
01.07.18;WA67;Zugerichtete Federn, Daunen, künstliche Blumen;11431;23392;-11961
01.07.18;WA68;Waren aus Steinen, Gips, Zement usw.;433995;312269;121726
01.07.18;WA69;Keramische Waren;316375;249213;67162
01.07.18;WA70;Glas und Glaswaren;568997;455284;113713
01.07.18;WA71;Perlen, Edelsteine, Edelmetalle;986641;1642541;-655900
01.07.18;WA72;Eisen und Stahl;2024215;2521229;-497014
01.07.18;WA73;Waren aus Eisen oder Stahl;2436274;1984945;451329
01.07.18;WA74;Kupfer und Waren daraus;982187;865528;116659
01.07.18;WA75;Nickel und Waren daraus;112404;127489;-15085
01.07.18;WA76;Aluminium und Waren daraus;1339999;1527982;-187983
01.07.18;WA78;Blei und Waren daraus;32724;45022;-12298
01.07.18;WA79;Zink und Waren daraus;67434;166847;-99413
01.07.18;WA80;Zinn und Waren daraus;9433;42383;-32950
01.07.18;WA81;Andere unedle Metalle, Cermets usw.;134937;194224;-59287
01.07.18;WA82;Werkzeuge, Schneidwaren, Essbestecke;761403;470291;291112
01.07.18;WA83;Verschiedene Waren aus unedlen Metallen;642103;428660;213443
01.07.18;WA84;Maschinen, Apparate, mechanische Geräte;19589239;11905691;7683548
01.07.18;WA85;Elektrotechnische Erzeugnisse;11623310;11239145;384165
01.07.18;WA86;Schienenfahrzeuge;292109;215238;76871
01.07.18;WA87;Kraftfahrzeuge, Landfahrzeuge;18379466;9108698;9270768
01.07.18;WA88;Luftfahrzeuge, Raumfahrzeuge;2697098;1241279;1455819
01.07.18;WA89;Wasserfahrzeuge;477148;724002;-246854
01.07.18;WA90;Optische, photografische usw. Erzeugnisse;5686778;3213470;2473308
01.07.18;WA91;Uhrmacherwaren;139387;165171;-25784
01.07.18;WA92;Musikinstrumente;42532;47059;-4527
01.07.18;WA93;Waffen und Munition;35760;19947;15813
01.07.18;WA94;Möbel, Beleuchtungskörper usw.;1310810;1473734;-162924
01.07.18;WA95;Spielzeug, Spiele usw., Sportgeräte;401860;574387;-172527
01.07.18;WA96;Verschiedene Waren;338727;252540;86187
01.07.18;WA97;Kunstgegenstände, Sammlungsstücke;50351;44900;5451
01.07.18;WA98;Vollständige Fabrikationsanlagen;113830;6259;107571
01.07.18;WA99;Zusammenstellungen verschiedener Waren;1486650;1004472;482178
01.07.19;WA01;Lebende Tiere;104786;153250;-48464
01.07.19;WA02;Fleisch;650004;557454;92550
01.07.19;WA03;Fische, Krebs- und Weichtiere;124879;305349;-180470
01.07.19;WA04;Milch, Milcherzeugnisse, Eier, Honig;823949;689360;134589
01.07.19;WA05;Andere Waren tierischen Ursprungs;77374;94813;-17439
01.07.19;WA06;Pflanzen, Waren des Blumenhandels;61930;184891;-122961
01.07.19;WA07;Gemüse, Pflanzen für Ernährung;107507;483891;-376384
01.07.19;WA08;Geniessbare Früchte und Nüsse;148148;914356;-766208
01.07.19;WA09;Kaffee, Tee, Mate, Gewürze;225878;347285;-121407
01.07.19;WA10;Getreide;134882;193651;-58769
01.07.19;WA11;Müllereierzeugnisse, Malz usw.;139432;56599;82833
01.07.19;WA12;Ölsamen usw., Heilpflanzen usw.;93089;359518;-266429
01.07.19;WA13;Schellack, Gummen, Harz, Pflanzensaft;58516;48175;10341
01.07.19;WA14;Flechtstoffe usw. pflanzlichen Ursprungs;618;3688;-3070
01.07.19;WA15;Tierische und pflanzliche Fette, Öle, Wachs;205440;273417;-67977
01.07.19;WA16;Zubereitungen von Fleisch, Fisch usw.;258215;226953;31262
01.07.19;WA17;Zucker und Zuckerwaren;197485;133615;63870
01.07.19;WA18;Kakao und Zubereitungen aus Kakao;434121;409213;24908
01.07.19;WA19;Zubereitungen aus Getreide usw., Backwaren;562261;361507;200754
01.07.19;WA20;Zubereitungen von Gemüse, Früchten usw.;249664;416214;-166550
01.07.19;WA21;Verschiedene Lebensmittelzubereitungen;553293;336183;217110
01.07.19;WA22;Getränke, alkoholhaltige Flüssigkeiten, Essig;564957;725408;-160451
01.07.19;WA23;Rückstände der Lebensmittelindustrie, Futter;361614;352687;8927
01.07.19;WA24;Tabak;277585;223655;53930
01.07.19;WA25;Salz, Schwefel, Steine, Erden usw.;174799;164320;10479
01.07.19;WA26;Erze, Schlacken, Aschen;48556;735538;-686982
01.07.19;WA27;Mineralische Brennstoffe usw.;2569685;8009363;-5439678
01.07.19;WA28;Anorganische chemische Erzeugnisse;892985;617166;275819
01.07.19;WA29;Organische chemische Erzeugnisse;2193369;3414557;-1221188
01.07.19;WA30;Pharmazeutische Erzeugnisse;7426154;4610277;2815877
01.07.19;WA31;Düngemittel;164162;84491;79671
01.07.19;WA32;Gerb- und Farbstoffe, Farben, Lacke usw.;1087145;487746;599399
01.07.19;WA33;Etherische Öle, Riech-, Schönheitsmittel;898911;687635;211276
01.07.19;WA34;Seifen, Waschmittel usw.;671337;364637;306700
01.07.19;WA35;Eiweissstoffe, Klebstoffe, Enzyme;311766;192597;119169
01.07.19;WA36;Sprengstoffe, pyrotechnische Artikel usw.;22477;30181;-7704
01.07.19;WA37;Photochemische Erzeugnisse;112073;80147;31926
01.07.19;WA38;Verschiedene Erzeugnisse der Chemischen Industrie;1875475;1222847;652628
01.07.19;WA39;Kunststoffe und Waren daraus;5234707;3514139;1720568
01.07.19;WA40;Kautschuk und Waren daraus;1265447;1178180;87267
01.07.19;WA41;Häute, Felle, Leder;58829;50345;8484
01.07.19;WA42;Lederwaren, Sattlerwaren;228925;413795;-184870
01.07.19;WA43;Pelzfelle, künstliches Pelzwerk;10421;14505;-4084
01.07.19;WA44;Holz, Holzwaren, Holzkohle;736306;683452;52854
01.07.19;WA45;Kork, Korkwaren;2871;10978;-8107
01.07.19;WA46;Flechtwaren, Korbmacherwaren;3919;10003;-6084
01.07.19;WA47;Halbstoffe aus Holz usw., Papierabfall;84169;284849;-200680
01.07.19;WA48;Papier, Pappe und Waren daraus;1599523;1044233;555290
01.07.19;WA49;Bücher, Zeitungen, Bilddrucke usw.;342546;218254;124292
01.07.19;WA50;Seide;2702;2471;231
01.07.19;WA51;Wolle, feine und grobe Tierhaare;41303;47664;-6361
01.07.19;WA52;Baumwolle;55088;61515;-6427
01.07.19;WA53;Andere pflanzliche Spinnstoffe, Papiergarn;2243;5330;-3087
01.07.19;WA54;Synthetisches oder künstliches Filament;140741;122812;17929
01.07.19;WA55;Synthetische oder künstliche Spinnfaser;136728;115279;21449
01.07.19;WA56;Watte, Filz, Vliesstoff usw., Tauwerk;210803;134340;76463
01.07.19;WA57;Teppiche, Fussbodenbelag aus Spinnstoff;43572;83650;-40078
01.07.19;WA58;Spezialgewebe, Spitzen, Tapisserien;43204;21714;21490
01.07.19;WA59;Getränkte, bestrichene usw. Gewebe;203554;98248;105306
01.07.19;WA60;Gewirke und Gestricke;57291;39410;17881
01.07.19;WA61;Bekleidung usw. aus Gewirken, Gestricken;880770;1604902;-724132
01.07.19;WA62;Andere Bekleidung, Bekleidungszubehör;896972;1500097;-603125
01.07.19;WA63;Andere Konfektion, Spinnstoffwaren usw.;247413;366782;-119369
01.07.19;WA64;Schuhe, Gamaschen, ähnliche Waren;704163;1109533;-405370
01.07.19;WA65;Kopfbedeckungen und Teile davon;39653;68142;-28489
01.07.19;WA66;Schirme, Gehstöcke usw., Peitschen;9795;21697;-11902
01.07.19;WA67;Zugerichtete Federn, Daunen, künstliche Blumen;13350;25117;-11767
01.07.19;WA68;Waren aus Steinen, Gips, Zement usw.;423718;317691;106027
01.07.19;WA69;Keramische Waren;306779;254939;51840
01.07.19;WA70;Glas und Glaswaren;561731;436377;125354
01.07.19;WA71;Perlen, Edelsteine, Edelmetalle;1500401;1526721;-26320
01.07.19;WA72;Eisen und Stahl;1933064;2111351;-178287
01.07.19;WA73;Waren aus Eisen oder Stahl;2406793;1960226;446567
01.07.19;WA74;Kupfer und Waren daraus;896170;786421;109749
01.07.19;WA75;Nickel und Waren daraus;116500;140147;-23647
01.07.19;WA76;Aluminium und Waren daraus;1251311;1355578;-104267
01.07.19;WA78;Blei und Waren daraus;27517;43071;-15554
01.07.19;WA79;Zink und Waren daraus;75911;125200;-49289
01.07.19;WA80;Zinn und Waren daraus;7328;37643;-30315
01.07.19;WA81;Andere unedle Metalle, Cermets usw.;131533;175845;-44312
01.07.19;WA82;Werkzeuge, Schneidwaren, Essbestecke;726400;475031;251369
01.07.19;WA83;Verschiedene Waren aus unedlen Metallen;646473;419010;227463
01.07.19;WA84;Maschinen, Apparate, mechanische Geräte;20658951;12022515;8636436
01.07.19;WA85;Elektrotechnische Erzeugnisse;12331697;11146808;1184889
01.07.19;WA86;Schienenfahrzeuge;301057;271534;29523
01.07.19;WA87;Kraftfahrzeuge, Landfahrzeuge;18942152;9766259;9175893
01.07.19;WA88;Luftfahrzeuge, Raumfahrzeuge;3157223;1372210;1785013
01.07.19;WA89;Wasserfahrzeuge;355851;278171;77680
01.07.19;WA90;Optische, photografische usw. Erzeugnisse;6125609;3373084;2752525
01.07.19;WA91;Uhrmacherwaren;140193;187343;-47150
01.07.19;WA92;Musikinstrumente;51990;51242;748
01.07.19;WA93;Waffen und Munition;41402;25138;16264
01.07.19;WA94;Möbel, Beleuchtungskörper usw.;1306075;1465894;-159819
01.07.19;WA95;Spielzeug, Spiele usw., Sportgeräte;405422;573625;-168203
01.07.19;WA96;Verschiedene Waren;341067;256320;84747
01.07.19;WA97;Kunstgegenstände, Sammlungsstücke;71155;181686;-110531
01.07.19;WA98;Vollständige Fabrikationsanlagen;156083;272;155811
01.07.19;WA99;Zusammenstellungen verschiedener Waren;1415255;1118571;296684
01.07.20;WA01;Lebende Tiere;84816;117935;-33119
01.07.20;WA02;Fleisch;547120;457460;89660
01.07.20;WA03;Fische, Krebs- und Weichtiere;107089;280334;-173245
01.07.20;WA04;Milch, Milcherzeugnisse, Eier, Honig;810667;671741;138926
01.07.20;WA05;Andere Waren tierischen Ursprungs;71276;75743;-4467
01.07.20;WA06;Pflanzen, Waren des Blumenhandels;52042;173177;-121135
01.07.20;WA07;Gemüse, Pflanzen für Ernährung;83513;452639;-369126
01.07.20;WA08;Geniessbare Früchte und Nüsse;183125;1005600;-822475
01.07.20;WA09;Kaffee, Tee, Mate, Gewürze;252022;316008;-63986
01.07.20;WA10;Getreide;137081;200653;-63572
01.07.20;WA11;Müllereierzeugnisse, Malz usw.;130208;55816;74392
01.07.20;WA12;Ölsamen usw., Heilpflanzen usw.;93916;386905;-292989
01.07.20;WA13;Schellack, Gummen, Harz, Pflanzensaft;52053;46816;5237
01.07.20;WA14;Flechtstoffe usw. pflanzlichen Ursprungs;737;4202;-3465
01.07.20;WA15;Tierische und pflanzliche Fette, Öle, Wachs;221239;300716;-79477
01.07.20;WA16;Zubereitungen von Fleisch, Fisch usw.;238289;259760;-21471
01.07.20;WA17;Zucker und Zuckerwaren;192340;136296;56044
01.07.20;WA18;Kakao und Zubereitungen aus Kakao;404718;399789;4929
01.07.20;WA19;Zubereitungen aus Getreide usw., Backwaren;565757;375412;190345
01.07.20;WA20;Zubereitungen von Gemüse, Früchten usw.;254673;408397;-153724
01.07.20;WA21;Verschiedene Lebensmittelzubereitungen;560482;332734;227748
01.07.20;WA22;Getränke, alkoholhaltige Flüssigkeiten, Essig;505647;639318;-133671
01.07.20;WA23;Rückstände der Lebensmittelindustrie, Futter;367977;323531;44446
01.07.20;WA24;Tabak;219545;225044;-5499
01.07.20;WA25;Salz, Schwefel, Steine, Erden usw.;155479;130572;24907
01.07.20;WA26;Erze, Schlacken, Aschen;29322;688901;-659579
01.07.20;WA27;Mineralische Brennstoffe usw.;1624068;4669121;-3045053
01.07.20;WA28;Anorganische chemische Erzeugnisse;861203;484201;377002
01.07.20;WA29;Organische chemische Erzeugnisse;1753301;2178016;-424715
01.07.20;WA30;Pharmazeutische Erzeugnisse;7903766;4922961;2980805
01.07.20;WA31;Düngemittel;165765;64709;101056
01.07.20;WA32;Gerb- und Farbstoffe, Farben, Lacke usw.;854928;487241;367687
01.07.20;WA33;Etherische Öle, Riech-, Schönheitsmittel;699778;494124;205654
01.07.20;WA34;Seifen, Waschmittel usw.;607580;333923;273657
01.07.20;WA35;Eiweissstoffe, Klebstoffe, Enzyme;305757;182575;123182
01.07.20;WA36;Sprengstoffe, pyrotechnische Artikel usw.;15140;32387;-17247
01.07.20;WA37;Photochemische Erzeugnisse;77191;48938;28253
01.07.20;WA38;Verschiedene Erzeugnisse der Chemischen Industrie;1864209;1220586;643623
01.07.20;WA39;Kunststoffe und Waren daraus;4674986;3013292;1661694
01.07.20;WA40;Kautschuk und Waren daraus;1143025;1034849;108176
01.07.20;WA41;Häute, Felle, Leder;42066;32856;9210
01.07.20;WA42;Lederwaren, Sattlerwaren;183788;330909;-147121
01.07.20;WA43;Pelzfelle, künstliches Pelzwerk;3641;6106;-2465
01.07.20;WA44;Holz, Holzwaren, Holzkohle;764879;630872;134007
01.07.20;WA45;Kork, Korkwaren;2666;5686;-3020
01.07.20;WA46;Flechtwaren, Korbmacherwaren;4881;12248;-7367
01.07.20;WA47;Halbstoffe aus Holz usw., Papierabfall;82531;217146;-134615
01.07.20;WA48;Papier, Pappe und Waren daraus;1389135;899593;489542
01.07.20;WA49;Bücher, Zeitungen, Bilddrucke usw.;295902;202317;93585
01.07.20;WA50;Seide;1892;1967;-75
01.07.20;WA51;Wolle, feine und grobe Tierhaare;25944;33738;-7794
01.07.20;WA52;Baumwolle;42154;56319;-14165
01.07.20;WA53;Andere pflanzliche Spinnstoffe, Papiergarn;2172;3832;-1660
01.07.20;WA54;Synthetisches oder künstliches Filament;108031;86098;21933
01.07.20;WA55;Synthetische oder künstliche Spinnfaser;118883;83936;34947
01.07.20;WA56;Watte, Filz, Vliesstoff usw., Tauwerk;204096;121143;82953
01.07.20;WA57;Teppiche, Fussbodenbelag aus Spinnstoff;41898;87283;-45385
01.07.20;WA58;Spezialgewebe, Spitzen, Tapisserien;38049;18720;19329
01.07.20;WA59;Getränkte, bestrichene usw. Gewebe;180851;82027;98824
01.07.20;WA60;Gewirke und Gestricke;49445;31369;18076
01.07.20;WA61;Bekleidung usw. aus Gewirken, Gestricken;772802;1420178;-647376
01.07.20;WA62;Andere Bekleidung, Bekleidungszubehör;757120;1429866;-672746
01.07.20;WA63;Andere Konfektion, Spinnstoffwaren usw.;336682;983503;-646821
01.07.20;WA64;Schuhe, Gamaschen, ähnliche Waren;713860;1043136;-329276
01.07.20;WA65;Kopfbedeckungen und Teile davon;40489;66584;-26095
01.07.20;WA66;Schirme, Gehstöcke usw., Peitschen;7330;18357;-11027
01.07.20;WA67;Zugerichtete Federn, Daunen, künstliche Blumen;13861;22993;-9132
01.07.20;WA68;Waren aus Steinen, Gips, Zement usw.;385706;256044;129662
01.07.20;WA69;Keramische Waren;270779;247149;23630
01.07.20;WA70;Glas und Glaswaren;536329;374781;161548
01.07.20;WA71;Perlen, Edelsteine, Edelmetalle;1590673;1882236;-291563
01.07.20;WA72;Eisen und Stahl;1466436;1512437;-46001
01.07.20;WA73;Waren aus Eisen oder Stahl;2070942;1634550;436392
01.07.20;WA74;Kupfer und Waren daraus;809279;728438;80841
01.07.20;WA75;Nickel und Waren daraus;101046;91370;9676
01.07.20;WA76;Aluminium und Waren daraus;1040876;1038638;2238
01.07.20;WA78;Blei und Waren daraus;29282;32607;-3325
01.07.20;WA79;Zink und Waren daraus;54348;90236;-35888
01.07.20;WA80;Zinn und Waren daraus;5134;16125;-10991
01.07.20;WA81;Andere unedle Metalle, Cermets usw.;81008;94894;-13886
01.07.20;WA82;Werkzeuge, Schneidwaren, Essbestecke;650400;413040;237360
01.07.20;WA83;Verschiedene Waren aus unedlen Metallen;592683;405570;187113
01.07.20;WA84;Maschinen, Apparate, mechanische Geräte;18040154;10858319;7181835
01.07.20;WA85;Elektrotechnische Erzeugnisse;11304673;10810072;494601
01.07.20;WA86;Schienenfahrzeuge;236503;227067;9436
01.07.20;WA87;Kraftfahrzeuge, Landfahrzeuge;16882272;8968834;7913438
01.07.20;WA88;Luftfahrzeuge, Raumfahrzeuge;1981269;828892;1152377
01.07.20;WA89;Wasserfahrzeuge;621548;75596;545952
01.07.20;WA90;Optische, photografische usw. Erzeugnisse;5569706;3099400;2470306
01.07.20;WA91;Uhrmacherwaren;113157;186656;-73499
01.07.20;WA92;Musikinstrumente;50127;53951;-3824
01.07.20;WA93;Waffen und Munition;42140;23112;19028
01.07.20;WA94;Möbel, Beleuchtungskörper usw.;1229642;1614048;-384406
01.07.20;WA95;Spielzeug, Spiele usw., Sportgeräte;390906;593725;-202819
01.07.20;WA96;Verschiedene Waren;320502;249885;70617
01.07.20;WA97;Kunstgegenstände, Sammlungsstücke;43215;107328;-64113
01.07.20;WA98;Vollständige Fabrikationsanlagen;98754;0;98754
01.07.20;WA99;Zusammenstellungen verschiedener Waren;1070501;1046152;24349
01.07.21;WA01;Lebende Tiere;99197;106172;-6975
01.07.21;WA02;Fleisch;482933;512850;-29917
01.07.21;WA03;Fische, Krebs- und Weichtiere;112867;292117;-179250
01.07.21;WA04;Milch, Milcherzeugnisse, Eier, Honig;895288;697350;197938
01.07.21;WA05;Andere Waren tierischen Ursprungs;76634;89274;-12640
01.07.21;WA06;Pflanzen, Waren des Blumenhandels;61418;216410;-154992
01.07.21;WA07;Gemüse, Pflanzen für Ernährung;91681;499374;-407693
01.07.21;WA08;Geniessbare Früchte und Nüsse;166301;997040;-830739
01.07.21;WA09;Kaffee, Tee, Mate, Gewürze;249500;327427;-77927
01.07.21;WA10;Getreide;143579;192860;-49281
01.07.21;WA11;Müllereierzeugnisse, Malz usw.;138105;67463;70642
01.07.21;WA12;Ölsamen usw., Heilpflanzen usw.;113044;383392;-270348
01.07.21;WA13;Schellack, Gummen, Harz, Pflanzensaft;56833;54322;2511
01.07.21;WA14;Flechtstoffe usw. pflanzlichen Ursprungs;760;3844;-3084
01.07.21;WA15;Tierische und pflanzliche Fette, Öle, Wachs;294879;385144;-90265
01.07.21;WA16;Zubereitungen von Fleisch, Fisch usw.;245401;243002;2399
01.07.21;WA17;Zucker und Zuckerwaren;228561;139292;89269
01.07.21;WA18;Kakao und Zubereitungen aus Kakao;432017;382461;49556
01.07.21;WA19;Zubereitungen aus Getreide usw., Backwaren;564320;401895;162425
01.07.21;WA20;Zubereitungen von Gemüse, Früchten usw.;240969;416461;-175492
01.07.21;WA21;Verschiedene Lebensmittelzubereitungen;606964;385775;221189
01.07.21;WA22;Getränke, alkoholhaltige Flüssigkeiten, Essig;571658;702677;-131019
01.07.21;WA23;Rückstände der Lebensmittelindustrie, Futter;448771;353556;95215
01.07.21;WA24;Tabak;204886;265331;-60445
01.07.21;WA25;Salz, Schwefel, Steine, Erden usw.;190463;160586;29877
01.07.21;WA26;Erze, Schlacken, Aschen;52465;945516;-893051
01.07.21;WA27;Mineralische Brennstoffe usw.;2166525;7767325;-5600800
01.07.21;WA28;Anorganische chemische Erzeugnisse;1078602;557977;520625
01.07.21;WA29;Organische chemische Erzeugnisse;2374925;2547462;-172537
01.07.21;WA30;Pharmazeutische Erzeugnisse;8857288;5428256;3429032
01.07.21;WA31;Düngemittel;191542;76720;114822
01.07.21;WA32;Gerb- und Farbstoffe, Farben, Lacke usw.;988886;510362;478524
01.07.21;WA33;Etherische Öle, Riech-, Schönheitsmittel;846004;615560;230444
01.07.21;WA34;Seifen, Waschmittel usw.;712553;360186;352367
01.07.21;WA35;Eiweissstoffe, Klebstoffe, Enzyme;364254;226391;137863
01.07.21;WA36;Sprengstoffe, pyrotechnische Artikel usw.;15808;11017;4791
01.07.21;WA37;Photochemische Erzeugnisse;97871;54257;43614
01.07.21;WA38;Verschiedene Erzeugnisse der Chemischen Industrie;2245025;1380143;864882
01.07.21;WA39;Kunststoffe und Waren daraus;6013309;4188355;1824954
01.07.21;WA40;Kautschuk und Waren daraus;1283382;1341274;-57892
01.07.21;WA41;Häute, Felle, Leder;55296;44132;11164
01.07.21;WA42;Lederwaren, Sattlerwaren;208399;320157;-111758
01.07.21;WA43;Pelzfelle, künstliches Pelzwerk;5924;9265;-3341
01.07.21;WA44;Holz, Holzwaren, Holzkohle;1073153;993320;79833
01.07.21;WA45;Kork, Korkwaren;2495;10831;-8336
01.07.21;WA46;Flechtwaren, Korbmacherwaren;5108;13092;-7984
01.07.21;WA47;Halbstoffe aus Holz usw., Papierabfall;108458;337059;-228601
01.07.21;WA48;Papier, Pappe und Waren daraus;1622917;1039087;583830
01.07.21;WA49;Bücher, Zeitungen, Bilddrucke usw.;315776;239243;76533
01.07.21;WA50;Seide;2016;2386;-370
01.07.21;WA51;Wolle, feine und grobe Tierhaare;30485;37235;-6750
01.07.21;WA52;Baumwolle;49245;57673;-8428
01.07.21;WA53;Andere pflanzliche Spinnstoffe, Papiergarn;2887;6080;-3193
01.07.21;WA54;Synthetisches oder künstliches Filament;122928;108779;14149
01.07.21;WA55;Synthetische oder künstliche Spinnfaser;137690;117878;19812
01.07.21;WA56;Watte, Filz, Vliesstoff usw., Tauwerk;228190;153958;74232
01.07.21;WA57;Teppiche, Fussbodenbelag aus Spinnstoff;45202;90593;-45391
01.07.21;WA58;Spezialgewebe, Spitzen, Tapisserien;39933;21064;18869
01.07.21;WA59;Getränkte, bestrichene usw. Gewebe;199094;99873;99221
01.07.21;WA60;Gewirke und Gestricke;56768;39436;17332
01.07.21;WA61;Bekleidung usw. aus Gewirken, Gestricken;905141;1594376;-689235
01.07.21;WA62;Andere Bekleidung, Bekleidungszubehör;798378;1316425;-518047
01.07.21;WA63;Andere Konfektion, Spinnstoffwaren usw.;291827;415592;-123765
01.07.21;WA64;Schuhe, Gamaschen, ähnliche Waren;670324;860330;-190006
01.07.21;WA65;Kopfbedeckungen und Teile davon;50110;68501;-18391
01.07.21;WA66;Schirme, Gehstöcke usw., Peitschen;10496;19550;-9054
01.07.21;WA67;Zugerichtete Federn, Daunen, künstliche Blumen;12337;18650;-6313
01.07.21;WA68;Waren aus Steinen, Gips, Zement usw.;468449;310825;157624
01.07.21;WA69;Keramische Waren;330877;274772;56105
01.07.21;WA70;Glas und Glaswaren;580719;433744;146975
01.07.21;WA71;Perlen, Edelsteine, Edelmetalle;1706398;2632423;-926025
01.07.21;WA72;Eisen und Stahl;2388347;2793503;-405156
01.07.21;WA73;Waren aus Eisen oder Stahl;2534328;2108146;426182
01.07.21;WA74;Kupfer und Waren daraus;1241301;1142174;99127
01.07.21;WA75;Nickel und Waren daraus;107174;134750;-27576
01.07.21;WA76;Aluminium und Waren daraus;1374750;1545469;-170719
01.07.21;WA78;Blei und Waren daraus;44103;47955;-3852
01.07.21;WA79;Zink und Waren daraus;68674;144640;-75966
01.07.21;WA80;Zinn und Waren daraus;12357;44914;-32557
01.07.21;WA81;Andere unedle Metalle, Cermets usw.;109389;129248;-19859
01.07.21;WA82;Werkzeuge, Schneidwaren, Essbestecke;721084;478341;242743
01.07.21;WA83;Verschiedene Waren aus unedlen Metallen;679126;445144;233982
01.07.21;WA84;Maschinen, Apparate, mechanische Geräte;19280138;12102987;7177151
01.07.21;WA85;Elektrotechnische Erzeugnisse;12378037;12199731;178306
01.07.21;WA86;Schienenfahrzeuge;320092;250157;69935
01.07.21;WA87;Kraftfahrzeuge, Landfahrzeuge;16702236;8902271;7799965
01.07.21;WA88;Luftfahrzeuge, Raumfahrzeuge;1613060;563031;1050029
01.07.21;WA89;Wasserfahrzeuge;813553;299586;513967
01.07.21;WA90;Optische, photografische usw. Erzeugnisse;6066545;3440342;2626203
01.07.21;WA91;Uhrmacherwaren;139362;204034;-64672
01.07.21;WA92;Musikinstrumente;57937;56012;1925
01.07.21;WA93;Waffen und Munition;59459;22741;36718
01.07.21;WA94;Möbel, Beleuchtungskörper usw.;1327055;1688239;-361184
01.07.21;WA95;Spielzeug, Spiele usw., Sportgeräte;425932;651114;-225182
01.07.21;WA96;Verschiedene Waren;346348;248562;97786
01.07.21;WA97;Kunstgegenstände, Sammlungsstücke;101855;91764;10091
01.07.21;WA98;Vollständige Fabrikationsanlagen;38946;NULL;#WERT!
01.07.21;WA99;Zusammenstellungen verschiedener Waren;1697548;887150;810398
01.07.22;WA01;Lebende Tiere;109170;101794;7376
01.07.22;WA02;Fleisch;641714;602665;39049
01.07.22;WA03;Fische, Krebs- und Weichtiere;147829;361695;-213866
01.07.22;WA04;Milch, Milcherzeugnisse, Eier, Honig;1086955;904291;182664
01.07.22;WA05;Andere Waren tierischen Ursprungs;80915;100115;-19200
01.07.22;WA06;Pflanzen, Waren des Blumenhandels;58067;196410;-138343
01.07.22;WA07;Gemüse, Pflanzen für Ernährung;105742;482450;-376708
01.07.22;WA08;Geniessbare Früchte und Nüsse;171500;1038705;-867205
01.07.22;WA09;Kaffee, Tee, Mate, Gewürze;309989;535931;-225942
01.07.22;WA10;Getreide;298466;305715;-7249
01.07.22;WA11;Müllereierzeugnisse, Malz usw.;173199;78285;94914
01.07.22;WA12;Ölsamen usw., Heilpflanzen usw.;152643;688115;-535472
01.07.22;WA13;Schellack, Gummen, Harz, Pflanzensaft;57351;65031;-7680
01.07.22;WA14;Flechtstoffe usw. pflanzlichen Ursprungs;957;3737;-2780
01.07.22;WA15;Tierische und pflanzliche Fette, Öle, Wachs;362922;599150;-236228
01.07.22;WA16;Zubereitungen von Fleisch, Fisch usw.;299378;309254;-9876
01.07.22;WA17;Zucker und Zuckerwaren;273987;160780;113207
01.07.22;WA18;Kakao und Zubereitungen aus Kakao;459163;376891;82272
01.07.22;WA19;Zubereitungen aus Getreide usw., Backwaren;664033;456541;207492
01.07.22;WA20;Zubereitungen von Gemüse, Früchten usw.;266577;482507;-215930
01.07.22;WA21;Verschiedene Lebensmittelzubereitungen;685642;423118;262524
01.07.22;WA22;Getränke, alkoholhaltige Flüssigkeiten, Essig;650749;849644;-198895
01.07.22;WA23;Rückstände der Lebensmittelindustrie, Futter;532917;481072;51845
01.07.22;WA24;Tabak;241304;267386;-26082
01.07.22;WA25;Salz, Schwefel, Steine, Erden usw.;199634;187043;12591
01.07.22;WA26;Erze, Schlacken, Aschen;76541;946064;-869523
01.07.22;WA27;Mineralische Brennstoffe usw.;5926904;19429055;-13502151
01.07.22;WA28;Anorganische chemische Erzeugnisse;1365447;725669;639778
01.07.22;WA29;Organische chemische Erzeugnisse;3231080;4050965;-819885
01.07.22;WA30;Pharmazeutische Erzeugnisse;8963238;6702561;2260677
01.07.22;WA31;Düngemittel;438151;189020;249131
01.07.22;WA32;Gerb- und Farbstoffe, Farben, Lacke usw.;1048690;549235;499455
01.07.22;WA33;Etherische Öle, Riech-, Schönheitsmittel;993259;678185;315074
01.07.22;WA34;Seifen, Waschmittel usw.;775511;436025;339486
01.07.22;WA35;Eiweissstoffe, Klebstoffe, Enzyme;407472;252267;155205
01.07.22;WA36;Sprengstoffe, pyrotechnische Artikel usw.;24153;15987;8166
01.07.22;WA37;Photochemische Erzeugnisse;88743;54979;33764
01.07.22;WA38;Verschiedene Erzeugnisse der Chemischen Industrie;2613197;1900900;712297
01.07.22;WA39;Kunststoffe und Waren daraus;6502505;4681351;1821154
01.07.22;WA40;Kautschuk und Waren daraus;1376157;1391368;-15211
01.07.22;WA41;Häute, Felle, Leder;60329;48854;11475
01.07.22;WA42;Lederwaren, Sattlerwaren;240930;403951;-163021
01.07.22;WA43;Pelzfelle, künstliches Pelzwerk;3564;7390;-3826
01.07.22;WA44;Holz, Holzwaren, Holzkohle;1015859;933442;82417
01.07.22;WA45;Kork, Korkwaren;2191;8829;-6638
01.07.22;WA46;Flechtwaren, Korbmacherwaren;6332;19261;-12929
01.07.22;WA47;Halbstoffe aus Holz usw., Papierabfall;127832;506776;-378944
01.07.22;WA48;Papier, Pappe und Waren daraus;2048724;1322607;726117
01.07.22;WA49;Bücher, Zeitungen, Bilddrucke usw.;297040;231649;65391
01.07.22;WA50;Seide;1285;1966;-681
01.07.22;WA51;Wolle, feine und grobe Tierhaare;40630;51238;-10608
01.07.22;WA52;Baumwolle;51072;71171;-20099
01.07.22;WA53;Andere pflanzliche Spinnstoffe, Papiergarn;2413;5737;-3324
01.07.22;WA54;Synthetisches oder künstliches Filament;135402;121396;14006
01.07.22;WA55;Synthetische oder künstliche Spinnfaser;131038;128924;2114
01.07.22;WA56;Watte, Filz, Vliesstoff usw., Tauwerk;228682;155444;73238
01.07.22;WA57;Teppiche, Fussbodenbelag aus Spinnstoff;38004;91793;-53789
01.07.22;WA58;Spezialgewebe, Spitzen, Tapisserien;42576;20765;21811
01.07.22;WA59;Getränkte, bestrichene usw. Gewebe;217906;100310;117596
01.07.22;WA60;Gewirke und Gestricke;57600;36745;20855
01.07.22;WA61;Bekleidung usw. aus Gewirken, Gestricken;1051260;1960743;-909483
01.07.22;WA62;Andere Bekleidung, Bekleidungszubehör;896314;1605057;-708743
01.07.22;WA63;Andere Konfektion, Spinnstoffwaren usw.;272201;451078;-178877
01.07.22;WA64;Schuhe, Gamaschen, ähnliche Waren;786580;1232712;-446132
01.07.22;WA65;Kopfbedeckungen und Teile davon;57436;85572;-28136
01.07.22;WA66;Schirme, Gehstöcke usw., Peitschen;11835;21213;-9378
01.07.22;WA67;Zugerichtete Federn, Daunen, künstliche Blumen;12691;26948;-14257
01.07.22;WA68;Waren aus Steinen, Gips, Zement usw.;454709;321480;133229
01.07.22;WA69;Keramische Waren;333439;308906;24533
01.07.22;WA70;Glas und Glaswaren;655318;465676;189642
01.07.22;WA71;Perlen, Edelsteine, Edelmetalle;1726151;2733846;-1007695
01.07.22;WA72;Eisen und Stahl;2800519;3343720;-543201
01.07.22;WA73;Waren aus Eisen oder Stahl;2640350;2574939;65411
01.07.22;WA74;Kupfer und Waren daraus;1149919;1171464;-21545
01.07.22;WA75;Nickel und Waren daraus;148994;205093;-56099
01.07.22;WA76;Aluminium und Waren daraus;1709894;2176305;-466411
01.07.22;WA78;Blei und Waren daraus;24318;42904;-18586
01.07.22;WA79;Zink und Waren daraus;72408;161870;-89462
01.07.22;WA80;Zinn und Waren daraus;15117;46266;-31149
01.07.22;WA81;Andere unedle Metalle, Cermets usw.;160067;207753;-47686
01.07.22;WA82;Werkzeuge, Schneidwaren, Essbestecke;754459;514569;239890
01.07.22;WA83;Verschiedene Waren aus unedlen Metallen;686164;480823;205341
01.07.22;WA84;Maschinen, Apparate, mechanische Geräte;20195375;13400705;6794670
01.07.22;WA85;Elektrotechnische Erzeugnisse;13866365;15362339;-1495974
01.07.22;WA86;Schienenfahrzeuge;218756;427174;-208418
01.07.22;WA87;Kraftfahrzeuge, Landfahrzeuge;19447223;9738137;9709086
01.07.22;WA88;Luftfahrzeuge, Raumfahrzeuge;2055176;686863;1368313
01.07.22;WA89;Wasserfahrzeuge;319619;498799;-179180
01.07.22;WA90;Optische, photografische usw. Erzeugnisse;6147867;3560037;2587830
01.07.22;WA91;Uhrmacherwaren;153866;230952;-77086
01.07.22;WA92;Musikinstrumente;70445;58748;11697
01.07.22;WA93;Waffen und Munition;51484;29161;22323
01.07.22;WA94;Möbel, Beleuchtungskörper usw.;1354844;1708085;-353241
01.07.22;WA95;Spielzeug, Spiele usw., Sportgeräte;450872;740458;-289586
01.07.22;WA96;Verschiedene Waren;355881;296742;59139
01.07.22;WA97;Kunstgegenstände, Sammlungsstücke;59049;71404;-12355
01.07.22;WA98;Vollständige Fabrikationsanlagen;27780;NULL;#WERT!
01.07.22;WA99;Zusammenstellungen verschiedener Waren;1426491;886942;539549
01.07.23;WA01;Lebende Tiere;124374;156979;-32605
01.07.23;WA02;Fleisch;637139;623287;13852
01.07.23;WA03;Fische, Krebs- und Weichtiere;118381;318544;-200163
01.07.23;WA04;Milch, Milcherzeugnisse, Eier, Honig;987451;828339;159112
01.07.23;WA05;Andere Waren tierischen Ursprungs;72836;100946;-28110
01.07.23;WA06;Pflanzen, Waren des Blumenhandels;56753;182661;-125908
01.07.23;WA07;Gemüse, Pflanzen für Ernährung;131614;531995;-400381
01.07.23;WA08;Geniessbare Früchte und Nüsse;167701;1046115;-878414
01.07.23;WA09;Kaffee, Tee, Mate, Gewürze;304938;413975;-109037
01.07.23;WA10;Getreide;275361;307984;-32623
01.07.23;WA11;Müllereierzeugnisse, Malz usw.;195688;86086;109602
01.07.23;WA12;Ölsamen usw., Heilpflanzen usw.;145560;435504;-289944
01.07.23;WA13;Schellack, Gummen, Harz, Pflanzensaft;52532;53942;-1410
01.07.23;WA14;Flechtstoffe usw. pflanzlichen Ursprungs;1133;4246;-3113
01.07.23;WA15;Tierische und pflanzliche Fette, Öle, Wachs;322309;388583;-66274
01.07.23;WA16;Zubereitungen von Fleisch, Fisch usw.;308893;305908;2985
01.07.23;WA17;Zucker und Zuckerwaren;284925;219621;65304
01.07.23;WA18;Kakao und Zubereitungen aus Kakao;535072;424879;110193
01.07.23;WA19;Zubereitungen aus Getreide usw., Backwaren;762832;530036;232796
01.07.23;WA20;Zubereitungen von Gemüse, Früchten usw.;285195;517725;-232530
01.07.23;WA21;Verschiedene Lebensmittelzubereitungen;741499;487479;254020
01.07.23;WA22;Getränke, alkoholhaltige Flüssigkeiten, Essig;629585;847018;-217433
01.07.23;WA23;Rückstände der Lebensmittelindustrie, Futter;584522;516755;67767
01.07.23;WA24;Tabak;271157;496367;-225210
01.07.23;WA25;Salz, Schwefel, Steine, Erden usw.;192388;167329;25059
01.07.23;WA26;Erze, Schlacken, Aschen;61681;853771;-792090
01.07.23;WA27;Mineralische Brennstoffe usw.;2467565;9649470;-7181905
01.07.23;WA28;Anorganische chemische Erzeugnisse;1046974;709907;337067
01.07.23;WA29;Organische chemische Erzeugnisse;2408433;3764762;-1356329
01.07.23;WA30;Pharmazeutische Erzeugnisse;9758490;5703731;4054759
01.07.23;WA31;Düngemittel;219114;86341;132773
01.07.23;WA32;Gerb- und Farbstoffe, Farben, Lacke usw.;964558;464390;500168
01.07.23;WA33;Etherische Öle, Riech-, Schönheitsmittel;1043256;766833;276423
01.07.23;WA34;Seifen, Waschmittel usw.;714584;433841;280743
01.07.23;WA35;Eiweissstoffe, Klebstoffe, Enzyme;364680;226343;138337
01.07.23;WA36;Sprengstoffe, pyrotechnische Artikel usw.;25044;30684;-5640
01.07.23;WA37;Photochemische Erzeugnisse;82592;51141;31451
01.07.23;WA38;Verschiedene Erzeugnisse der Chemischen Industrie;2486692;1671960;814732
01.07.23;WA39;Kunststoffe und Waren daraus;5457934;3725521;1732413
01.07.23;WA40;Kautschuk und Waren daraus;1355590;1256688;98902
01.07.23;WA41;Häute, Felle, Leder;51853;45310;6543
01.07.23;WA42;Lederwaren, Sattlerwaren;260508;403197;-142689
01.07.23;WA43;Pelzfelle, künstliches Pelzwerk;4523;7869;-3346
01.07.23;WA44;Holz, Holzwaren, Holzkohle;791191;667846;123345
01.07.23;WA45;Kork, Korkwaren;1926;6539;-4613
01.07.23;WA46;Flechtwaren, Korbmacherwaren;5653;11610;-5957
01.07.23;WA47;Halbstoffe aus Holz usw., Papierabfall;121152;273594;-152442
01.07.23;WA48;Papier, Pappe und Waren daraus;1650568;1114667;535901
01.07.23;WA49;Bücher, Zeitungen, Bilddrucke usw.;264149;204225;59924
01.07.23;WA50;Seide;1556;3345;-1789
01.07.23;WA51;Wolle, feine und grobe Tierhaare;32175;40625;-8450
01.07.23;WA52;Baumwolle;46076;51597;-5521
01.07.23;WA53;Andere pflanzliche Spinnstoffe, Papiergarn;2337;3962;-1625
01.07.23;WA54;Synthetisches oder künstliches Filament;129431;105140;24291
01.07.23;WA55;Synthetische oder künstliche Spinnfaser;121072;109612;11460
01.07.23;WA56;Watte, Filz, Vliesstoff usw., Tauwerk;217907;142019;75888
01.07.23;WA57;Teppiche, Fussbodenbelag aus Spinnstoff;45358;85224;-39866
01.07.23;WA58;Spezialgewebe, Spitzen, Tapisserien;43470;20902;22568
01.07.23;WA59;Getränkte, bestrichene usw. Gewebe;216672;108748;107924
01.07.23;WA60;Gewirke und Gestricke;55803;33438;22365
01.07.23;WA61;Bekleidung usw. aus Gewirken, Gestricken;1081336;1790792;-709456
01.07.23;WA62;Andere Bekleidung, Bekleidungszubehör;986033;1562176;-576143
01.07.23;WA63;Andere Konfektion, Spinnstoffwaren usw.;272452;373176;-100724
01.07.23;WA64;Schuhe, Gamaschen, ähnliche Waren;901246;1118282;-217036
01.07.23;WA65;Kopfbedeckungen und Teile davon;63264;79557;-16293
01.07.23;WA66;Schirme, Gehstöcke usw., Peitschen;9704;17755;-8051
01.07.23;WA67;Zugerichtete Federn, Daunen, künstliche Blumen;12223;24957;-12734
01.07.23;WA68;Waren aus Steinen, Gips, Zement usw.;440301;309111;131190
01.07.23;WA69;Keramische Waren;311164;241654;69510
01.07.23;WA70;Glas und Glaswaren;626647;475799;150848
01.07.23;WA71;Perlen, Edelsteine, Edelmetalle;1756261;1625322;130939
01.07.23;WA72;Eisen und Stahl;2287803;2400895;-113092
01.07.23;WA73;Waren aus Eisen oder Stahl;2705323;2260439;444884
01.07.23;WA74;Kupfer und Waren daraus;1103605;924707;178898
01.07.23;WA75;Nickel und Waren daraus;162354;187364;-25010
01.07.23;WA76;Aluminium und Waren daraus;1474665;1778789;-304124
01.07.23;WA78;Blei und Waren daraus;37518;47022;-9504
01.07.23;WA79;Zink und Waren daraus;54342;136523;-82181
01.07.23;WA80;Zinn und Waren daraus;10941;36008;-25067
01.07.23;WA81;Andere unedle Metalle, Cermets usw.;128363;186549;-58186
01.07.23;WA82;Werkzeuge, Schneidwaren, Essbestecke;750473;475502;274971
01.07.23;WA83;Verschiedene Waren aus unedlen Metallen;669641;447892;221749
01.07.23;WA84;Maschinen, Apparate, mechanische Geräte;21030410;13428564;7601846
01.07.23;WA85;Elektrotechnische Erzeugnisse;14230809;16173191;-1942382
01.07.23;WA86;Schienenfahrzeuge;197704;357762;-160058
01.07.23;WA87;Kraftfahrzeuge, Landfahrzeuge;21977805;12389493;9588312
01.07.23;WA88;Luftfahrzeuge, Raumfahrzeuge;2725735;605414;2120321
01.07.23;WA89;Wasserfahrzeuge;278004;238076;39928
01.07.23;WA90;Optische, photografische usw. Erzeugnisse;6317126;3716693;2600433
01.07.23;WA91;Uhrmacherwaren;154949;222757;-67808
01.07.23;WA92;Musikinstrumente;69162;58254;10908
01.07.23;WA93;Waffen und Munition;55381;30070;25311
01.07.23;WA94;Möbel, Beleuchtungskörper usw.;1336150;1565090;-228940
01.07.23;WA95;Spielzeug, Spiele usw., Sportgeräte;407799;675312;-267513
01.07.23;WA96;Verschiedene Waren;356587;290176;66411
01.07.23;WA97;Kunstgegenstände, Sammlungsstücke;80059;62080;17979
01.07.23;WA98;Vollständige Fabrikationsanlagen;107510;1835;105675
01.07.23;WA99;Zusammenstellungen verschiedener Waren;1321840;1068387;253453
01.07.24;WA01;Lebende Tiere;123644;154152;-30508
01.07.24;WA02;Fleisch;641479;633293;8186
01.07.24;WA03;Fische, Krebs- und Weichtiere;128475;336284;-207809
01.07.24;WA04;Milch, Milcherzeugnisse, Eier, Honig;1082210;960887;121323
01.07.24;WA05;Andere Waren tierischen Ursprungs;75650;93637;-17987
01.07.24;WA06;Pflanzen, Waren des Blumenhandels;55900;186654;-130754
01.07.24;WA07;Gemüse, Pflanzen für Ernährung;151765;589321;-437556
01.07.24;WA08;Geniessbare Früchte und Nüsse;173494;1175047;-1001553
01.07.24;WA09;Kaffee, Tee, Mate, Gewürze;370616;537992;-167376
01.07.24;WA10;Getreide;284293;304358;-20065
01.07.24;WA11;Müllereierzeugnisse, Malz usw.;183831;86484;97347
01.07.24;WA12;Ölsamen usw., Heilpflanzen usw.;150665;510924;-360259
01.07.24;WA13;Schellack, Gummen, Harz, Pflanzensaft;56587;57971;-1384
01.07.24;WA14;Flechtstoffe usw. pflanzlichen Ursprungs;993;4277;-3284
01.07.24;WA15;Tierische und pflanzliche Fette, Öle, Wachs;292571;454388;-161817
01.07.24;WA16;Zubereitungen von Fleisch, Fisch usw.;319747;313284;6463
01.07.24;WA17;Zucker und Zuckerwaren;360840;225683;135157
01.07.24;WA18;Kakao und Zubereitungen aus Kakao;810836;836882;-26046
01.07.24;WA19;Zubereitungen aus Getreide usw., Backwaren;838694;610543;228151
01.07.24;WA20;Zubereitungen von Gemüse, Früchten usw.;320794;628905;-308111
01.07.24;WA21;Verschiedene Lebensmittelzubereitungen;882593;523694;358899
01.07.24;WA22;Getränke, alkoholhaltige Flüssigkeiten, Essig;699322;811438;-112116
01.07.24;WA23;Rückstände der Lebensmittelindustrie, Futter;588118;491989;96129
01.07.24;WA24;Tabak;303998;513708;-209710
01.07.24;WA25;Salz, Schwefel, Steine, Erden usw.;220769;182863;37906
01.07.24;WA26;Erze, Schlacken, Aschen;74941;814153;-739212
01.07.24;WA27;Mineralische Brennstoffe usw.;2780401;9181571;-6401170
01.07.24;WA28;Anorganische chemische Erzeugnisse;1085429;816853;268576
01.07.24;WA29;Organische chemische Erzeugnisse;2375897;4471337;-2095440
01.07.24;WA30;Pharmazeutische Erzeugnisse;10339469;7158470;3180999
01.07.24;WA31;Düngemittel;211786;115284;96502
01.07.24;WA32;Gerb- und Farbstoffe, Farben, Lacke usw.;1028447;519701;508746
01.07.24;WA33;Etherische Öle, Riech-, Schönheitsmittel;1054600;848017;206583
01.07.24;WA34;Seifen, Waschmittel usw.;817764;492025;325739
01.07.24;WA35;Eiweissstoffe, Klebstoffe, Enzyme;426327;272322;154005
01.07.24;WA36;Sprengstoffe, pyrotechnische Artikel usw.;28220;34250;-6030
01.07.24;WA37;Photochemische Erzeugnisse;82145;56442;25703
01.07.24;WA38;Verschiedene Erzeugnisse der Chemischen Industrie;2751175;1823310;927865
01.07.24;WA39;Kunststoffe und Waren daraus;5963772;4088197;1875575
01.07.24;WA40;Kautschuk und Waren daraus;1397503;1298440;99063
01.07.24;WA41;Häute, Felle, Leder;46431;41417;5014
01.07.24;WA42;Lederwaren, Sattlerwaren;272953;428614;-155661
01.07.24;WA43;Pelzfelle, künstliches Pelzwerk;3101;6985;-3884
01.07.24;WA44;Holz, Holzwaren, Holzkohle;822309;703533;118776
01.07.24;WA45;Kork, Korkwaren;2470;7840;-5370
01.07.24;WA46;Flechtwaren, Korbmacherwaren;5514;11228;-5714
01.07.24;WA47;Halbstoffe aus Holz usw., Papierabfall;128656;434657;-306001
01.07.24;WA48;Papier, Pappe und Waren daraus;1785480;1173249;612231
01.07.24;WA49;Bücher, Zeitungen, Bilddrucke usw.;267395;209983;57412
01.07.24;WA50;Seide;1908;4505;-2597
01.07.24;WA51;Wolle, feine und grobe Tierhaare;28818;36056;-7238
01.07.24;WA52;Baumwolle;40170;54161;-13991
01.07.24;WA53;Andere pflanzliche Spinnstoffe, Papiergarn;2319;5554;-3235
01.07.24;WA54;Synthetisches oder künstliches Filament;131037;117463;13574
01.07.24;WA55;Synthetische oder künstliche Spinnfaser;122018;119678;2340
01.07.24;WA56;Watte, Filz, Vliesstoff usw., Tauwerk;234035;156843;77192
01.07.24;WA57;Teppiche, Fussbodenbelag aus Spinnstoff;51391;92688;-41297
01.07.24;WA58;Spezialgewebe, Spitzen, Tapisserien;43893;22758;21135
01.07.24;WA59;Getränkte, bestrichene usw. Gewebe;231535;112297;119238
01.07.24;WA60;Gewirke und Gestricke;55988;34895;21093
01.07.24;WA61;Bekleidung usw. aus Gewirken, Gestricken;1105826;1899044;-793218
01.07.24;WA62;Andere Bekleidung, Bekleidungszubehör;1016669;1607541;-590872
01.07.24;WA63;Andere Konfektion, Spinnstoffwaren usw.;281259;401858;-120599
01.07.24;WA64;Schuhe, Gamaschen, ähnliche Waren;982399;1111110;-128711
01.07.24;WA65;Kopfbedeckungen und Teile davon;65658;89522;-23864
01.07.24;WA66;Schirme, Gehstöcke usw., Peitschen;9687;18367;-8680
01.07.24;WA67;Zugerichtete Federn, Daunen, künstliche Blumen;11698;25417;-13719
01.07.24;WA68;Waren aus Steinen, Gips, Zement usw.;478254;331651;146603
01.07.24;WA69;Keramische Waren;309246;266361;42885
01.07.24;WA70;Glas und Glaswaren;646679;483805;162874
01.07.24;WA71;Perlen, Edelsteine, Edelmetalle;2001159;1818922;182237
01.07.24;WA72;Eisen und Stahl;2398501;2482652;-84151
01.07.24;WA73;Waren aus Eisen oder Stahl;2784856;2251886;532970
01.07.24;WA74;Kupfer und Waren daraus;1306611;974955;331656
01.07.24;WA75;Nickel und Waren daraus;185243;169529;15714
01.07.24;WA76;Aluminium und Waren daraus;1574379;1806011;-231632
01.07.24;WA78;Blei und Waren daraus;41507;56479;-14972
01.07.24;WA79;Zink und Waren daraus;72330;132736;-60406
01.07.24;WA80;Zinn und Waren daraus;11212;40428;-29216
01.07.24;WA81;Andere unedle Metalle, Cermets usw.;142568;201153;-58585
01.07.24;WA82;Werkzeuge, Schneidwaren, Essbestecke;794457;517919;276538
01.07.24;WA83;Verschiedene Waren aus unedlen Metallen;696695;498482;198213
01.07.24;WA84;Maschinen, Apparate, mechanische Geräte;21938184;13731995;8206189
01.07.24;WA85;Elektrotechnische Erzeugnisse;14144342;15585653;-1441311
01.07.24;WA86;Schienenfahrzeuge;206114;256805;-50691
01.07.24;WA87;Kraftfahrzeuge, Landfahrzeuge;21919935;10456968;11462967
01.07.24;WA88;Luftfahrzeuge, Raumfahrzeuge;2657702;566763;2090939
01.07.24;WA89;Wasserfahrzeuge;157862;175627;-17765
01.07.24;WA90;Optische, photografische usw. Erzeugnisse;6805007;3968994;2836013
01.07.24;WA91;Uhrmacherwaren;171818;230896;-59078
01.07.24;WA92;Musikinstrumente;74940;57173;17767
01.07.24;WA93;Waffen und Munition;59133;27339;31794
01.07.24;WA94;Möbel, Beleuchtungskörper usw.;1399874;1676935;-277061
01.07.24;WA95;Spielzeug, Spiele usw., Sportgeräte;392686;563528;-170842
01.07.24;WA96;Verschiedene Waren;360186;324919;35267
01.07.24;WA97;Kunstgegenstände, Sammlungsstücke;83594;60802;22792
01.07.24;WA98;Vollständige Fabrikationsanlagen;44229;NULL;#WERT!
01.07.24;WA99;Zusammenstellungen verschiedener Waren;2026163;1093532;932631
01.07.25;WA01;Lebende Tiere;NULL;NULL;#WERT!
01.07.25;WA02;Fleisch;NULL;NULL;#WERT!
01.07.25;WA03;Fische, Krebs- und Weichtiere;NULL;NULL;#WERT!
01.07.25;WA04;Milch, Milcherzeugnisse, Eier, Honig;NULL;NULL;#WERT!
01.07.25;WA05;Andere Waren tierischen Ursprungs;NULL;NULL;#WERT!
01.07.25;WA06;Pflanzen, Waren des Blumenhandels;NULL;NULL;#WERT!
01.07.25;WA07;Gemüse, Pflanzen für Ernährung;NULL;NULL;#WERT!
01.07.25;WA08;Geniessbare Früchte und Nüsse;NULL;NULL;#WERT!
01.07.25;WA09;Kaffee, Tee, Mate, Gewürze;NULL;NULL;#WERT!
01.07.25;WA10;Getreide;NULL;NULL;#WERT!
01.07.25;WA11;Müllereierzeugnisse, Malz usw.;NULL;NULL;#WERT!
01.07.25;WA12;Ölsamen usw., Heilpflanzen usw.;NULL;NULL;#WERT!
01.07.25;WA13;Schellack, Gummen, Harz, Pflanzensaft;NULL;NULL;#WERT!
01.07.25;WA14;Flechtstoffe usw. pflanzlichen Ursprungs;NULL;NULL;#WERT!
01.07.25;WA15;Tierische und pflanzliche Fette, Öle, Wachs;NULL;NULL;#WERT!
01.07.25;WA16;Zubereitungen von Fleisch, Fisch usw.;NULL;NULL;#WERT!
01.07.25;WA17;Zucker und Zuckerwaren;NULL;NULL;#WERT!
01.07.25;WA18;Kakao und Zubereitungen aus Kakao;NULL;NULL;#WERT!
01.07.25;WA19;Zubereitungen aus Getreide usw., Backwaren;NULL;NULL;#WERT!
01.07.25;WA20;Zubereitungen von Gemüse, Früchten usw.;NULL;NULL;#WERT!
01.07.25;WA21;Verschiedene Lebensmittelzubereitungen;NULL;NULL;#WERT!
01.07.25;WA22;Getränke, alkoholhaltige Flüssigkeiten, Essig;NULL;NULL;#WERT!
01.07.25;WA23;Rückstände der Lebensmittelindustrie, Futter;NULL;NULL;#WERT!
01.07.25;WA24;Tabak;NULL;NULL;#WERT!
01.07.25;WA25;Salz, Schwefel, Steine, Erden usw.;NULL;NULL;#WERT!
01.07.25;WA26;Erze, Schlacken, Aschen;NULL;NULL;#WERT!
01.07.25;WA27;Mineralische Brennstoffe usw.;NULL;NULL;#WERT!
01.07.25;WA28;Anorganische chemische Erzeugnisse;NULL;NULL;#WERT!
01.07.25;WA29;Organische chemische Erzeugnisse;NULL;NULL;#WERT!
01.07.25;WA30;Pharmazeutische Erzeugnisse;NULL;NULL;#WERT!
01.07.25;WA31;Düngemittel;NULL;NULL;#WERT!
01.07.25;WA32;Gerb- und Farbstoffe, Farben, Lacke usw.;NULL;NULL;#WERT!
01.07.25;WA33;Etherische Öle, Riech-, Schönheitsmittel;NULL;NULL;#WERT!
01.07.25;WA34;Seifen, Waschmittel usw.;NULL;NULL;#WERT!
01.07.25;WA35;Eiweissstoffe, Klebstoffe, Enzyme;NULL;NULL;#WERT!
01.07.25;WA36;Sprengstoffe, pyrotechnische Artikel usw.;NULL;NULL;#WERT!
01.07.25;WA37;Photochemische Erzeugnisse;NULL;NULL;#WERT!
01.07.25;WA38;Verschiedene Erzeugnisse der Chemischen Industrie;NULL;NULL;#WERT!
01.07.25;WA39;Kunststoffe und Waren daraus;NULL;NULL;#WERT!
01.07.25;WA40;Kautschuk und Waren daraus;NULL;NULL;#WERT!
01.07.25;WA41;Häute, Felle, Leder;NULL;NULL;#WERT!
01.07.25;WA42;Lederwaren, Sattlerwaren;NULL;NULL;#WERT!
01.07.25;WA43;Pelzfelle, künstliches Pelzwerk;NULL;NULL;#WERT!
01.07.25;WA44;Holz, Holzwaren, Holzkohle;NULL;NULL;#WERT!
01.07.25;WA45;Kork, Korkwaren;NULL;NULL;#WERT!
01.07.25;WA46;Flechtwaren, Korbmacherwaren;NULL;NULL;#WERT!
01.07.25;WA47;Halbstoffe aus Holz usw., Papierabfall;NULL;NULL;#WERT!
01.07.25;WA48;Papier, Pappe und Waren daraus;NULL;NULL;#WERT!
01.07.25;WA49;Bücher, Zeitungen, Bilddrucke usw.;NULL;NULL;#WERT!
01.07.25;WA50;Seide;NULL;NULL;#WERT!
01.07.25;WA51;Wolle, feine und grobe Tierhaare;NULL;NULL;#WERT!
01.07.25;WA52;Baumwolle;NULL;NULL;#WERT!
01.07.25;WA53;Andere pflanzliche Spinnstoffe, Papiergarn;NULL;NULL;#WERT!
01.07.25;WA54;Synthetisches oder künstliches Filament;NULL;NULL;#WERT!
01.07.25;WA55;Synthetische oder künstliche Spinnfaser;NULL;NULL;#WERT!
01.07.25;WA56;Watte, Filz, Vliesstoff usw., Tauwerk;NULL;NULL;#WERT!
01.07.25;WA57;Teppiche, Fussbodenbelag aus Spinnstoff;NULL;NULL;#WERT!
01.07.25;WA58;Spezialgewebe, Spitzen, Tapisserien;NULL;NULL;#WERT!
01.07.25;WA59;Getränkte, bestrichene usw. Gewebe;NULL;NULL;#WERT!
01.07.25;WA60;Gewirke und Gestricke;NULL;NULL;#WERT!
01.07.25;WA61;Bekleidung usw. aus Gewirken, Gestricken;NULL;NULL;#WERT!
01.07.25;WA62;Andere Bekleidung, Bekleidungszubehör;NULL;NULL;#WERT!
01.07.25;WA63;Andere Konfektion, Spinnstoffwaren usw.;NULL;NULL;#WERT!
01.07.25;WA64;Schuhe, Gamaschen, ähnliche Waren;NULL;NULL;#WERT!
01.07.25;WA65;Kopfbedeckungen und Teile davon;NULL;NULL;#WERT!
01.07.25;WA66;Schirme, Gehstöcke usw., Peitschen;NULL;NULL;#WERT!
01.07.25;WA67;Zugerichtete Federn, Daunen, künstliche Blumen;NULL;NULL;#WERT!
01.07.25;WA68;Waren aus Steinen, Gips, Zement usw.;NULL;NULL;#WERT!
01.07.25;WA69;Keramische Waren;NULL;NULL;#WERT!
01.07.25;WA70;Glas und Glaswaren;NULL;NULL;#WERT!
01.07.25;WA71;Perlen, Edelsteine, Edelmetalle;NULL;NULL;#WERT!
01.07.25;WA72;Eisen und Stahl;NULL;NULL;#WERT!
01.07.25;WA73;Waren aus Eisen oder Stahl;NULL;NULL;#WERT!
01.07.25;WA74;Kupfer und Waren daraus;NULL;NULL;#WERT!
01.07.25;WA75;Nickel und Waren daraus;NULL;NULL;#WERT!
01.07.25;WA76;Aluminium und Waren daraus;NULL;NULL;#WERT!
01.07.25;WA78;Blei und Waren daraus;NULL;NULL;#WERT!
01.07.25;WA79;Zink und Waren daraus;NULL;NULL;#WERT!
01.07.25;WA80;Zinn und Waren daraus;NULL;NULL;#WERT!
01.07.25;WA81;Andere unedle Metalle, Cermets usw.;NULL;NULL;#WERT!
01.07.25;WA82;Werkzeuge, Schneidwaren, Essbestecke;NULL;NULL;#WERT!
01.07.25;WA83;Verschiedene Waren aus unedlen Metallen;NULL;NULL;#WERT!
01.07.25;WA84;Maschinen, Apparate, mechanische Geräte;NULL;NULL;#WERT!
01.07.25;WA85;Elektrotechnische Erzeugnisse;NULL;NULL;#WERT!
01.07.25;WA86;Schienenfahrzeuge;NULL;NULL;#WERT!
01.07.25;WA87;Kraftfahrzeuge, Landfahrzeuge;NULL;NULL;#WERT!
01.07.25;WA88;Luftfahrzeuge, Raumfahrzeuge;NULL;NULL;#WERT!
01.07.25;WA89;Wasserfahrzeuge;NULL;NULL;#WERT!
01.07.25;WA90;Optische, photografische usw. Erzeugnisse;NULL;NULL;#WERT!
01.07.25;WA91;Uhrmacherwaren;NULL;NULL;#WERT!
01.07.25;WA92;Musikinstrumente;NULL;NULL;#WERT!
01.07.25;WA93;Waffen und Munition;NULL;NULL;#WERT!
01.07.25;WA94;Möbel, Beleuchtungskörper usw.;NULL;NULL;#WERT!
01.07.25;WA95;Spielzeug, Spiele usw., Sportgeräte;NULL;NULL;#WERT!
01.07.25;WA96;Verschiedene Waren;NULL;NULL;#WERT!
01.07.25;WA97;Kunstgegenstände, Sammlungsstücke;NULL;NULL;#WERT!
01.07.25;WA98;Vollständige Fabrikationsanlagen;NULL;NULL;#WERT!
01.07.25;WA99;Zusammenstellungen verschiedener Waren;NULL;NULL;#WERT!
01.08.08;WA01;Lebende Tiere;74808;147969;-73161
01.08.08;WA02;Fleisch;515041;430859;84182
01.08.08;WA03;Fische, Krebs- und Weichtiere;71577;174044;-102467
01.08.08;WA04;Milch, Milcherzeugnisse, Eier, Honig;594193;449661;144532
01.08.08;WA05;Andere Waren tierischen Ursprungs;50702;57694;-6992
01.08.08;WA06;Pflanzen, Waren des Blumenhandels;35400;170865;-135465
01.08.08;WA07;Gemüse, Pflanzen für Ernährung;66534;249455;-182921
01.08.08;WA08;Geniessbare Früchte und Nüsse;91132;519256;-428124
01.08.08;WA09;Kaffee, Tee, Mate, Gewürze;117331;206736;-89405
01.08.08;WA10;Getreide;141387;117767;23620
01.08.08;WA11;Müllereierzeugnisse, Malz usw.;89404;42348;47056
01.08.08;WA12;Ölsamen usw., Heilpflanzen usw.;76439;311286;-234847
01.08.08;WA13;Schellack, Gummen, Harz, Pflanzensaft;34562;24922;9640
01.08.08;WA14;Flechtstoffe usw. pflanzlichen Ursprungs;1255;1827;-572
01.08.08;WA15;Tierische und pflanzliche Fette, Öle, Wachs;155321;302821;-147500
01.08.08;WA16;Zubereitungen von Fleisch, Fisch usw.;216841;155307;61534
01.08.08;WA17;Zucker und Zuckerwaren;102178;107006;-4828
01.08.08;WA18;Kakao und Zubereitungen aus Kakao;203938;186743;17195
01.08.08;WA19;Zubereitungen aus Getreide usw., Backwaren;387448;193783;193665
01.08.08;WA20;Zubereitungen von Gemüse, Früchten usw.;175911;328165;-152254
01.08.08;WA21;Verschiedene Lebensmittelzubereitungen;298932;192494;106438
01.08.08;WA22;Getränke, alkoholhaltige Flüssigkeiten, Essig;380400;367239;13161
01.08.08;WA23;Rückstände der Lebensmittelindustrie, Futter;208211;212907;-4696
01.08.08;WA24;Tabak;264793;110858;153935
01.08.08;WA25;Salz, Schwefel, Steine, Erden usw.;184219;158259;25960
01.08.08;WA26;Erze, Schlacken, Aschen;22904;555434;-532530
01.08.08;WA27;Mineralische Brennstoffe usw.;1983527;10292081;-8308554
01.08.08;WA28;Anorganische chemische Erzeugnisse;615905;500346;115559
01.08.08;WA29;Organische chemische Erzeugnisse;2232649;1938437;294212
01.08.08;WA30;Pharmazeutische Erzeugnisse;3562179;2289983;1272196
01.08.08;WA31;Düngemittel;257764;145774;111990
01.08.08;WA32;Gerb- und Farbstoffe, Farben, Lacke usw.;657459;289554;367905
01.08.08;WA33;Etherische Öle, Riech-, Schönheitsmittel;526150;353673;172477
01.08.08;WA34;Seifen, Waschmittel usw.;402876;180323;222553
01.08.08;WA35;Eiweissstoffe, Klebstoffe, Enzyme;160579;119924;40655
01.08.08;WA36;Sprengstoffe, pyrotechnische Artikel usw.;15440;19845;-4405
01.08.08;WA37;Photochemische Erzeugnisse;83610;59394;24216
01.08.08;WA38;Verschiedene Erzeugnisse der Chemischen Industrie;1161603;817614;343989
01.08.08;WA39;Kunststoffe und Waren daraus;3601727;2248977;1352750
01.08.08;WA40;Kautschuk und Waren daraus;779547;764600;14947
01.08.08;WA41;Häute, Felle, Leder;42255;43123;-868
01.08.08;WA42;Lederwaren, Sattlerwaren;125084;204027;-78943
01.08.08;WA43;Pelzfelle, künstliches Pelzwerk;17125;15677;1448
01.08.08;WA44;Holz, Holzwaren, Holzkohle;552780;401020;151760
01.08.08;WA45;Kork, Korkwaren;3519;8919;-5400
01.08.08;WA46;Flechtwaren, Korbmacherwaren;3752;10091;-6339
01.08.08;WA47;Halbstoffe aus Holz usw., Papierabfall;82188;255388;-173200
01.08.08;WA48;Papier, Pappe und Waren daraus;1463471;958867;504604
01.08.08;WA49;Bücher, Zeitungen, Bilddrucke usw.;415576;177397;238179
01.08.08;WA50;Seide;4252;4624;-372
01.08.08;WA51;Wolle, feine und grobe Tierhaare;41928;41572;356
01.08.08;WA52;Baumwolle;63892;61247;2645
01.08.08;WA53;Andere pflanzliche Spinnstoffe, Papiergarn;2436;5252;-2816
01.08.08;WA54;Synthetisches oder künstliches Filament;159035;109242;49793
01.08.08;WA55;Synthetische oder künstliche Spinnfaser;122129;101681;20448
01.08.08;WA56;Watte, Filz, Vliesstoff usw., Tauwerk;150115;83817;66298
01.08.08;WA57;Teppiche, Fussbodenbelag aus Spinnstoff;42410;62361;-19951
01.08.08;WA58;Spezialgewebe, Spitzen, Tapisserien;35438;24545;10893
01.08.08;WA59;Getränkte, bestrichene usw. Gewebe;131182;95803;35379
01.08.08;WA60;Gewirke und Gestricke;49682;26462;23220
01.08.08;WA61;Bekleidung usw. aus Gewirken, Gestricken;563962;985425;-421463
01.08.08;WA62;Andere Bekleidung, Bekleidungszubehör;778164;1105931;-327767
01.08.08;WA63;Andere Konfektion, Spinnstoffwaren usw.;122044;196297;-74253
01.08.08;WA64;Schuhe, Gamaschen, ähnliche Waren;301057;506543;-205486
01.08.08;WA65;Kopfbedeckungen und Teile davon;23910;29215;-5305
01.08.08;WA66;Schirme, Gehstöcke usw., Peitschen;9010;10080;-1070
01.08.08;WA67;Zugerichtete Federn, Daunen, künstliche Blumen;5192;13170;-7978
01.08.08;WA68;Waren aus Steinen, Gips, Zement usw.;311487;189318;122169
01.08.08;WA69;Keramische Waren;242615;169808;72807
01.08.08;WA70;Glas und Glaswaren;412031;295522;116509
01.08.08;WA71;Perlen, Edelsteine, Edelmetalle;725955;726386;-431
01.08.08;WA72;Eisen und Stahl;2282579;2534271;-251692
01.08.08;WA73;Waren aus Eisen oder Stahl;2057696;1328727;728969
01.08.08;WA74;Kupfer und Waren daraus;712073;843761;-131688
01.08.08;WA75;Nickel und Waren daraus;87729;144328;-56599
01.08.08;WA76;Aluminium und Waren daraus;993791;1079584;-85793
01.08.08;WA78;Blei und Waren daraus;31654;13627;18027
01.08.08;WA79;Zink und Waren daraus;40832;76631;-35799
01.08.08;WA80;Zinn und Waren daraus;10660;37453;-26793
01.08.08;WA81;Andere unedle Metalle, Cermets usw.;127033;133203;-6170
01.08.08;WA82;Werkzeuge, Schneidwaren, Essbestecke;450571;309814;140757
01.08.08;WA83;Verschiedene Waren aus unedlen Metallen;501311;285069;216242
01.08.08;WA84;Maschinen, Apparate, mechanische Geräte;13987576;7689115;6298461
01.08.08;WA85;Elektrotechnische Erzeugnisse;7843659;6436553;1407106
01.08.08;WA86;Schienenfahrzeuge;230370;139950;90420
01.08.08;WA87;Kraftfahrzeuge, Landfahrzeuge;10026575;4359537;5667038
01.08.08;WA88;Luftfahrzeuge, Raumfahrzeuge;1460961;1134024;326937
01.08.08;WA89;Wasserfahrzeuge;468257;793181;-324924
01.08.08;WA90;Optische, photografische usw. Erzeugnisse;2867272;1567504;1299768
01.08.08;WA91;Uhrmacherwaren;80979;79722;1257
01.08.08;WA92;Musikinstrumente;26675;26964;-289
01.08.08;WA93;Waffen und Munition;28307;12185;16122
01.08.08;WA94;Möbel, Beleuchtungskörper usw.;938939;872207;66732
01.08.08;WA95;Spielzeug, Spiele usw., Sportgeräte;480398;582018;-101620
01.08.08;WA96;Verschiedene Waren;129093;91307;37786
01.08.08;WA97;Kunstgegenstände, Sammlungsstücke;36275;20912;15363
01.08.08;WA98;Vollständige Fabrikationsanlagen;310301;3007;307294
01.08.08;WA99;Zusammenstellungen verschiedener Waren;1042294;736906;305388
01.08.09;WA01;Lebende Tiere;96098;127723;-31625
01.08.09;WA02;Fleisch;513348;394077;119271
01.08.09;WA03;Fische, Krebs- und Weichtiere;80639;189025;-108386
01.08.09;WA04;Milch, Milcherzeugnisse, Eier, Honig;500664;422185;78479
01.08.09;WA05;Andere Waren tierischen Ursprungs;40948;49315;-8367
01.08.09;WA06;Pflanzen, Waren des Blumenhandels;37693;159251;-121558
01.08.09;WA07;Gemüse, Pflanzen für Ernährung;63471;242953;-179482
01.08.09;WA08;Geniessbare Früchte und Nüsse;81926;473611;-391685
01.08.09;WA09;Kaffee, Tee, Mate, Gewürze;109304;178939;-69635
01.08.09;WA10;Getreide;152393;111451;40942
01.08.09;WA11;Müllereierzeugnisse, Malz usw.;71975;37447;34528
01.08.09;WA12;Ölsamen usw., Heilpflanzen usw.;58795;287169;-228374
01.08.09;WA13;Schellack, Gummen, Harz, Pflanzensaft;32642;26750;5892
01.08.09;WA14;Flechtstoffe usw. pflanzlichen Ursprungs;500;2011;-1511
01.08.09;WA15;Tierische und pflanzliche Fette, Öle, Wachs;128676;226894;-98218
01.08.09;WA16;Zubereitungen von Fleisch, Fisch usw.;172515;157138;15377
01.08.09;WA17;Zucker und Zuckerwaren;115921;106805;9116
01.08.09;WA18;Kakao und Zubereitungen aus Kakao;237675;237032;643
01.08.09;WA19;Zubereitungen aus Getreide usw., Backwaren;339704;184832;154872
01.08.09;WA20;Zubereitungen von Gemüse, Früchten usw.;154655;280573;-125918
01.08.09;WA21;Verschiedene Lebensmittelzubereitungen;276936;196611;80325
01.08.09;WA22;Getränke, alkoholhaltige Flüssigkeiten, Essig;347619;402090;-54471
01.08.09;WA23;Rückstände der Lebensmittelindustrie, Futter;215525;210922;4603
01.08.09;WA24;Tabak;288830;142249;146581
01.08.09;WA25;Salz, Schwefel, Steine, Erden usw.;131715;116837;14878
01.08.09;WA26;Erze, Schlacken, Aschen;14029;508478;-494449
01.08.09;WA27;Mineralische Brennstoffe usw.;1435503;6435995;-5000492
01.08.09;WA28;Anorganische chemische Erzeugnisse;490501;356350;134151
01.08.09;WA29;Organische chemische Erzeugnisse;1396774;1460420;-63646
01.08.09;WA30;Pharmazeutische Erzeugnisse;3356803;2515746;841057
01.08.09;WA31;Düngemittel;97541;63970;33571
01.08.09;WA32;Gerb- und Farbstoffe, Farben, Lacke usw.;567195;265241;301954
01.08.09;WA33;Etherische Öle, Riech-, Schönheitsmittel;524421;290727;233694
01.08.09;WA34;Seifen, Waschmittel usw.;368262;167914;200348
01.08.09;WA35;Eiweissstoffe, Klebstoffe, Enzyme;154836;109104;45732
01.08.09;WA36;Sprengstoffe, pyrotechnische Artikel usw.;13925;18658;-4733
01.08.09;WA37;Photochemische Erzeugnisse;85026;50745;34281
01.08.09;WA38;Verschiedene Erzeugnisse der Chemischen Industrie;971251;665503;305748
01.08.09;WA39;Kunststoffe und Waren daraus;2835754;1714897;1120857
01.08.09;WA40;Kautschuk und Waren daraus;698484;654324;44160
01.08.09;WA41;Häute, Felle, Leder;36379;35622;757
01.08.09;WA42;Lederwaren, Sattlerwaren;112748;179421;-66673
01.08.09;WA43;Pelzfelle, künstliches Pelzwerk;12573;9937;2636
01.08.09;WA44;Holz, Holzwaren, Holzkohle;482720;360320;122400
01.08.09;WA45;Kork, Korkwaren;3478;7152;-3674
01.08.09;WA46;Flechtwaren, Korbmacherwaren;3922;9021;-5099
01.08.09;WA47;Halbstoffe aus Holz usw., Papierabfall;73420;177863;-104443
01.08.09;WA48;Papier, Pappe und Waren daraus;1242815;811319;431496
01.08.09;WA49;Bücher, Zeitungen, Bilddrucke usw.;374968;155910;219058
01.08.09;WA50;Seide;2938;3270;-332
01.08.09;WA51;Wolle, feine und grobe Tierhaare;31799;26066;5733
01.08.09;WA52;Baumwolle;49150;47875;1275
01.08.09;WA53;Andere pflanzliche Spinnstoffe, Papiergarn;1867;3892;-2025
01.08.09;WA54;Synthetisches oder künstliches Filament;109615;76612;33003
01.08.09;WA55;Synthetische oder künstliche Spinnfaser;111448;82300;29148
01.08.09;WA56;Watte, Filz, Vliesstoff usw., Tauwerk;128723;68941;59782
01.08.09;WA57;Teppiche, Fussbodenbelag aus Spinnstoff;35378;67113;-31735
01.08.09;WA58;Spezialgewebe, Spitzen, Tapisserien;29926;17747;12179
01.08.09;WA59;Getränkte, bestrichene usw. Gewebe;101482;74904;26578
01.08.09;WA60;Gewirke und Gestricke;39284;21452;17832
01.08.09;WA61;Bekleidung usw. aus Gewirken, Gestricken;539030;1028528;-489498
01.08.09;WA62;Andere Bekleidung, Bekleidungszubehör;677465;1099011;-421546
01.08.09;WA63;Andere Konfektion, Spinnstoffwaren usw.;121134;189834;-68700
01.08.09;WA64;Schuhe, Gamaschen, ähnliche Waren;265799;497424;-231625
01.08.09;WA65;Kopfbedeckungen und Teile davon;21930;29863;-7933
01.08.09;WA66;Schirme, Gehstöcke usw., Peitschen;5191;9957;-4766
01.08.09;WA67;Zugerichtete Federn, Daunen, künstliche Blumen;4628;10490;-5862
01.08.09;WA68;Waren aus Steinen, Gips, Zement usw.;218972;149188;69784
01.08.09;WA69;Keramische Waren;190101;138432;51669
01.08.09;WA70;Glas und Glaswaren;349489;253542;95947
01.08.09;WA71;Perlen, Edelsteine, Edelmetalle;533552;547939;-14387
01.08.09;WA72;Eisen und Stahl;1277181;976484;300697
01.08.09;WA73;Waren aus Eisen oder Stahl;1508654;908752;599902
01.08.09;WA74;Kupfer und Waren daraus;545884;504392;41492
01.08.09;WA75;Nickel und Waren daraus;41117;63222;-22105
01.08.09;WA76;Aluminium und Waren daraus;720686;663300;57386
01.08.09;WA78;Blei und Waren daraus;32682;19916;12766
01.08.09;WA79;Zink und Waren daraus;34385;56935;-22550
01.08.09;WA80;Zinn und Waren daraus;5014;14537;-9523
01.08.09;WA81;Andere unedle Metalle, Cermets usw.;39312;54094;-14782
01.08.09;WA82;Werkzeuge, Schneidwaren, Essbestecke;348693;213278;135415
01.08.09;WA83;Verschiedene Waren aus unedlen Metallen;414078;225400;188678
01.08.09;WA84;Maschinen, Apparate, mechanische Geräte;10772710;5836241;4936469
01.08.09;WA85;Elektrotechnische Erzeugnisse;5990255;5612745;377510
01.08.09;WA86;Schienenfahrzeuge;253660;120267;133393
01.08.09;WA87;Kraftfahrzeuge, Landfahrzeuge;7736790;3616974;4119816
01.08.09;WA88;Luftfahrzeuge, Raumfahrzeuge;1756196;1629543;126653
01.08.09;WA89;Wasserfahrzeuge;145726;444255;-298529
01.08.09;WA90;Optische, photografische usw. Erzeugnisse;2576165;1494258;1081907
01.08.09;WA91;Uhrmacherwaren;64772;78940;-14168
01.08.09;WA92;Musikinstrumente;24976;36169;-11193
01.08.09;WA93;Waffen und Munition;36486;10534;25952
01.08.09;WA94;Möbel, Beleuchtungskörper usw.;773335;778111;-4776
01.08.09;WA95;Spielzeug, Spiele usw., Sportgeräte;320310;434951;-114641
01.08.09;WA96;Verschiedene Waren;115794;73878;41916
01.08.09;WA97;Kunstgegenstände, Sammlungsstücke;30914;12386;18528
01.08.09;WA98;Vollständige Fabrikationsanlagen;290169;7280;282889
01.08.09;WA99;Zusammenstellungen verschiedener Waren;1059848;769763;290085
01.08.10;WA01;Lebende Tiere;87585;130809;-43224
01.08.10;WA02;Fleisch;529662;414413;115249
01.08.10;WA03;Fische, Krebs- und Weichtiere;73670;223154;-149484
01.08.10;WA04;Milch, Milcherzeugnisse, Eier, Honig;600648;480725;119923
01.08.10;WA05;Andere Waren tierischen Ursprungs;44982;53593;-8611
01.08.10;WA06;Pflanzen, Waren des Blumenhandels;39481;175291;-135810
01.08.10;WA07;Gemüse, Pflanzen für Ernährung;74686;325402;-250716
01.08.10;WA08;Geniessbare Früchte und Nüsse;96376;561992;-465616
01.08.10;WA09;Kaffee, Tee, Mate, Gewürze;156987;274520;-117533
01.08.10;WA10;Getreide;112615;161388;-48773
01.08.10;WA11;Müllereierzeugnisse, Malz usw.;63853;33209;30644
01.08.10;WA12;Ölsamen usw., Heilpflanzen usw.;77079;282260;-205181
01.08.10;WA13;Schellack, Gummen, Harz, Pflanzensaft;31587;32638;-1051
01.08.10;WA14;Flechtstoffe usw. pflanzlichen Ursprungs;789;1893;-1104
01.08.10;WA15;Tierische und pflanzliche Fette, Öle, Wachs;163733;288921;-125188
01.08.10;WA16;Zubereitungen von Fleisch, Fisch usw.;185142;156139;29003
01.08.10;WA17;Zucker und Zuckerwaren;115876;103549;12327
01.08.10;WA18;Kakao und Zubereitungen aus Kakao;295094;257746;37348
01.08.10;WA19;Zubereitungen aus Getreide usw., Backwaren;363108;189513;173595
01.08.10;WA20;Zubereitungen von Gemüse, Früchten usw.;168895;305096;-136201
01.08.10;WA21;Verschiedene Lebensmittelzubereitungen;302410;203350;99060
01.08.10;WA22;Getränke, alkoholhaltige Flüssigkeiten, Essig;421956;450901;-28945
01.08.10;WA23;Rückstände der Lebensmittelindustrie, Futter;215563;200249;15314
01.08.10;WA24;Tabak;303689;131187;172502
01.08.10;WA25;Salz, Schwefel, Steine, Erden usw.;149478;167063;-17585
01.08.10;WA26;Erze, Schlacken, Aschen;24362;677443;-653081
01.08.10;WA27;Mineralische Brennstoffe usw.;1514607;8155032;-6640425
01.08.10;WA28;Anorganische chemische Erzeugnisse;685494;532645;152849
01.08.10;WA29;Organische chemische Erzeugnisse;1705631;1736969;-31338
01.08.10;WA30;Pharmazeutische Erzeugnisse;4139238;2770540;1368698
01.08.10;WA31;Düngemittel;160228;105371;54857
01.08.10;WA32;Gerb- und Farbstoffe, Farben, Lacke usw.;698624;354969;343655
01.08.10;WA33;Etherische Öle, Riech-, Schönheitsmittel;608322;391220;217102
01.08.10;WA34;Seifen, Waschmittel usw.;427272;227060;200212
01.08.10;WA35;Eiweissstoffe, Klebstoffe, Enzyme;179424;135775;43649
01.08.10;WA36;Sprengstoffe, pyrotechnische Artikel usw.;13600;20289;-6689
01.08.10;WA37;Photochemische Erzeugnisse;101357;56093;45264
01.08.10;WA38;Verschiedene Erzeugnisse der Chemischen Industrie;1301234;808984;492250
01.08.10;WA39;Kunststoffe und Waren daraus;3699068;2330351;1368717
01.08.10;WA40;Kautschuk und Waren daraus;930905;943117;-12212
01.08.10;WA41;Häute, Felle, Leder;69068;55533;13535
01.08.10;WA42;Lederwaren, Sattlerwaren;129175;246806;-117631
01.08.10;WA43;Pelzfelle, künstliches Pelzwerk;14564;14665;-101
01.08.10;WA44;Holz, Holzwaren, Holzkohle;522953;462375;60578
01.08.10;WA45;Kork, Korkwaren;2402;7161;-4759
01.08.10;WA46;Flechtwaren, Korbmacherwaren;3300;11066;-7766
01.08.10;WA47;Halbstoffe aus Holz usw., Papierabfall;86799;377930;-291131
01.08.10;WA48;Papier, Pappe und Waren daraus;1551787;935310;616477
01.08.10;WA49;Bücher, Zeitungen, Bilddrucke usw.;401289;152275;249014
01.08.10;WA50;Seide;3014;4013;-999
01.08.10;WA51;Wolle, feine und grobe Tierhaare;31697;48819;-17122
01.08.10;WA52;Baumwolle;58011;64310;-6299
01.08.10;WA53;Andere pflanzliche Spinnstoffe, Papiergarn;2284;5113;-2829
01.08.10;WA54;Synthetisches oder künstliches Filament;137833;100267;37566
01.08.10;WA55;Synthetische oder künstliche Spinnfaser;124517;99075;25442
01.08.10;WA56;Watte, Filz, Vliesstoff usw., Tauwerk;148134;76996;71138
01.08.10;WA57;Teppiche, Fussbodenbelag aus Spinnstoff;36179;69285;-33106
01.08.10;WA58;Spezialgewebe, Spitzen, Tapisserien;33473;21121;12352
01.08.10;WA59;Getränkte, bestrichene usw. Gewebe;131735;79329;52406
01.08.10;WA60;Gewirke und Gestricke;51573;27974;23599
01.08.10;WA61;Bekleidung usw. aus Gewirken, Gestricken;622700;1303041;-680341
01.08.10;WA62;Andere Bekleidung, Bekleidungszubehör;725945;1308081;-582136
01.08.10;WA63;Andere Konfektion, Spinnstoffwaren usw.;141141;233153;-92012
01.08.10;WA64;Schuhe, Gamaschen, ähnliche Waren;309347;610072;-300725
01.08.10;WA65;Kopfbedeckungen und Teile davon;25759;43895;-18136
01.08.10;WA66;Schirme, Gehstöcke usw., Peitschen;5609;11829;-6220
01.08.10;WA67;Zugerichtete Federn, Daunen, künstliche Blumen;6549;17152;-10603
01.08.10;WA68;Waren aus Steinen, Gips, Zement usw.;262389;177014;85375
01.08.10;WA69;Keramische Waren;215784;177872;37912
01.08.10;WA70;Glas und Glaswaren;381577;307118;74459
01.08.10;WA71;Perlen, Edelsteine, Edelmetalle;927734;1029438;-101704
01.08.10;WA72;Eisen und Stahl;1695128;1730141;-35013
01.08.10;WA73;Waren aus Eisen oder Stahl;1699454;1166637;532817
01.08.10;WA74;Kupfer und Waren daraus;861123;783190;77933
01.08.10;WA75;Nickel und Waren daraus;71962;156417;-84455
01.08.10;WA76;Aluminium und Waren daraus;831361;978072;-146711
01.08.10;WA78;Blei und Waren daraus;35596;21567;14029
01.08.10;WA79;Zink und Waren daraus;46515;101210;-54695
01.08.10;WA80;Zinn und Waren daraus;6740;26210;-19470
01.08.10;WA81;Andere unedle Metalle, Cermets usw.;85265;93528;-8263
01.08.10;WA82;Werkzeuge, Schneidwaren, Essbestecke;442508;280070;162438
01.08.10;WA83;Verschiedene Waren aus unedlen Metallen;481223;288658;192565
01.08.10;WA84;Maschinen, Apparate, mechanische Geräte;13315152;7853828;5461324
01.08.10;WA85;Elektrotechnische Erzeugnisse;8255925;7654860;601065
01.08.10;WA86;Schienenfahrzeuge;269484;144825;124659
01.08.10;WA87;Kraftfahrzeuge, Landfahrzeuge;9885598;4075250;5810348
01.08.10;WA88;Luftfahrzeuge, Raumfahrzeuge;1674996;1345643;329353
01.08.10;WA89;Wasserfahrzeuge;407360;1007725;-600365
01.08.10;WA90;Optische, photografische usw. Erzeugnisse;3449686;1829004;1620682
01.08.10;WA91;Uhrmacherwaren;77877;119758;-41881
01.08.10;WA92;Musikinstrumente;33423;43805;-10382
01.08.10;WA93;Waffen und Munition;27088;12405;14683
01.08.10;WA94;Möbel, Beleuchtungskörper usw.;851591;944242;-92651
01.08.10;WA95;Spielzeug, Spiele usw., Sportgeräte;326805;386772;-59967
01.08.10;WA96;Verschiedene Waren;141833;105939;35894
01.08.10;WA97;Kunstgegenstände, Sammlungsstücke;43716;18728;24988
01.08.10;WA98;Vollständige Fabrikationsanlagen;334481;3369;331112
01.08.10;WA99;Zusammenstellungen verschiedener Waren;1012984;837158;175826
01.08.11;WA01;Lebende Tiere;106847;121536;-14689
01.08.11;WA02;Fleisch;620773;467979;152794
01.08.11;WA03;Fische, Krebs- und Weichtiere;91755;222260;-130505
01.08.11;WA04;Milch, Milcherzeugnisse, Eier, Honig;698197;530039;168158
01.08.11;WA05;Andere Waren tierischen Ursprungs;60135;72780;-12645
01.08.11;WA06;Pflanzen, Waren des Blumenhandels;49161;191772;-142611
01.08.11;WA07;Gemüse, Pflanzen für Ernährung;62465;280329;-217864
01.08.11;WA08;Geniessbare Früchte und Nüsse;99278;529724;-430446
01.08.11;WA09;Kaffee, Tee, Mate, Gewürze;195055;391997;-196942
01.08.11;WA10;Getreide;112075;187951;-75876
01.08.11;WA11;Müllereierzeugnisse, Malz usw.;73117;42998;30119
01.08.11;WA12;Ölsamen usw., Heilpflanzen usw.;85963;417040;-331077
01.08.11;WA13;Schellack, Gummen, Harz, Pflanzensaft;34999;30981;4018
01.08.11;WA14;Flechtstoffe usw. pflanzlichen Ursprungs;769;2003;-1234
01.08.11;WA15;Tierische und pflanzliche Fette, Öle, Wachs;199927;416502;-216575
01.08.11;WA16;Zubereitungen von Fleisch, Fisch usw.;205319;178269;27050
01.08.11;WA17;Zucker und Zuckerwaren;116158;137916;-21758
01.08.11;WA18;Kakao und Zubereitungen aus Kakao;307657;293370;14287
01.08.11;WA19;Zubereitungen aus Getreide usw., Backwaren;402731;211970;190761
01.08.11;WA20;Zubereitungen von Gemüse, Früchten usw.;168840;339008;-170168
01.08.11;WA21;Verschiedene Lebensmittelzubereitungen;344579;196280;148299
01.08.11;WA22;Getränke, alkoholhaltige Flüssigkeiten, Essig;402172;498374;-96202
01.08.11;WA23;Rückstände der Lebensmittelindustrie, Futter;239719;234102;5617
01.08.11;WA24;Tabak;360645;160339;200306
01.08.11;WA25;Salz, Schwefel, Steine, Erden usw.;179730;168942;10788
01.08.11;WA26;Erze, Schlacken, Aschen;25770;772317;-746547
01.08.11;WA27;Mineralische Brennstoffe usw.;1903611;9879532;-7975921
01.08.11;WA28;Anorganische chemische Erzeugnisse;782217;614054;168163
01.08.11;WA29;Organische chemische Erzeugnisse;1905459;2239908;-334449
01.08.11;WA30;Pharmazeutische Erzeugnisse;4189712;3004957;1184755
01.08.11;WA31;Düngemittel;183634;137675;45959
01.08.11;WA32;Gerb- und Farbstoffe, Farben, Lacke usw.;762780;393095;369685
01.08.11;WA33;Etherische Öle, Riech-, Schönheitsmittel;669648;439502;230146
01.08.11;WA34;Seifen, Waschmittel usw.;485693;274713;210980
01.08.11;WA35;Eiweissstoffe, Klebstoffe, Enzyme;210388;159127;51261
01.08.11;WA36;Sprengstoffe, pyrotechnische Artikel usw.;15089;22880;-7791
01.08.11;WA37;Photochemische Erzeugnisse;75536;54523;21013
01.08.11;WA38;Verschiedene Erzeugnisse der Chemischen Industrie;1404240;987499;416741
01.08.11;WA39;Kunststoffe und Waren daraus;3963940;2589977;1373963
01.08.11;WA40;Kautschuk und Waren daraus;1178361;1231207;-52846
01.08.11;WA41;Häute, Felle, Leder;72123;65747;6376
01.08.11;WA42;Lederwaren, Sattlerwaren;147734;285988;-138254
01.08.11;WA43;Pelzfelle, künstliches Pelzwerk;21804;21480;324
01.08.11;WA44;Holz, Holzwaren, Holzkohle;534949;518607;16342
01.08.11;WA45;Kork, Korkwaren;2818;5106;-2288
01.08.11;WA46;Flechtwaren, Korbmacherwaren;3824;12413;-8589
01.08.11;WA47;Halbstoffe aus Holz usw., Papierabfall;104800;339585;-234785
01.08.11;WA48;Papier, Pappe und Waren daraus;1575849;1001102;574747
01.08.11;WA49;Bücher, Zeitungen, Bilddrucke usw.;352087;173612;178475
01.08.11;WA50;Seide;3389;3874;-485
01.08.11;WA51;Wolle, feine und grobe Tierhaare;43321;59674;-16353
01.08.11;WA52;Baumwolle;72799;75069;-2270
01.08.11;WA53;Andere pflanzliche Spinnstoffe, Papiergarn;2754;6468;-3714
01.08.11;WA54;Synthetisches oder künstliches Filament;150318;111028;39290
01.08.11;WA55;Synthetische oder künstliche Spinnfaser;143164;114831;28333
01.08.11;WA56;Watte, Filz, Vliesstoff usw., Tauwerk;174324;99318;75006
01.08.11;WA57;Teppiche, Fussbodenbelag aus Spinnstoff;41035;77424;-36389
01.08.11;WA58;Spezialgewebe, Spitzen, Tapisserien;36785;22230;14555
01.08.11;WA59;Getränkte, bestrichene usw. Gewebe;152054;84820;67234
01.08.11;WA60;Gewirke und Gestricke;55706;31375;24331
01.08.11;WA61;Bekleidung usw. aus Gewirken, Gestricken;708802;1478797;-769995
01.08.11;WA62;Andere Bekleidung, Bekleidungszubehör;805200;1524701;-719501
01.08.11;WA63;Andere Konfektion, Spinnstoffwaren usw.;175219;279556;-104337
01.08.11;WA64;Schuhe, Gamaschen, ähnliche Waren;437331;774342;-337011
01.08.11;WA65;Kopfbedeckungen und Teile davon;27437;46690;-19253
01.08.11;WA66;Schirme, Gehstöcke usw., Peitschen;7550;13973;-6423
01.08.11;WA67;Zugerichtete Federn, Daunen, künstliche Blumen;9086;18449;-9363
01.08.11;WA68;Waren aus Steinen, Gips, Zement usw.;280444;216339;64105
01.08.11;WA69;Keramische Waren;230205;185040;45165
01.08.11;WA70;Glas und Glaswaren;413924;318604;95320
01.08.11;WA71;Perlen, Edelsteine, Edelmetalle;1558631;1853531;-294900
01.08.11;WA72;Eisen und Stahl;1972950;2082022;-109072
01.08.11;WA73;Waren aus Eisen oder Stahl;2332653;1415590;917063
01.08.11;WA74;Kupfer und Waren daraus;989329;1005908;-16579
01.08.11;WA75;Nickel und Waren daraus;89714;147480;-57766
01.08.11;WA76;Aluminium und Waren daraus;1043060;1199287;-156227
01.08.11;WA78;Blei und Waren daraus;44917;22363;22554
01.08.11;WA79;Zink und Waren daraus;47088;111137;-64049
01.08.11;WA80;Zinn und Waren daraus;9470;39691;-30221
01.08.11;WA81;Andere unedle Metalle, Cermets usw.;104873;127053;-22180
01.08.11;WA82;Werkzeuge, Schneidwaren, Essbestecke;498607;339014;159593
01.08.11;WA83;Verschiedene Waren aus unedlen Metallen;525453;301677;223776
01.08.11;WA84;Maschinen, Apparate, mechanische Geräte;15251306;8718010;6533296
01.08.11;WA85;Elektrotechnische Erzeugnisse;8610109;8022431;587678
01.08.11;WA86;Schienenfahrzeuge;202798;120270;82528
01.08.11;WA87;Kraftfahrzeuge, Landfahrzeuge;13032516;4643087;8389429
01.08.11;WA88;Luftfahrzeuge, Raumfahrzeuge;1958907;1185017;773890
01.08.11;WA89;Wasserfahrzeuge;78701;326012;-247311
01.08.11;WA90;Optische, photografische usw. Erzeugnisse;3905326;2080438;1824888
01.08.11;WA91;Uhrmacherwaren;113552;149449;-35897
01.08.11;WA92;Musikinstrumente;38346;41826;-3480
01.08.11;WA93;Waffen und Munition;27830;15319;12511
01.08.11;WA94;Möbel, Beleuchtungskörper usw.;1005670;1063756;-58086
01.08.11;WA95;Spielzeug, Spiele usw., Sportgeräte;316131;400314;-84183
01.08.11;WA96;Verschiedene Waren;156456;115156;41300
01.08.11;WA97;Kunstgegenstände, Sammlungsstücke;41336;19748;21588
01.08.11;WA98;Vollständige Fabrikationsanlagen;390905;1664;389241
01.08.11;WA99;Zusammenstellungen verschiedener Waren;1147911;876688;271223
01.08.12;WA01;Lebende Tiere;129181;157253;-28072
01.08.12;WA02;Fleisch;723757;489654;234103
01.08.12;WA03;Fische, Krebs- und Weichtiere;90150;244435;-154285
01.08.12;WA04;Milch, Milcherzeugnisse, Eier, Honig;663717;490020;173697
01.08.12;WA05;Andere Waren tierischen Ursprungs;50868;73325;-22457
01.08.12;WA06;Pflanzen, Waren des Blumenhandels;46376;180944;-134568
01.08.12;WA07;Gemüse, Pflanzen für Ernährung;75645;304379;-228734
01.08.12;WA08;Geniessbare Früchte und Nüsse;101186;617574;-516388
01.08.12;WA09;Kaffee, Tee, Mate, Gewürze;206825;370445;-163620
01.08.12;WA10;Getreide;158395;176245;-17850
01.08.12;WA11;Müllereierzeugnisse, Malz usw.;94942;42880;52062
01.08.12;WA12;Ölsamen usw., Heilpflanzen usw.;88934;447445;-358511
01.08.12;WA13;Schellack, Gummen, Harz, Pflanzensaft;40151;37007;3144
01.08.12;WA14;Flechtstoffe usw. pflanzlichen Ursprungs;564;1697;-1133
01.08.12;WA15;Tierische und pflanzliche Fette, Öle, Wachs;258287;256827;1460
01.08.12;WA16;Zubereitungen von Fleisch, Fisch usw.;218978;190583;28395
01.08.12;WA17;Zucker und Zuckerwaren;156132;136983;19149
01.08.12;WA18;Kakao und Zubereitungen aus Kakao;325942;253716;72226
01.08.12;WA19;Zubereitungen aus Getreide usw., Backwaren;421173;225850;195323
01.08.12;WA20;Zubereitungen von Gemüse, Früchten usw.;164174;337703;-173529
01.08.12;WA21;Verschiedene Lebensmittelzubereitungen;360763;200010;160753
01.08.12;WA22;Getränke, alkoholhaltige Flüssigkeiten, Essig;419682;553844;-134162
01.08.12;WA23;Rückstände der Lebensmittelindustrie, Futter;328759;283869;44890
01.08.12;WA24;Tabak;361551;159731;201820
01.08.12;WA25;Salz, Schwefel, Steine, Erden usw.;156962;163372;-6410
01.08.12;WA26;Erze, Schlacken, Aschen;33800;748360;-714560
01.08.12;WA27;Mineralische Brennstoffe usw.;2425099;9935368;-7510269
01.08.12;WA28;Anorganische chemische Erzeugnisse;661731;541842;119889
01.08.12;WA29;Organische chemische Erzeugnisse;2170796;2008526;162270
01.08.12;WA30;Pharmazeutische Erzeugnisse;4715781;2785491;1930290
01.08.12;WA31;Düngemittel;237464;120383;117081
01.08.12;WA32;Gerb- und Farbstoffe, Farben, Lacke usw.;818132;423196;394936
01.08.12;WA33;Etherische Öle, Riech-, Schönheitsmittel;725279;442233;283046
01.08.12;WA34;Seifen, Waschmittel usw.;507628;259802;247826
01.08.12;WA35;Eiweissstoffe, Klebstoffe, Enzyme;214052;162543;51509
01.08.12;WA36;Sprengstoffe, pyrotechnische Artikel usw.;17442;22450;-5008
01.08.12;WA37;Photochemische Erzeugnisse;85709;63128;22581
01.08.12;WA38;Verschiedene Erzeugnisse der Chemischen Industrie;1425680;935757;489923
01.08.12;WA39;Kunststoffe und Waren daraus;4161506;2587081;1574425
01.08.12;WA40;Kautschuk und Waren daraus;1152634;1131592;21042
01.08.12;WA41;Häute, Felle, Leder;74824;62466;12358
01.08.12;WA42;Lederwaren, Sattlerwaren;142673;283521;-140848
01.08.12;WA43;Pelzfelle, künstliches Pelzwerk;24780;22023;2757
01.08.12;WA44;Holz, Holzwaren, Holzkohle;514882;496923;17959
01.08.12;WA45;Kork, Korkwaren;2772;6680;-3908
01.08.12;WA46;Flechtwaren, Korbmacherwaren;3225;10592;-7367
01.08.12;WA47;Halbstoffe aus Holz usw., Papierabfall;97461;325611;-228150
01.08.12;WA48;Papier, Pappe und Waren daraus;1568287;1022551;545736
01.08.12;WA49;Bücher, Zeitungen, Bilddrucke usw.;368288;163525;204763
01.08.12;WA50;Seide;3687;3995;-308
01.08.12;WA51;Wolle, feine und grobe Tierhaare;41608;39503;2105
01.08.12;WA52;Baumwolle;66612;65985;627
01.08.12;WA53;Andere pflanzliche Spinnstoffe, Papiergarn;2501;5815;-3314
01.08.12;WA54;Synthetisches oder künstliches Filament;139820;111832;27988
01.08.12;WA55;Synthetische oder künstliche Spinnfaser;146561;120959;25602
01.08.12;WA56;Watte, Filz, Vliesstoff usw., Tauwerk;167591;94730;72861
01.08.12;WA57;Teppiche, Fussbodenbelag aus Spinnstoff;41019;76360;-35341
01.08.12;WA58;Spezialgewebe, Spitzen, Tapisserien;33726;24718;9008
01.08.12;WA59;Getränkte, bestrichene usw. Gewebe;155724;79792;75932
01.08.12;WA60;Gewirke und Gestricke;48188;31377;16811
01.08.12;WA61;Bekleidung usw. aus Gewirken, Gestricken;625675;1341725;-716050
01.08.12;WA62;Andere Bekleidung, Bekleidungszubehör;745292;1425067;-679775
01.08.12;WA63;Andere Konfektion, Spinnstoffwaren usw.;169451;271924;-102473
01.08.12;WA64;Schuhe, Gamaschen, ähnliche Waren;382000;791425;-409425
01.08.12;WA65;Kopfbedeckungen und Teile davon;25851;45561;-19710
01.08.12;WA66;Schirme, Gehstöcke usw., Peitschen;6469;10122;-3653
01.08.12;WA67;Zugerichtete Federn, Daunen, künstliche Blumen;8275;18560;-10285
01.08.12;WA68;Waren aus Steinen, Gips, Zement usw.;307786;215964;91822
01.08.12;WA69;Keramische Waren;237266;191044;46222
01.08.12;WA70;Glas und Glaswaren;419845;330916;88929
01.08.12;WA71;Perlen, Edelsteine, Edelmetalle;1354061;1432736;-78675
01.08.12;WA72;Eisen und Stahl;1891581;1740705;150876
01.08.12;WA73;Waren aus Eisen oder Stahl;2135697;1374216;761481
01.08.12;WA74;Kupfer und Waren daraus;886288;755546;130742
01.08.12;WA75;Nickel und Waren daraus;83092;110080;-26988
01.08.12;WA76;Aluminium und Waren daraus;1001966;1060314;-58348
01.08.12;WA78;Blei und Waren daraus;29322;20337;8985
01.08.12;WA79;Zink und Waren daraus;53555;82591;-29036
01.08.12;WA80;Zinn und Waren daraus;9916;35836;-25920
01.08.12;WA81;Andere unedle Metalle, Cermets usw.;105736;122267;-16531
01.08.12;WA82;Werkzeuge, Schneidwaren, Essbestecke;553865;366549;187316
01.08.12;WA83;Verschiedene Waren aus unedlen Metallen;539111;312616;226495
01.08.12;WA84;Maschinen, Apparate, mechanische Geräte;15334012;8553874;6780138
01.08.12;WA85;Elektrotechnische Erzeugnisse;8966416;7832363;1134053
01.08.12;WA86;Schienenfahrzeuge;473514;177451;296063
01.08.12;WA87;Kraftfahrzeuge, Landfahrzeuge;13728664;5010766;8717898
01.08.12;WA88;Luftfahrzeuge, Raumfahrzeuge;2570426;2038206;532220
01.08.12;WA89;Wasserfahrzeuge;550893;688044;-137151
01.08.12;WA90;Optische, photografische usw. Erzeugnisse;4104844;2145993;1958851
01.08.12;WA91;Uhrmacherwaren;124119;174274;-50155
01.08.12;WA92;Musikinstrumente;37764;42611;-4847
01.08.12;WA93;Waffen und Munition;40171;17412;22759
01.08.12;WA94;Möbel, Beleuchtungskörper usw.;1003455;1130104;-126649
01.08.12;WA95;Spielzeug, Spiele usw., Sportgeräte;286058;411853;-125795
01.08.12;WA96;Verschiedene Waren;266729;177767;88962
01.08.12;WA97;Kunstgegenstände, Sammlungsstücke;38961;26669;12292
01.08.12;WA98;Vollständige Fabrikationsanlagen;355950;526;355424
01.08.12;WA99;Zusammenstellungen verschiedener Waren;1801959;804326;997633
01.08.13;WA01;Lebende Tiere;122863;171815;-48952
01.08.13;WA02;Fleisch;686230;482047;204183
01.08.13;WA03;Fische, Krebs- und Weichtiere;102108;244880;-142772
01.08.13;WA04;Milch, Milcherzeugnisse, Eier, Honig;755710;571917;183793
01.08.13;WA05;Andere Waren tierischen Ursprungs;59076;69168;-10092
01.08.13;WA06;Pflanzen, Waren des Blumenhandels;53569;158168;-104599
01.08.13;WA07;Gemüse, Pflanzen für Ernährung;88028;353834;-265806
01.08.13;WA08;Geniessbare Früchte und Nüsse;111380;688252;-576872
01.08.13;WA09;Kaffee, Tee, Mate, Gewürze;171766;261105;-89339
01.08.13;WA10;Getreide;293883;173997;119886
01.08.13;WA11;Müllereierzeugnisse, Malz usw.;98985;45834;53151
01.08.13;WA12;Ölsamen usw., Heilpflanzen usw.;75482;420006;-344524
01.08.13;WA13;Schellack, Gummen, Harz, Pflanzensaft;38753;37069;1684
01.08.13;WA14;Flechtstoffe usw. pflanzlichen Ursprungs;688;2573;-1885
01.08.13;WA15;Tierische und pflanzliche Fette, Öle, Wachs;229039;325978;-96939
01.08.13;WA16;Zubereitungen von Fleisch, Fisch usw.;209161;186943;22218
01.08.13;WA17;Zucker und Zuckerwaren;144478;143107;1371
01.08.13;WA18;Kakao und Zubereitungen aus Kakao;318372;277051;41321
01.08.13;WA19;Zubereitungen aus Getreide usw., Backwaren;422737;237116;185621
01.08.13;WA20;Zubereitungen von Gemüse, Früchten usw.;185449;327544;-142095
01.08.13;WA21;Verschiedene Lebensmittelzubereitungen;363224;205570;157654
01.08.13;WA22;Getränke, alkoholhaltige Flüssigkeiten, Essig;423789;507443;-83654
01.08.13;WA23;Rückstände der Lebensmittelindustrie, Futter;304179;278776;25403
01.08.13;WA24;Tabak;306257;148856;157401
01.08.13;WA25;Salz, Schwefel, Steine, Erden usw.;160274;140111;20163
01.08.13;WA26;Erze, Schlacken, Aschen;25387;461901;-436514
01.08.13;WA27;Mineralische Brennstoffe usw.;2226489;11566908;-9340419
01.08.13;WA28;Anorganische chemische Erzeugnisse;620838;374542;246296
01.08.13;WA29;Organische chemische Erzeugnisse;1983491;2109346;-125855
01.08.13;WA30;Pharmazeutische Erzeugnisse;4414634;2651368;1763266
01.08.13;WA31;Düngemittel;166271;90223;76048
01.08.13;WA32;Gerb- und Farbstoffe, Farben, Lacke usw.;833308;434986;398322
01.08.13;WA33;Etherische Öle, Riech-, Schönheitsmittel;698339;456112;242227
01.08.13;WA34;Seifen, Waschmittel usw.;512522;270614;241908
01.08.13;WA35;Eiweissstoffe, Klebstoffe, Enzyme;230434;151978;78456
01.08.13;WA36;Sprengstoffe, pyrotechnische Artikel usw.;14449;19526;-5077
01.08.13;WA37;Photochemische Erzeugnisse;80006;56985;23021
01.08.13;WA38;Verschiedene Erzeugnisse der Chemischen Industrie;1431152;889118;542034
01.08.13;WA39;Kunststoffe und Waren daraus;4024002;2631104;1392898
01.08.13;WA40;Kautschuk und Waren daraus;1108653;1106279;2374
01.08.13;WA41;Häute, Felle, Leder;75549;66976;8573
01.08.13;WA42;Lederwaren, Sattlerwaren;151099;272539;-121440
01.08.13;WA43;Pelzfelle, künstliches Pelzwerk;21219;15761;5458
01.08.13;WA44;Holz, Holzwaren, Holzkohle;514512;527293;-12781
01.08.13;WA45;Kork, Korkwaren;1868;6156;-4288
01.08.13;WA46;Flechtwaren, Korbmacherwaren;2831;9195;-6364
01.08.13;WA47;Halbstoffe aus Holz usw., Papierabfall;95453;290501;-195048
01.08.13;WA48;Papier, Pappe und Waren daraus;1368061;926040;442021
01.08.13;WA49;Bücher, Zeitungen, Bilddrucke usw.;357272;137375;219897
01.08.13;WA50;Seide;3216;3825;-609
01.08.13;WA51;Wolle, feine und grobe Tierhaare;33630;41802;-8172
01.08.13;WA52;Baumwolle;60111;66478;-6367
01.08.13;WA53;Andere pflanzliche Spinnstoffe, Papiergarn;2121;4448;-2327
01.08.13;WA54;Synthetisches oder künstliches Filament;128984;99959;29025
01.08.13;WA55;Synthetische oder künstliche Spinnfaser;145799;112441;33358
01.08.13;WA56;Watte, Filz, Vliesstoff usw., Tauwerk;174270;93704;80566
01.08.13;WA57;Teppiche, Fussbodenbelag aus Spinnstoff;34088;72321;-38233
01.08.13;WA58;Spezialgewebe, Spitzen, Tapisserien;32485;18826;13659
01.08.13;WA59;Getränkte, bestrichene usw. Gewebe;151783;79209;72574
01.08.13;WA60;Gewirke und Gestricke;50895;25568;25327
01.08.13;WA61;Bekleidung usw. aus Gewirken, Gestricken;649089;1354098;-705009
01.08.13;WA62;Andere Bekleidung, Bekleidungszubehör;726956;1400447;-673491
01.08.13;WA63;Andere Konfektion, Spinnstoffwaren usw.;167868;264579;-96711
01.08.13;WA64;Schuhe, Gamaschen, ähnliche Waren;396009;769441;-373432
01.08.13;WA65;Kopfbedeckungen und Teile davon;30223;48093;-17870
01.08.13;WA66;Schirme, Gehstöcke usw., Peitschen;7523;9966;-2443
01.08.13;WA67;Zugerichtete Federn, Daunen, künstliche Blumen;7065;14654;-7589
01.08.13;WA68;Waren aus Steinen, Gips, Zement usw.;292493;213524;78969
01.08.13;WA69;Keramische Waren;224754;184360;40394
01.08.13;WA70;Glas und Glaswaren;409426;326037;83389
01.08.13;WA71;Perlen, Edelsteine, Edelmetalle;973808;1199568;-225760
01.08.13;WA72;Eisen und Stahl;1577148;1681993;-104845
01.08.13;WA73;Waren aus Eisen oder Stahl;1922225;1350690;571535
01.08.13;WA74;Kupfer und Waren daraus;838662;788042;50620
01.08.13;WA75;Nickel und Waren daraus;64608;86522;-21914
01.08.13;WA76;Aluminium und Waren daraus;951040;1028572;-77532
01.08.13;WA78;Blei und Waren daraus;26423;23821;2602
01.08.13;WA79;Zink und Waren daraus;44685;93902;-49217
01.08.13;WA80;Zinn und Waren daraus;9471;40402;-30931
01.08.13;WA81;Andere unedle Metalle, Cermets usw.;99129;117893;-18764
01.08.13;WA82;Werkzeuge, Schneidwaren, Essbestecke;525193;306965;218228
01.08.13;WA83;Verschiedene Waren aus unedlen Metallen;528505;292626;235879
01.08.13;WA84;Maschinen, Apparate, mechanische Geräte;14481736;8129391;6352345
01.08.13;WA85;Elektrotechnische Erzeugnisse;8474313;7430229;1044084
01.08.13;WA86;Schienenfahrzeuge;251572;186438;65134
01.08.13;WA87;Kraftfahrzeuge, Landfahrzeuge;13346266;4802390;8543876
01.08.13;WA88;Luftfahrzeuge, Raumfahrzeuge;2352835;1457803;895032
01.08.13;WA89;Wasserfahrzeuge;161839;253504;-91665
01.08.13;WA90;Optische, photografische usw. Erzeugnisse;3954189;2074095;1880094
01.08.13;WA91;Uhrmacherwaren;138473;170237;-31764
01.08.13;WA92;Musikinstrumente;34805;34232;573
01.08.13;WA93;Waffen und Munition;40116;17256;22860
01.08.13;WA94;Möbel, Beleuchtungskörper usw.;988869;1107697;-118828
01.08.13;WA95;Spielzeug, Spiele usw., Sportgeräte;255311;355064;-99753
01.08.13;WA96;Verschiedene Waren;268821;184695;84126
01.08.13;WA97;Kunstgegenstände, Sammlungsstücke;48625;17677;30948
01.08.13;WA98;Vollständige Fabrikationsanlagen;250895;6482;244413
01.08.13;WA99;Zusammenstellungen verschiedener Waren;1415003;742680;672323
01.08.14;WA01;Lebende Tiere;116245;146112;-29867
01.08.14;WA02;Fleisch;612721;460637;152084
01.08.14;WA03;Fische, Krebs- und Weichtiere;103857;242004;-138147
01.08.14;WA04;Milch, Milcherzeugnisse, Eier, Honig;756394;590289;166105
01.08.14;WA05;Andere Waren tierischen Ursprungs;52479;62872;-10393
01.08.14;WA06;Pflanzen, Waren des Blumenhandels;53075;172307;-119232
01.08.14;WA07;Gemüse, Pflanzen für Ernährung;71972;298245;-226273
01.08.14;WA08;Geniessbare Früchte und Nüsse;114116;623783;-509667
01.08.14;WA09;Kaffee, Tee, Mate, Gewürze;168453;323478;-155025
01.08.14;WA10;Getreide;209951;189191;20760
01.08.14;WA11;Müllereierzeugnisse, Malz usw.;104348;38547;65801
01.08.14;WA12;Ölsamen usw., Heilpflanzen usw.;70344;444679;-374335
01.08.14;WA13;Schellack, Gummen, Harz, Pflanzensaft;36099;33774;2325
01.08.14;WA14;Flechtstoffe usw. pflanzlichen Ursprungs;1178;3256;-2078
01.08.14;WA15;Tierische und pflanzliche Fette, Öle, Wachs;217179;334115;-116936
01.08.14;WA16;Zubereitungen von Fleisch, Fisch usw.;211801;174909;36892
01.08.14;WA17;Zucker und Zuckerwaren;154658;132781;21877
01.08.14;WA18;Kakao und Zubereitungen aus Kakao;355777;296191;59586
01.08.14;WA19;Zubereitungen aus Getreide usw., Backwaren;428616;257384;171232
01.08.14;WA20;Zubereitungen von Gemüse, Früchten usw.;184751;313601;-128850
01.08.14;WA21;Verschiedene Lebensmittelzubereitungen;366253;217667;148586
01.08.14;WA22;Getränke, alkoholhaltige Flüssigkeiten, Essig;444569;525436;-80867
01.08.14;WA23;Rückstände der Lebensmittelindustrie, Futter;333551;284341;49210
01.08.14;WA24;Tabak;306116;142436;163680
01.08.14;WA25;Salz, Schwefel, Steine, Erden usw.;149798;142904;6894
01.08.14;WA26;Erze, Schlacken, Aschen;20487;629712;-609225
01.08.14;WA27;Mineralische Brennstoffe usw.;1992321;9299175;-7306854
01.08.14;WA28;Anorganische chemische Erzeugnisse;655697;554140;101557
01.08.14;WA29;Organische chemische Erzeugnisse;2001283;2337190;-335907
01.08.14;WA30;Pharmazeutische Erzeugnisse;5276209;2963945;2312264
01.08.14;WA31;Düngemittel;152268;97987;54281
01.08.14;WA32;Gerb- und Farbstoffe, Farben, Lacke usw.;775442;425932;349510
01.08.14;WA33;Etherische Öle, Riech-, Schönheitsmittel;699851;465363;234488
01.08.14;WA34;Seifen, Waschmittel usw.;521263;278016;243247
01.08.14;WA35;Eiweissstoffe, Klebstoffe, Enzyme;232956;151504;81452
01.08.14;WA36;Sprengstoffe, pyrotechnische Artikel usw.;16466;20067;-3601
01.08.14;WA37;Photochemische Erzeugnisse;81673;55693;25980
01.08.14;WA38;Verschiedene Erzeugnisse der Chemischen Industrie;1426071;919332;506739
01.08.14;WA39;Kunststoffe und Waren daraus;4068082;2617227;1450855
01.08.14;WA40;Kautschuk und Waren daraus;1041840;1012399;29441
01.08.14;WA41;Häute, Felle, Leder;74775;70714;4061
01.08.14;WA42;Lederwaren, Sattlerwaren;155586;293554;-137968
01.08.14;WA43;Pelzfelle, künstliches Pelzwerk;19024;15567;3457
01.08.14;WA44;Holz, Holzwaren, Holzkohle;514094;529620;-15526
01.08.14;WA45;Kork, Korkwaren;2381;9272;-6891
01.08.14;WA46;Flechtwaren, Korbmacherwaren;3687;10156;-6469
01.08.14;WA47;Halbstoffe aus Holz usw., Papierabfall;87592;273641;-186049
01.08.14;WA48;Papier, Pappe und Waren daraus;1300885;898302;402583
01.08.14;WA49;Bücher, Zeitungen, Bilddrucke usw.;339301;142368;196933
01.08.14;WA50;Seide;3152;4435;-1283
01.08.14;WA51;Wolle, feine und grobe Tierhaare;30408;38646;-8238
01.08.14;WA52;Baumwolle;53615;55451;-1836
01.08.14;WA53;Andere pflanzliche Spinnstoffe, Papiergarn;2057;3862;-1805
01.08.14;WA54;Synthetisches oder künstliches Filament;127233;103519;23714
01.08.14;WA55;Synthetische oder künstliche Spinnfaser;127436;104283;23153
01.08.14;WA56;Watte, Filz, Vliesstoff usw., Tauwerk;170989;93013;77976
01.08.14;WA57;Teppiche, Fussbodenbelag aus Spinnstoff;37239;67534;-30295
01.08.14;WA58;Spezialgewebe, Spitzen, Tapisserien;30738;18372;12366
01.08.14;WA59;Getränkte, bestrichene usw. Gewebe;150925;74542;76383
01.08.14;WA60;Gewirke und Gestricke;45857;24156;21701
01.08.14;WA61;Bekleidung usw. aus Gewirken, Gestricken;681359;1398868;-717509
01.08.14;WA62;Andere Bekleidung, Bekleidungszubehör;764432;1419750;-655318
01.08.14;WA63;Andere Konfektion, Spinnstoffwaren usw.;186340;276040;-89700
01.08.14;WA64;Schuhe, Gamaschen, ähnliche Waren;451556;870163;-418607
01.08.14;WA65;Kopfbedeckungen und Teile davon;31029;51280;-20251
01.08.14;WA66;Schirme, Gehstöcke usw., Peitschen;5869;12733;-6864
01.08.14;WA67;Zugerichtete Federn, Daunen, künstliche Blumen;7952;14228;-6276
01.08.14;WA68;Waren aus Steinen, Gips, Zement usw.;301733;214811;86922
01.08.14;WA69;Keramische Waren;232718;189731;42987
01.08.14;WA70;Glas und Glaswaren;420403;312835;107568
01.08.14;WA71;Perlen, Edelsteine, Edelmetalle;849540;1122106;-272566
01.08.14;WA72;Eisen und Stahl;1600373;1644934;-44561
01.08.14;WA73;Waren aus Eisen oder Stahl;1953181;1365789;587392
01.08.14;WA74;Kupfer und Waren daraus;803690;749638;54052
01.08.14;WA75;Nickel und Waren daraus;77352;100371;-23019
01.08.14;WA76;Aluminium und Waren daraus;991036;1046339;-55303
01.08.14;WA78;Blei und Waren daraus;32902;24007;8895
01.08.14;WA79;Zink und Waren daraus;45625;102152;-56527
01.08.14;WA80;Zinn und Waren daraus;8229;29566;-21337
01.08.14;WA81;Andere unedle Metalle, Cermets usw.;101809;113682;-11873
01.08.14;WA82;Werkzeuge, Schneidwaren, Essbestecke;550323;325269;225054
01.08.14;WA83;Verschiedene Waren aus unedlen Metallen;507621;284081;223540
01.08.14;WA84;Maschinen, Apparate, mechanische Geräte;14535621;7935419;6600202
01.08.14;WA85;Elektrotechnische Erzeugnisse;8431884;7517383;914501
01.08.14;WA86;Schienenfahrzeuge;241615;140403;101212
01.08.14;WA87;Kraftfahrzeuge, Landfahrzeuge;11515787;4909990;6605797
01.08.14;WA88;Luftfahrzeuge, Raumfahrzeuge;2077265;1429663;647602
01.08.14;WA89;Wasserfahrzeuge;277132;30984;246148
01.08.14;WA90;Optische, photografische usw. Erzeugnisse;3889523;2134543;1754980
01.08.14;WA91;Uhrmacherwaren;153459;157038;-3579
01.08.14;WA92;Musikinstrumente;32225;39255;-7030
01.08.14;WA93;Waffen und Munition;29587;14124;15463
01.08.14;WA94;Möbel, Beleuchtungskörper usw.;999095;1151861;-152766
01.08.14;WA95;Spielzeug, Spiele usw., Sportgeräte;245318;372946;-127628
01.08.14;WA96;Verschiedene Waren;287396;183021;104375
01.08.14;WA97;Kunstgegenstände, Sammlungsstücke;31831;18043;13788
01.08.14;WA98;Vollständige Fabrikationsanlagen;179165;4787;174378
01.08.14;WA99;Zusammenstellungen verschiedener Waren;1714231;752898;961333
01.08.15;WA01;Lebende Tiere;128798;137301;-8503
01.08.15;WA02;Fleisch;585334;475874;109460
01.08.15;WA03;Fische, Krebs- und Weichtiere;123089;272985;-149896
01.08.15;WA04;Milch, Milcherzeugnisse, Eier, Honig;650270;533658;116612
01.08.15;WA05;Andere Waren tierischen Ursprungs;55928;61798;-5870
01.08.15;WA06;Pflanzen, Waren des Blumenhandels;53107;171578;-118471
01.08.15;WA07;Gemüse, Pflanzen für Ernährung;68571;361994;-293423
01.08.15;WA08;Geniessbare Früchte und Nüsse;143153;779347;-636194
01.08.15;WA09;Kaffee, Tee, Mate, Gewürze;199428;304968;-105540
01.08.15;WA10;Getreide;132498;184610;-52112
01.08.15;WA11;Müllereierzeugnisse, Malz usw.;103417;39063;64354
01.08.15;WA12;Ölsamen usw., Heilpflanzen usw.;74245;414121;-339876
01.08.15;WA13;Schellack, Gummen, Harz, Pflanzensaft;42805;40538;2267
01.08.15;WA14;Flechtstoffe usw. pflanzlichen Ursprungs;665;3187;-2522
01.08.15;WA15;Tierische und pflanzliche Fette, Öle, Wachs;202028;326212;-124184
01.08.15;WA16;Zubereitungen von Fleisch, Fisch usw.;240616;199219;41397
01.08.15;WA17;Zucker und Zuckerwaren;145280;138423;6857
01.08.15;WA18;Kakao und Zubereitungen aus Kakao;388918;362487;26431
01.08.15;WA19;Zubereitungen aus Getreide usw., Backwaren;462504;290395;172109
01.08.15;WA20;Zubereitungen von Gemüse, Früchten usw.;192825;367210;-174385
01.08.15;WA21;Verschiedene Lebensmittelzubereitungen;384766;237764;147002
01.08.15;WA22;Getränke, alkoholhaltige Flüssigkeiten, Essig;453806;519802;-65996
01.08.15;WA23;Rückstände der Lebensmittelindustrie, Futter;319739;293539;26200
01.08.15;WA24;Tabak;345326;148050;197276
01.08.15;WA25;Salz, Schwefel, Steine, Erden usw.;147657;149145;-1488
01.08.15;WA26;Erze, Schlacken, Aschen;28505;596213;-567708
01.08.15;WA27;Mineralische Brennstoffe usw.;2223269;7235421;-5012152
01.08.15;WA28;Anorganische chemische Erzeugnisse;697588;428176;269412
01.08.15;WA29;Organische chemische Erzeugnisse;1866579;2376645;-510066
01.08.15;WA30;Pharmazeutische Erzeugnisse;5592720;3286163;2306557
01.08.15;WA31;Düngemittel;138550;108271;30279
01.08.15;WA32;Gerb- und Farbstoffe, Farben, Lacke usw.;792734;431113;361621
01.08.15;WA33;Etherische Öle, Riech-, Schönheitsmittel;733452;547730;185722
01.08.15;WA34;Seifen, Waschmittel usw.;523500;294393;229107
01.08.15;WA35;Eiweissstoffe, Klebstoffe, Enzyme;230240;158875;71365
01.08.15;WA36;Sprengstoffe, pyrotechnische Artikel usw.;13864;27612;-13748
01.08.15;WA37;Photochemische Erzeugnisse;86228;56951;29277
01.08.15;WA38;Verschiedene Erzeugnisse der Chemischen Industrie;1461578;901395;560183
01.08.15;WA39;Kunststoffe und Waren daraus;4121705;2798169;1323536
01.08.15;WA40;Kautschuk und Waren daraus;1079479;1050074;29405
01.08.15;WA41;Häute, Felle, Leder;71140;61235;9905
01.08.15;WA42;Lederwaren, Sattlerwaren;167498;338174;-170676
01.08.15;WA43;Pelzfelle, künstliches Pelzwerk;11025;13448;-2423
01.08.15;WA44;Holz, Holzwaren, Holzkohle;531557;561798;-30241
01.08.15;WA45;Kork, Korkwaren;2421;7598;-5177
01.08.15;WA46;Flechtwaren, Korbmacherwaren;3395;10653;-7258
01.08.15;WA47;Halbstoffe aus Holz usw., Papierabfall;108669;306684;-198015
01.08.15;WA48;Papier, Pappe und Waren daraus;1353205;989512;363693
01.08.15;WA49;Bücher, Zeitungen, Bilddrucke usw.;359150;177539;181611
01.08.15;WA50;Seide;2734;4398;-1664
01.08.15;WA51;Wolle, feine und grobe Tierhaare;34423;39353;-4930
01.08.15;WA52;Baumwolle;50201;65247;-15046
01.08.15;WA53;Andere pflanzliche Spinnstoffe, Papiergarn;2347;5222;-2875
01.08.15;WA54;Synthetisches oder künstliches Filament;127994;109625;18369
01.08.15;WA55;Synthetische oder künstliche Spinnfaser;132331;106082;26249
01.08.15;WA56;Watte, Filz, Vliesstoff usw., Tauwerk;172094;99061;73033
01.08.15;WA57;Teppiche, Fussbodenbelag aus Spinnstoff;37420;73467;-36047
01.08.15;WA58;Spezialgewebe, Spitzen, Tapisserien;37386;19848;17538
01.08.15;WA59;Getränkte, bestrichene usw. Gewebe;154639;80841;73798
01.08.15;WA60;Gewirke und Gestricke;47111;25857;21254
01.08.15;WA61;Bekleidung usw. aus Gewirken, Gestricken;682212;1537372;-855160
01.08.15;WA62;Andere Bekleidung, Bekleidungszubehör;748089;1524717;-776628
01.08.15;WA63;Andere Konfektion, Spinnstoffwaren usw.;187424;308492;-121068
01.08.15;WA64;Schuhe, Gamaschen, ähnliche Waren;439271;921867;-482596
01.08.15;WA65;Kopfbedeckungen und Teile davon;32267;52748;-20481
01.08.15;WA66;Schirme, Gehstöcke usw., Peitschen;7880;14722;-6842
01.08.15;WA67;Zugerichtete Federn, Daunen, künstliche Blumen;9100;18273;-9173
01.08.15;WA68;Waren aus Steinen, Gips, Zement usw.;311119;235906;75213
01.08.15;WA69;Keramische Waren;232638;217682;14956
01.08.15;WA70;Glas und Glaswaren;414691;363190;51501
01.08.15;WA71;Perlen, Edelsteine, Edelmetalle;744543;1344985;-600442
01.08.15;WA72;Eisen und Stahl;1530067;1653457;-123390
01.08.15;WA73;Waren aus Eisen oder Stahl;1961552;1392469;569083
01.08.15;WA74;Kupfer und Waren daraus;720793;651725;69068
01.08.15;WA75;Nickel und Waren daraus;94985;89744;5241
01.08.15;WA76;Aluminium und Waren daraus;1073198;1194367;-121169
01.08.15;WA78;Blei und Waren daraus;30276;39892;-9616
01.08.15;WA79;Zink und Waren daraus;41664;95244;-53580
01.08.15;WA80;Zinn und Waren daraus;6403;27620;-21217
01.08.15;WA81;Andere unedle Metalle, Cermets usw.;100194;132447;-32253
01.08.15;WA82;Werkzeuge, Schneidwaren, Essbestecke;554020;370344;183676
01.08.15;WA83;Verschiedene Waren aus unedlen Metallen;533393;309753;223640
01.08.15;WA84;Maschinen, Apparate, mechanische Geräte;14794714;8520223;6274491
01.08.15;WA85;Elektrotechnische Erzeugnisse;8834200;8629127;205073
01.08.15;WA86;Schienenfahrzeuge;287808;200467;87341
01.08.15;WA87;Kraftfahrzeuge, Landfahrzeuge;13911437;5706424;8205013
01.08.15;WA88;Luftfahrzeuge, Raumfahrzeuge;2665277;1300895;1364382
01.08.15;WA89;Wasserfahrzeuge;189990;95395;94595
01.08.15;WA90;Optische, photografische usw. Erzeugnisse;4230471;2563748;1666723
01.08.15;WA91;Uhrmacherwaren;142620;216383;-73763
01.08.15;WA92;Musikinstrumente;34037;41114;-7077
01.08.15;WA93;Waffen und Munition;30481;14094;16387
01.08.15;WA94;Möbel, Beleuchtungskörper usw.;1055227;1263226;-207999
01.08.15;WA95;Spielzeug, Spiele usw., Sportgeräte;276508;489360;-212852
01.08.15;WA96;Verschiedene Waren;291048;211460;79588
01.08.15;WA97;Kunstgegenstände, Sammlungsstücke;47443;31494;15949
01.08.15;WA98;Vollständige Fabrikationsanlagen;245008;2899;242109
01.08.15;WA99;Zusammenstellungen verschiedener Waren;1600848;722887;877961
01.08.16;WA01;Lebende Tiere;152212;187495;-35283
01.08.16;WA02;Fleisch;663432;514208;149224
01.08.16;WA03;Fische, Krebs- und Weichtiere;131426;335696;-204270
01.08.16;WA04;Milch, Milcherzeugnisse, Eier, Honig;670459;580834;89625
01.08.16;WA05;Andere Waren tierischen Ursprungs;65437;70004;-4567
01.08.16;WA06;Pflanzen, Waren des Blumenhandels;64438;188186;-123748
01.08.16;WA07;Gemüse, Pflanzen für Ernährung;100451;407850;-307399
01.08.16;WA08;Geniessbare Früchte und Nüsse;148449;807783;-659334
01.08.16;WA09;Kaffee, Tee, Mate, Gewürze;208612;333147;-124535
01.08.16;WA10;Getreide;163720;178544;-14824
01.08.16;WA11;Müllereierzeugnisse, Malz usw.;114346;44341;70005
01.08.16;WA12;Ölsamen usw., Heilpflanzen usw.;89008;435276;-346268
01.08.16;WA13;Schellack, Gummen, Harz, Pflanzensaft;45311;37347;7964
01.08.16;WA14;Flechtstoffe usw. pflanzlichen Ursprungs;529;3091;-2562
01.08.16;WA15;Tierische und pflanzliche Fette, Öle, Wachs;231387;335801;-104414
01.08.16;WA16;Zubereitungen von Fleisch, Fisch usw.;239866;211086;28780
01.08.16;WA17;Zucker und Zuckerwaren;170986;137848;33138
01.08.16;WA18;Kakao und Zubereitungen aus Kakao;434351;383720;50631
01.08.16;WA19;Zubereitungen aus Getreide usw., Backwaren;519365;316438;202927
01.08.16;WA20;Zubereitungen von Gemüse, Früchten usw.;212646;374729;-162083
01.08.16;WA21;Verschiedene Lebensmittelzubereitungen;432899;245936;186963
01.08.16;WA22;Getränke, alkoholhaltige Flüssigkeiten, Essig;487257;556621;-69364
01.08.16;WA23;Rückstände der Lebensmittelindustrie, Futter;366366;302826;63540
01.08.16;WA24;Tabak;352604;144495;208109
01.08.16;WA25;Salz, Schwefel, Steine, Erden usw.;151652;158818;-7166
01.08.16;WA26;Erze, Schlacken, Aschen;24493;525839;-501346
01.08.16;WA27;Mineralische Brennstoffe usw.;1717201;6344264;-4627063
01.08.16;WA28;Anorganische chemische Erzeugnisse;685871;480426;205445
01.08.16;WA29;Organische chemische Erzeugnisse;1895154;2153637;-258483
01.08.16;WA30;Pharmazeutische Erzeugnisse;5484352;3813900;1670452
01.08.16;WA31;Düngemittel;132950;77222;55728
01.08.16;WA32;Gerb- und Farbstoffe, Farben, Lacke usw.;868182;464290;403892
01.08.16;WA33;Etherische Öle, Riech-, Schönheitsmittel;816177;549602;266575
01.08.16;WA34;Seifen, Waschmittel usw.;580645;318337;262308
01.08.16;WA35;Eiweissstoffe, Klebstoffe, Enzyme;251417;156637;94780
01.08.16;WA36;Sprengstoffe, pyrotechnische Artikel usw.;17176;28689;-11513
01.08.16;WA37;Photochemische Erzeugnisse;101985;63613;38372
01.08.16;WA38;Verschiedene Erzeugnisse der Chemischen Industrie;1592188;963342;628846
01.08.16;WA39;Kunststoffe und Waren daraus;4439918;2941879;1498039
01.08.16;WA40;Kautschuk und Waren daraus;1139832;1142215;-2383
01.08.16;WA41;Häute, Felle, Leder;64886;53284;11602
01.08.16;WA42;Lederwaren, Sattlerwaren;179039;349141;-170102
01.08.16;WA43;Pelzfelle, künstliches Pelzwerk;10987;10961;26
01.08.16;WA44;Holz, Holzwaren, Holzkohle;562451;601054;-38603
01.08.16;WA45;Kork, Korkwaren;2623;9051;-6428
01.08.16;WA46;Flechtwaren, Korbmacherwaren;3691;10015;-6324
01.08.16;WA47;Halbstoffe aus Holz usw., Papierabfall;96264;319863;-223599
01.08.16;WA48;Papier, Pappe und Waren daraus;1413862;1002555;411307
01.08.16;WA49;Bücher, Zeitungen, Bilddrucke usw.;377230;223346;153884
01.08.16;WA50;Seide;2742;3535;-793
01.08.16;WA51;Wolle, feine und grobe Tierhaare;37809;43396;-5587
01.08.16;WA52;Baumwolle;50271;60470;-10199
01.08.16;WA53;Andere pflanzliche Spinnstoffe, Papiergarn;2490;4764;-2274
01.08.16;WA54;Synthetisches oder künstliches Filament;130328;110400;19928
01.08.16;WA55;Synthetische oder künstliche Spinnfaser;129226;108044;21182
01.08.16;WA56;Watte, Filz, Vliesstoff usw., Tauwerk;180341;108471;71870
01.08.16;WA57;Teppiche, Fussbodenbelag aus Spinnstoff;42932;77215;-34283
01.08.16;WA58;Spezialgewebe, Spitzen, Tapisserien;39123;20835;18288
01.08.16;WA59;Getränkte, bestrichene usw. Gewebe;178021;81938;96083
01.08.16;WA60;Gewirke und Gestricke;51385;29849;21536
01.08.16;WA61;Bekleidung usw. aus Gewirken, Gestricken;720626;1645976;-925350
01.08.16;WA62;Andere Bekleidung, Bekleidungszubehör;792761;1603839;-811078
01.08.16;WA63;Andere Konfektion, Spinnstoffwaren usw.;215917;315161;-99244
01.08.16;WA64;Schuhe, Gamaschen, ähnliche Waren;585140;1024772;-439632
01.08.16;WA65;Kopfbedeckungen und Teile davon;32253;50519;-18266
01.08.16;WA66;Schirme, Gehstöcke usw., Peitschen;8376;14825;-6449
01.08.16;WA67;Zugerichtete Federn, Daunen, künstliche Blumen;10284;20307;-10023
01.08.16;WA68;Waren aus Steinen, Gips, Zement usw.;350463;252523;97940
01.08.16;WA69;Keramische Waren;252760;249467;3293
01.08.16;WA70;Glas und Glaswaren;465916;415557;50359
01.08.16;WA71;Perlen, Edelsteine, Edelmetalle;1043162;1056817;-13655
01.08.16;WA72;Eisen und Stahl;1476468;1608120;-131652
01.08.16;WA73;Waren aus Eisen oder Stahl;2139211;1506328;632883
01.08.16;WA74;Kupfer und Waren daraus;699602;566587;133015
01.08.16;WA75;Nickel und Waren daraus;68190;81272;-13082
01.08.16;WA76;Aluminium und Waren daraus;1119458;1166465;-47007
01.08.16;WA78;Blei und Waren daraus;26013;29111;-3098
01.08.16;WA79;Zink und Waren daraus;44308;110412;-66104
01.08.16;WA80;Zinn und Waren daraus;9585;30952;-21367
01.08.16;WA81;Andere unedle Metalle, Cermets usw.;108367;130346;-21979
01.08.16;WA82;Werkzeuge, Schneidwaren, Essbestecke;630138;386748;243390
01.08.16;WA83;Verschiedene Waren aus unedlen Metallen;580910;355126;225784
01.08.16;WA84;Maschinen, Apparate, mechanische Geräte;15991595;9571467;6420128
01.08.16;WA85;Elektrotechnische Erzeugnisse;10068945;9524219;544726
01.08.16;WA86;Schienenfahrzeuge;399633;187996;211637
01.08.16;WA87;Kraftfahrzeuge, Landfahrzeuge;16116510;7073807;9042703
01.08.16;WA88;Luftfahrzeuge, Raumfahrzeuge;3278941;1023900;2255041
01.08.16;WA89;Wasserfahrzeuge;333152;165694;167458
01.08.16;WA90;Optische, photografische usw. Erzeugnisse;4842439;2711253;2131186
01.08.16;WA91;Uhrmacherwaren;139253;159644;-20391
01.08.16;WA92;Musikinstrumente;35258;46672;-11414
01.08.16;WA93;Waffen und Munition;38221;19535;18686
01.08.16;WA94;Möbel, Beleuchtungskörper usw.;1146735;1401843;-255108
01.08.16;WA95;Spielzeug, Spiele usw., Sportgeräte;270064;462246;-192182
01.08.16;WA96;Verschiedene Waren;317267;245261;72006
01.08.16;WA97;Kunstgegenstände, Sammlungsstücke;53622;27643;25979
01.08.16;WA98;Vollständige Fabrikationsanlagen;183786;1266;182520
01.08.16;WA99;Zusammenstellungen verschiedener Waren;1864022;846504;1017518
01.08.17;WA01;Lebende Tiere;128473;164659;-36186
01.08.17;WA02;Fleisch;687085;540546;146539
01.08.17;WA03;Fische, Krebs- und Weichtiere;132552;328438;-195886
01.08.17;WA04;Milch, Milcherzeugnisse, Eier, Honig;800615;696715;103900
01.08.17;WA05;Andere Waren tierischen Ursprungs;74710;92208;-17498
01.08.17;WA06;Pflanzen, Waren des Blumenhandels;58250;184115;-125865
01.08.17;WA07;Gemüse, Pflanzen für Ernährung;79354;355702;-276348
01.08.17;WA08;Geniessbare Früchte und Nüsse;156774;828486;-671712
01.08.17;WA09;Kaffee, Tee, Mate, Gewürze;250617;303041;-52424
01.08.17;WA10;Getreide;154472;182253;-27781
01.08.17;WA11;Müllereierzeugnisse, Malz usw.;114225;47651;66574
01.08.17;WA12;Ölsamen usw., Heilpflanzen usw.;109973;440241;-330268
01.08.17;WA13;Schellack, Gummen, Harz, Pflanzensaft;48704;42707;5997
01.08.17;WA14;Flechtstoffe usw. pflanzlichen Ursprungs;640;3536;-2896
01.08.17;WA15;Tierische und pflanzliche Fette, Öle, Wachs;242369;313889;-71520
01.08.17;WA16;Zubereitungen von Fleisch, Fisch usw.;238743;205344;33399
01.08.17;WA17;Zucker und Zuckerwaren;172095;143655;28440
01.08.17;WA18;Kakao und Zubereitungen aus Kakao;449792;416523;33269
01.08.17;WA19;Zubereitungen aus Getreide usw., Backwaren;553796;315574;238222
01.08.17;WA20;Zubereitungen von Gemüse, Früchten usw.;213541;393080;-179539
01.08.17;WA21;Verschiedene Lebensmittelzubereitungen;433834;237837;195997
01.08.17;WA22;Getränke, alkoholhaltige Flüssigkeiten, Essig;519377;600457;-81080
01.08.17;WA23;Rückstände der Lebensmittelindustrie, Futter;314733;272713;42020
01.08.17;WA24;Tabak;335317;205341;129976
01.08.17;WA25;Salz, Schwefel, Steine, Erden usw.;152039;147201;4838
01.08.17;WA26;Erze, Schlacken, Aschen;30500;574707;-544207
01.08.17;WA27;Mineralische Brennstoffe usw.;1768752;6219406;-4450654
01.08.17;WA28;Anorganische chemische Erzeugnisse;723830;488752;235078
01.08.17;WA29;Organische chemische Erzeugnisse;2037278;2426205;-388927
01.08.17;WA30;Pharmazeutische Erzeugnisse;6413814;3838893;2574921
01.08.17;WA31;Düngemittel;144455;74965;69490
01.08.17;WA32;Gerb- und Farbstoffe, Farben, Lacke usw.;943311;532296;411015
01.08.17;WA33;Etherische Öle, Riech-, Schönheitsmittel;821876;634419;187457
01.08.17;WA34;Seifen, Waschmittel usw.;612789;335004;277785
01.08.17;WA35;Eiweissstoffe, Klebstoffe, Enzyme;289219;176738;112481
01.08.17;WA36;Sprengstoffe, pyrotechnische Artikel usw.;18883;27146;-8263
01.08.17;WA37;Photochemische Erzeugnisse;86081;61782;24299
01.08.17;WA38;Verschiedene Erzeugnisse der Chemischen Industrie;1709381;1050426;658955
01.08.17;WA39;Kunststoffe und Waren daraus;4948842;3363036;1585806
01.08.17;WA40;Kautschuk und Waren daraus;1218406;1264123;-45717
01.08.17;WA41;Häute, Felle, Leder;63441;56003;7438
01.08.17;WA42;Lederwaren, Sattlerwaren;199355;347260;-147905
01.08.17;WA43;Pelzfelle, künstliches Pelzwerk;14122;16321;-2199
01.08.17;WA44;Holz, Holzwaren, Holzkohle;607354;631122;-23768
01.08.17;WA45;Kork, Korkwaren;2487;5495;-3008
01.08.17;WA46;Flechtwaren, Korbmacherwaren;2966;9055;-6089
01.08.17;WA47;Halbstoffe aus Holz usw., Papierabfall;104774;348794;-244020
01.08.17;WA48;Papier, Pappe und Waren daraus;1411882;1043495;368387
01.08.17;WA49;Bücher, Zeitungen, Bilddrucke usw.;352234;211646;140588
01.08.17;WA50;Seide;2605;3566;-961
01.08.17;WA51;Wolle, feine und grobe Tierhaare;32684;43068;-10384
01.08.17;WA52;Baumwolle;53677;66978;-13301
01.08.17;WA53;Andere pflanzliche Spinnstoffe, Papiergarn;2089;5107;-3018
01.08.17;WA54;Synthetisches oder künstliches Filament;144480;118944;25536
01.08.17;WA55;Synthetische oder künstliche Spinnfaser;126034;111746;14288
01.08.17;WA56;Watte, Filz, Vliesstoff usw., Tauwerk;201164;121513;79651
01.08.17;WA57;Teppiche, Fussbodenbelag aus Spinnstoff;41462;81630;-40168
01.08.17;WA58;Spezialgewebe, Spitzen, Tapisserien;41927;20646;21281
01.08.17;WA59;Getränkte, bestrichene usw. Gewebe;198475;89542;108933
01.08.17;WA60;Gewirke und Gestricke;57419;31924;25495
01.08.17;WA61;Bekleidung usw. aus Gewirken, Gestricken;816300;1683615;-867315
01.08.17;WA62;Andere Bekleidung, Bekleidungszubehör;899209;1631090;-731881
01.08.17;WA63;Andere Konfektion, Spinnstoffwaren usw.;204781;324326;-119545
01.08.17;WA64;Schuhe, Gamaschen, ähnliche Waren;693653;1094311;-400658
01.08.17;WA65;Kopfbedeckungen und Teile davon;40964;58584;-17620
01.08.17;WA66;Schirme, Gehstöcke usw., Peitschen;6816;12908;-6092
01.08.17;WA67;Zugerichtete Federn, Daunen, künstliche Blumen;11511;20426;-8915
01.08.17;WA68;Waren aus Steinen, Gips, Zement usw.;376649;275772;100877
01.08.17;WA69;Keramische Waren;263076;238591;24485
01.08.17;WA70;Glas und Glaswaren;511191;428399;82792
01.08.17;WA71;Perlen, Edelsteine, Edelmetalle;864190;1311913;-447723
01.08.17;WA72;Eisen und Stahl;1836941;2000945;-164004
01.08.17;WA73;Waren aus Eisen oder Stahl;2145894;1636962;508932
01.08.17;WA74;Kupfer und Waren daraus;846818;797731;49087
01.08.17;WA75;Nickel und Waren daraus;89047;113098;-24051
01.08.17;WA76;Aluminium und Waren daraus;1170008;1321091;-151083
01.08.17;WA78;Blei und Waren daraus;31741;34983;-3242
01.08.17;WA79;Zink und Waren daraus;54585;138037;-83452
01.08.17;WA80;Zinn und Waren daraus;9090;30375;-21285
01.08.17;WA81;Andere unedle Metalle, Cermets usw.;120205;156868;-36663
01.08.17;WA82;Werkzeuge, Schneidwaren, Essbestecke;684824;417143;267681
01.08.17;WA83;Verschiedene Waren aus unedlen Metallen;613718;392115;221603
01.08.17;WA84;Maschinen, Apparate, mechanische Geräte;17800348;10344168;7456180
01.08.17;WA85;Elektrotechnische Erzeugnisse;10799077;10437008;362069
01.08.17;WA86;Schienenfahrzeuge;362869;183466;179403
01.08.17;WA87;Kraftfahrzeuge, Landfahrzeuge;17482936;7570351;9912585
01.08.17;WA88;Luftfahrzeuge, Raumfahrzeuge;3013249;1353482;1659767
01.08.17;WA89;Wasserfahrzeuge;282934;581766;-298832
01.08.17;WA90;Optische, photografische usw. Erzeugnisse;5380609;2836871;2543738
01.08.17;WA91;Uhrmacherwaren;131167;155304;-24137
01.08.17;WA92;Musikinstrumente;38991;48402;-9411
01.08.17;WA93;Waffen und Munition;35837;18971;16866
01.08.17;WA94;Möbel, Beleuchtungskörper usw.;1211211;1428723;-217512
01.08.17;WA95;Spielzeug, Spiele usw., Sportgeräte;372602;518942;-146340
01.08.17;WA96;Verschiedene Waren;326930;224893;102037
01.08.17;WA97;Kunstgegenstände, Sammlungsstücke;46026;28657;17369
01.08.17;WA98;Vollständige Fabrikationsanlagen;114144;NULL;#WERT!
01.08.17;WA99;Zusammenstellungen verschiedener Waren;1413121;950134;462987
01.08.18;WA01;Lebende Tiere;113075;130783;-17708
01.08.18;WA02;Fleisch;583755;539403;44352
01.08.18;WA03;Fische, Krebs- und Weichtiere;121941;321510;-199569
01.08.18;WA04;Milch, Milcherzeugnisse, Eier, Honig;756830;706283;50547
01.08.18;WA05;Andere Waren tierischen Ursprungs;78652;79592;-940
01.08.18;WA06;Pflanzen, Waren des Blumenhandels;65687;180789;-115102
01.08.18;WA07;Gemüse, Pflanzen für Ernährung;91715;388403;-296688
01.08.18;WA08;Geniessbare Früchte und Nüsse;158137;873732;-715595
01.08.18;WA09;Kaffee, Tee, Mate, Gewürze;227803;335637;-107834
01.08.18;WA10;Getreide;133337;224125;-90788
01.08.18;WA11;Müllereierzeugnisse, Malz usw.;127270;59544;67726
01.08.18;WA12;Ölsamen usw., Heilpflanzen usw.;109382;543232;-433850
01.08.18;WA13;Schellack, Gummen, Harz, Pflanzensaft;51017;37208;13809
01.08.18;WA14;Flechtstoffe usw. pflanzlichen Ursprungs;627;3393;-2766
01.08.18;WA15;Tierische und pflanzliche Fette, Öle, Wachs;189909;265367;-75458
01.08.18;WA16;Zubereitungen von Fleisch, Fisch usw.;259045;268034;-8989
01.08.18;WA17;Zucker und Zuckerwaren;194009;130972;63037
01.08.18;WA18;Kakao und Zubereitungen aus Kakao;488270;381289;106981
01.08.18;WA19;Zubereitungen aus Getreide usw., Backwaren;571673;350383;221290
01.08.18;WA20;Zubereitungen von Gemüse, Früchten usw.;258497;421336;-162839
01.08.18;WA21;Verschiedene Lebensmittelzubereitungen;489677;293818;195859
01.08.18;WA22;Getränke, alkoholhaltige Flüssigkeiten, Essig;549975;605887;-55912
01.08.18;WA23;Rückstände der Lebensmittelindustrie, Futter;358682;328440;30242
01.08.18;WA24;Tabak;312898;208656;104242
01.08.18;WA25;Salz, Schwefel, Steine, Erden usw.;152884;185404;-32520
01.08.18;WA26;Erze, Schlacken, Aschen;39520;497396;-457876
01.08.18;WA27;Mineralische Brennstoffe usw.;2312084;8262024;-5949940
01.08.18;WA28;Anorganische chemische Erzeugnisse;795534;512341;283193
01.08.18;WA29;Organische chemische Erzeugnisse;2161851;3479967;-1318116
01.08.18;WA30;Pharmazeutische Erzeugnisse;7381794;4302270;3079524
01.08.18;WA31;Düngemittel;166504;58815;107689
01.08.18;WA32;Gerb- und Farbstoffe, Farben, Lacke usw.;922015;496340;425675
01.08.18;WA33;Etherische Öle, Riech-, Schönheitsmittel;862109;659644;202465
01.08.18;WA34;Seifen, Waschmittel usw.;654598;358833;295765
01.08.18;WA35;Eiweissstoffe, Klebstoffe, Enzyme;308437;174280;134157
01.08.18;WA36;Sprengstoffe, pyrotechnische Artikel usw.;25284;29317;-4033
01.08.18;WA37;Photochemische Erzeugnisse;107334;68951;38383
01.08.18;WA38;Verschiedene Erzeugnisse der Chemischen Industrie;1816861;1140370;676491
01.08.18;WA39;Kunststoffe und Waren daraus;5031881;3476974;1554907
01.08.18;WA40;Kautschuk und Waren daraus;1235166;1214952;20214
01.08.18;WA41;Häute, Felle, Leder;55989;50480;5509
01.08.18;WA42;Lederwaren, Sattlerwaren;214033;358835;-144802
01.08.18;WA43;Pelzfelle, künstliches Pelzwerk;13008;13018;-10
01.08.18;WA44;Holz, Holzwaren, Holzkohle;658929;673052;-14123
01.08.18;WA45;Kork, Korkwaren;3027;9239;-6212
01.08.18;WA46;Flechtwaren, Korbmacherwaren;3632;7894;-4262
01.08.18;WA47;Halbstoffe aus Holz usw., Papierabfall;101388;389621;-288233
01.08.18;WA48;Papier, Pappe und Waren daraus;1567551;1102764;464787
01.08.18;WA49;Bücher, Zeitungen, Bilddrucke usw.;412228;231667;180561
01.08.18;WA50;Seide;1598;3372;-1774
01.08.18;WA51;Wolle, feine und grobe Tierhaare;34640;46167;-11527
01.08.18;WA52;Baumwolle;53491;61691;-8200
01.08.18;WA53;Andere pflanzliche Spinnstoffe, Papiergarn;2231;4927;-2696
01.08.18;WA54;Synthetisches oder künstliches Filament;137476;116527;20949
01.08.18;WA55;Synthetische oder künstliche Spinnfaser;133012;125511;7501
01.08.18;WA56;Watte, Filz, Vliesstoff usw., Tauwerk;195218;120049;75169
01.08.18;WA57;Teppiche, Fussbodenbelag aus Spinnstoff;43198;83386;-40188
01.08.18;WA58;Spezialgewebe, Spitzen, Tapisserien;39871;18463;21408
01.08.18;WA59;Getränkte, bestrichene usw. Gewebe;197222;90541;106681
01.08.18;WA60;Gewirke und Gestricke;51012;27030;23982
01.08.18;WA61;Bekleidung usw. aus Gewirken, Gestricken;873868;1712784;-838916
01.08.18;WA62;Andere Bekleidung, Bekleidungszubehör;967239;1636856;-669617
01.08.18;WA63;Andere Konfektion, Spinnstoffwaren usw.;232988;349391;-116403
01.08.18;WA64;Schuhe, Gamaschen, ähnliche Waren;702160;1048168;-346008
01.08.18;WA65;Kopfbedeckungen und Teile davon;37364;61306;-23942
01.08.18;WA66;Schirme, Gehstöcke usw., Peitschen;8089;15685;-7596
01.08.18;WA67;Zugerichtete Federn, Daunen, künstliche Blumen;12139;23287;-11148
01.08.18;WA68;Waren aus Steinen, Gips, Zement usw.;390277;276828;113449
01.08.18;WA69;Keramische Waren;282752;233616;49136
01.08.18;WA70;Glas und Glaswaren;569147;429494;139653
01.08.18;WA71;Perlen, Edelsteine, Edelmetalle;1044238;1310921;-266683
01.08.18;WA72;Eisen und Stahl;1963325;2185692;-222367
01.08.18;WA73;Waren aus Eisen oder Stahl;2332453;1763818;568635
01.08.18;WA74;Kupfer und Waren daraus;883829;783819;100010
01.08.18;WA75;Nickel und Waren daraus;99226;122741;-23515
01.08.18;WA76;Aluminium und Waren daraus;1231857;1373085;-141228
01.08.18;WA78;Blei und Waren daraus;36386;40852;-4466
01.08.18;WA79;Zink und Waren daraus;57018;128303;-71285
01.08.18;WA80;Zinn und Waren daraus;8295;42938;-34643
01.08.18;WA81;Andere unedle Metalle, Cermets usw.;130783;172375;-41592
01.08.18;WA82;Werkzeuge, Schneidwaren, Essbestecke;697786;448784;249002
01.08.18;WA83;Verschiedene Waren aus unedlen Metallen;633554;380986;252568
01.08.18;WA84;Maschinen, Apparate, mechanische Geräte;18929285;10910280;8019005
01.08.18;WA85;Elektrotechnische Erzeugnisse;11378133;10756792;621341
01.08.18;WA86;Schienenfahrzeuge;277519;234329;43190
01.08.18;WA87;Kraftfahrzeuge, Landfahrzeuge;15280938;7688851;7592087
01.08.18;WA88;Luftfahrzeuge, Raumfahrzeuge;2067522;794338;1273184
01.08.18;WA89;Wasserfahrzeuge;740818;140532;600286
01.08.18;WA90;Optische, photografische usw. Erzeugnisse;5464617;2987645;2476972
01.08.18;WA91;Uhrmacherwaren;130906;150158;-19252
01.08.18;WA92;Musikinstrumente;45111;49212;-4101
01.08.18;WA93;Waffen und Munition;41404;17220;24184
01.08.18;WA94;Möbel, Beleuchtungskörper usw.;1267707;1410482;-142775
01.08.18;WA95;Spielzeug, Spiele usw., Sportgeräte;427329;613013;-185684
01.08.18;WA96;Verschiedene Waren;319448;230997;88451
01.08.18;WA97;Kunstgegenstände, Sammlungsstücke;38494;36322;2172
01.08.18;WA98;Vollständige Fabrikationsanlagen;95940;48;95892
01.08.18;WA99;Zusammenstellungen verschiedener Waren;1498696;1055099;443597
01.08.19;WA01;Lebende Tiere;105999;165302;-59303
01.08.19;WA02;Fleisch;694877;541691;153186
01.08.19;WA03;Fische, Krebs- und Weichtiere;120356;330579;-210223
01.08.19;WA04;Milch, Milcherzeugnisse, Eier, Honig;771397;652589;118808
01.08.19;WA05;Andere Waren tierischen Ursprungs;73664;86235;-12571
01.08.19;WA06;Pflanzen, Waren des Blumenhandels;61107;198872;-137765
01.08.19;WA07;Gemüse, Pflanzen für Ernährung;101024;437108;-336084
01.08.19;WA08;Geniessbare Früchte und Nüsse;152499;862842;-710343
01.08.19;WA09;Kaffee, Tee, Mate, Gewürze;215751;303993;-88242
01.08.19;WA10;Getreide;144672;194035;-49363
01.08.19;WA11;Müllereierzeugnisse, Malz usw.;120390;58314;62076
01.08.19;WA12;Ölsamen usw., Heilpflanzen usw.;115696;500300;-384604
01.08.19;WA13;Schellack, Gummen, Harz, Pflanzensaft;53486;43740;9746
01.08.19;WA14;Flechtstoffe usw. pflanzlichen Ursprungs;711;4068;-3357
01.08.19;WA15;Tierische und pflanzliche Fette, Öle, Wachs;218452;264986;-46534
01.08.19;WA16;Zubereitungen von Fleisch, Fisch usw.;263991;252550;11441
01.08.19;WA17;Zucker und Zuckerwaren;180265;129081;51184
01.08.19;WA18;Kakao und Zubereitungen aus Kakao;481404;376389;105015
01.08.19;WA19;Zubereitungen aus Getreide usw., Backwaren;566323;350102;216221
01.08.19;WA20;Zubereitungen von Gemüse, Früchten usw.;244416;383531;-139115
01.08.19;WA21;Verschiedene Lebensmittelzubereitungen;486206;287972;198234
01.08.19;WA22;Getränke, alkoholhaltige Flüssigkeiten, Essig;520571;591785;-71214
01.08.19;WA23;Rückstände der Lebensmittelindustrie, Futter;347095;293907;53188
01.08.19;WA24;Tabak;267746;203632;64114
01.08.19;WA25;Salz, Schwefel, Steine, Erden usw.;146288;158821;-12533
01.08.19;WA26;Erze, Schlacken, Aschen;36641;677669;-641028
01.08.19;WA27;Mineralische Brennstoffe usw.;2534099;7803265;-5269166
01.08.19;WA28;Anorganische chemische Erzeugnisse;834879;514429;320450
01.08.19;WA29;Organische chemische Erzeugnisse;1888754;2528148;-639394
01.08.19;WA30;Pharmazeutische Erzeugnisse;6712313;4262009;2450304
01.08.19;WA31;Düngemittel;170997;63711;107286
01.08.19;WA32;Gerb- und Farbstoffe, Farben, Lacke usw.;900403;454315;446088
01.08.19;WA33;Etherische Öle, Riech-, Schönheitsmittel;849637;592167;257470
01.08.19;WA34;Seifen, Waschmittel usw.;594798;353121;241677
01.08.19;WA35;Eiweissstoffe, Klebstoffe, Enzyme;283229;177906;105323
01.08.19;WA36;Sprengstoffe, pyrotechnische Artikel usw.;23929;13883;10046
01.08.19;WA37;Photochemische Erzeugnisse;95442;67371;28071
01.08.19;WA38;Verschiedene Erzeugnisse der Chemischen Industrie;1685443;1080163;605280
01.08.19;WA39;Kunststoffe und Waren daraus;4573093;3148001;1425092
01.08.19;WA40;Kautschuk und Waren daraus;1153027;1096630;56397
01.08.19;WA41;Häute, Felle, Leder;41559;36040;5519
01.08.19;WA42;Lederwaren, Sattlerwaren;215170;372813;-157643
01.08.19;WA43;Pelzfelle, künstliches Pelzwerk;9742;11542;-1800
01.08.19;WA44;Holz, Holzwaren, Holzkohle;654089;619538;34551
01.08.19;WA45;Kork, Korkwaren;2694;6309;-3615
01.08.19;WA46;Flechtwaren, Korbmacherwaren;3306;9735;-6429
01.08.19;WA47;Halbstoffe aus Holz usw., Papierabfall;98906;335007;-236101
01.08.19;WA48;Papier, Pappe und Waren daraus;1413553;1032772;380781
01.08.19;WA49;Bücher, Zeitungen, Bilddrucke usw.;348284;217739;130545
01.08.19;WA50;Seide;1128;2030;-902
01.08.19;WA51;Wolle, feine und grobe Tierhaare;31080;38059;-6979
01.08.19;WA52;Baumwolle;46052;53348;-7296
01.08.19;WA53;Andere pflanzliche Spinnstoffe, Papiergarn;2244;3883;-1639
01.08.19;WA54;Synthetisches oder künstliches Filament;120471;102416;18055
01.08.19;WA55;Synthetische oder künstliche Spinnfaser;119025;111025;8000
01.08.19;WA56;Watte, Filz, Vliesstoff usw., Tauwerk;191527;120024;71503
01.08.19;WA57;Teppiche, Fussbodenbelag aus Spinnstoff;39458;83011;-43553
01.08.19;WA58;Spezialgewebe, Spitzen, Tapisserien;38297;17664;20633
01.08.19;WA59;Getränkte, bestrichene usw. Gewebe;178380;84298;94082
01.08.19;WA60;Gewirke und Gestricke;49477;27501;21976
01.08.19;WA61;Bekleidung usw. aus Gewirken, Gestricken;913273;1692373;-779100
01.08.19;WA62;Andere Bekleidung, Bekleidungszubehör;993237;1688607;-695370
01.08.19;WA63;Andere Konfektion, Spinnstoffwaren usw.;223840;341617;-117777
01.08.19;WA64;Schuhe, Gamaschen, ähnliche Waren;731153;1127399;-396246
01.08.19;WA65;Kopfbedeckungen und Teile davon;42579;70671;-28092
01.08.19;WA66;Schirme, Gehstöcke usw., Peitschen;7294;17869;-10575
01.08.19;WA67;Zugerichtete Federn, Daunen, künstliche Blumen;11973;25145;-13172
01.08.19;WA68;Waren aus Steinen, Gips, Zement usw.;372395;281901;90494
01.08.19;WA69;Keramische Waren;279862;232873;46989
01.08.19;WA70;Glas und Glaswaren;510695;404902;105793
01.08.19;WA71;Perlen, Edelsteine, Edelmetalle;1503471;1477303;26168
01.08.19;WA72;Eisen und Stahl;1764047;1828760;-64713
01.08.19;WA73;Waren aus Eisen oder Stahl;2137176;1649413;487763
01.08.19;WA74;Kupfer und Waren daraus;763936;659610;104326
01.08.19;WA75;Nickel und Waren daraus;105255;127700;-22445
01.08.19;WA76;Aluminium und Waren daraus;1164708;1204433;-39725
01.08.19;WA78;Blei und Waren daraus;30285;34083;-3798
01.08.19;WA79;Zink und Waren daraus;51433;113723;-62290
01.08.19;WA80;Zinn und Waren daraus;6641;31599;-24958
01.08.19;WA81;Andere unedle Metalle, Cermets usw.;120456;149227;-28771
01.08.19;WA82;Werkzeuge, Schneidwaren, Essbestecke;639174;423869;215305
01.08.19;WA83;Verschiedene Waren aus unedlen Metallen;598214;388940;209274
01.08.19;WA84;Maschinen, Apparate, mechanische Geräte;18483512;10630465;7853047
01.08.19;WA85;Elektrotechnische Erzeugnisse;11357020;10478852;878168
01.08.19;WA86;Schienenfahrzeuge;264958;232710;32248
01.08.19;WA87;Kraftfahrzeuge, Landfahrzeuge;14744748;8344860;6399888
01.08.19;WA88;Luftfahrzeuge, Raumfahrzeuge;1663971;800581;863390
01.08.19;WA89;Wasserfahrzeuge;279411;73888;205523
01.08.19;WA90;Optische, photografische usw. Erzeugnisse;5671149;3132667;2538482
01.08.19;WA91;Uhrmacherwaren;123808;169387;-45579
01.08.19;WA92;Musikinstrumente;49841;56256;-6415
01.08.19;WA93;Waffen und Munition;30855;17437;13418
01.08.19;WA94;Möbel, Beleuchtungskörper usw.;1195466;1421980;-226514
01.08.19;WA95;Spielzeug, Spiele usw., Sportgeräte;521912;729762;-207850
01.08.19;WA96;Verschiedene Waren;319972;237970;82002
01.08.19;WA97;Kunstgegenstände, Sammlungsstücke;47652;40916;6736
01.08.19;WA98;Vollständige Fabrikationsanlagen;98352;11;98341
01.08.19;WA99;Zusammenstellungen verschiedener Waren;1397766;986078;411688
01.08.20;WA01;Lebende Tiere;106898;120509;-13611
01.08.20;WA02;Fleisch;594816;469360;125456
01.08.20;WA03;Fische, Krebs- und Weichtiere;106727;285013;-178286
01.08.20;WA04;Milch, Milcherzeugnisse, Eier, Honig;759486;669390;90096
01.08.20;WA05;Andere Waren tierischen Ursprungs;65905;70495;-4590
01.08.20;WA06;Pflanzen, Waren des Blumenhandels;77620;201904;-124284
01.08.20;WA07;Gemüse, Pflanzen für Ernährung;98091;382877;-284786
01.08.20;WA08;Geniessbare Früchte und Nüsse;159302;863676;-704374
01.08.20;WA09;Kaffee, Tee, Mate, Gewürze;229766;263725;-33959
01.08.20;WA10;Getreide;134373;229952;-95579
01.08.20;WA11;Müllereierzeugnisse, Malz usw.;126602;56419;70183
01.08.20;WA12;Ölsamen usw., Heilpflanzen usw.;105407;500185;-394778
01.08.20;WA13;Schellack, Gummen, Harz, Pflanzensaft;46577;38980;7597
01.08.20;WA14;Flechtstoffe usw. pflanzlichen Ursprungs;798;3445;-2647
01.08.20;WA15;Tierische und pflanzliche Fette, Öle, Wachs;238645;287982;-49337
01.08.20;WA16;Zubereitungen von Fleisch, Fisch usw.;279785;234956;44829
01.08.20;WA17;Zucker und Zuckerwaren;183265;127629;55636
01.08.20;WA18;Kakao und Zubereitungen aus Kakao;438180;370259;67921
01.08.20;WA19;Zubereitungen aus Getreide usw., Backwaren;557448;343956;213492
01.08.20;WA20;Zubereitungen von Gemüse, Früchten usw.;233176;378283;-145107
01.08.20;WA21;Verschiedene Lebensmittelzubereitungen;506573;306601;199972
01.08.20;WA22;Getränke, alkoholhaltige Flüssigkeiten, Essig;488142;596571;-108429
01.08.20;WA23;Rückstände der Lebensmittelindustrie, Futter;407733;332405;75328
01.08.20;WA24;Tabak;216108;205404;10704
01.08.20;WA25;Salz, Schwefel, Steine, Erden usw.;140320;137860;2460
01.08.20;WA26;Erze, Schlacken, Aschen;28828;574664;-545836
01.08.20;WA27;Mineralische Brennstoffe usw.;1772245;4836947;-3064702
01.08.20;WA28;Anorganische chemische Erzeugnisse;746460;439783;306677
01.08.20;WA29;Organische chemische Erzeugnisse;1745148;2681251;-936103
01.08.20;WA30;Pharmazeutische Erzeugnisse;6478059;4164891;2313168
01.08.20;WA31;Düngemittel;128207;47931;80276
01.08.20;WA32;Gerb- und Farbstoffe, Farben, Lacke usw.;797091;410005;387086
01.08.20;WA33;Etherische Öle, Riech-, Schönheitsmittel;766895;588099;178796
01.08.20;WA34;Seifen, Waschmittel usw.;569295;318594;250701
01.08.20;WA35;Eiweissstoffe, Klebstoffe, Enzyme;276987;169688;107299
01.08.20;WA36;Sprengstoffe, pyrotechnische Artikel usw.;19188;26276;-7088
01.08.20;WA37;Photochemische Erzeugnisse;73942;46245;27697
01.08.20;WA38;Verschiedene Erzeugnisse der Chemischen Industrie;1770305;1202647;567658
01.08.20;WA39;Kunststoffe und Waren daraus;4273898;2830263;1443635
01.08.20;WA40;Kautschuk und Waren daraus;1075874;1021912;53962
01.08.20;WA41;Häute, Felle, Leder;32436;24339;8097
01.08.20;WA42;Lederwaren, Sattlerwaren;178609;300219;-121610
01.08.20;WA43;Pelzfelle, künstliches Pelzwerk;3875;7307;-3432
01.08.20;WA44;Holz, Holzwaren, Holzkohle;703886;621879;82007
01.08.20;WA45;Kork, Korkwaren;2359;10929;-8570
01.08.20;WA46;Flechtwaren, Korbmacherwaren;4696;12534;-7838
01.08.20;WA47;Halbstoffe aus Holz usw., Papierabfall;72745;215891;-143146
01.08.20;WA48;Papier, Pappe und Waren daraus;1304469;881690;422779
01.08.20;WA49;Bücher, Zeitungen, Bilddrucke usw.;288271;214134;74137
01.08.20;WA50;Seide;594;2161;-1567
01.08.20;WA51;Wolle, feine und grobe Tierhaare;19479;27471;-7992
01.08.20;WA52;Baumwolle;40972;47060;-6088
01.08.20;WA53;Andere pflanzliche Spinnstoffe, Papiergarn;1740;4123;-2383
01.08.20;WA54;Synthetisches oder künstliches Filament;97741;76106;21635
01.08.20;WA55;Synthetische oder künstliche Spinnfaser;102157;80543;21614
01.08.20;WA56;Watte, Filz, Vliesstoff usw., Tauwerk;182741;115139;67602
01.08.20;WA57;Teppiche, Fussbodenbelag aus Spinnstoff;38327;87052;-48725
01.08.20;WA58;Spezialgewebe, Spitzen, Tapisserien;30629;16264;14365
01.08.20;WA59;Getränkte, bestrichene usw. Gewebe;156524;76709;79815
01.08.20;WA60;Gewirke und Gestricke;41084;26504;14580
01.08.20;WA61;Bekleidung usw. aus Gewirken, Gestricken;948408;1703040;-754632
01.08.20;WA62;Andere Bekleidung, Bekleidungszubehör;980360;1597190;-616830
01.08.20;WA63;Andere Konfektion, Spinnstoffwaren usw.;302217;543600;-241383
01.08.20;WA64;Schuhe, Gamaschen, ähnliche Waren;684621;1023852;-339231
01.08.20;WA65;Kopfbedeckungen und Teile davon;41348;63692;-22344
01.08.20;WA66;Schirme, Gehstöcke usw., Peitschen;6363;13906;-7543
01.08.20;WA67;Zugerichtete Federn, Daunen, künstliche Blumen;11885;22636;-10751
01.08.20;WA68;Waren aus Steinen, Gips, Zement usw.;349687;249038;100649
01.08.20;WA69;Keramische Waren;259707;225262;34445
01.08.20;WA70;Glas und Glaswaren;467550;350984;116566
01.08.20;WA71;Perlen, Edelsteine, Edelmetalle;1769396;1660739;108657
01.08.20;WA72;Eisen und Stahl;1423634;1354688;68946
01.08.20;WA73;Waren aus Eisen oder Stahl;1883404;1492739;390665
01.08.20;WA74;Kupfer und Waren daraus;812897;784273;28624
01.08.20;WA75;Nickel und Waren daraus;95683;84209;11474
01.08.20;WA76;Aluminium und Waren daraus;990739;991196;-457
01.08.20;WA78;Blei und Waren daraus;23674;27060;-3386
01.08.20;WA79;Zink und Waren daraus;42346;84341;-41995
01.08.20;WA80;Zinn und Waren daraus;6268;22082;-15814
01.08.20;WA81;Andere unedle Metalle, Cermets usw.;78740;88624;-9884
01.08.20;WA82;Werkzeuge, Schneidwaren, Essbestecke;564698;397618;167080
01.08.20;WA83;Verschiedene Waren aus unedlen Metallen;552055;349934;202121
01.08.20;WA84;Maschinen, Apparate, mechanische Geräte;15550363;9510877;6039486
01.08.20;WA85;Elektrotechnische Erzeugnisse;10465900;10268650;197250
01.08.20;WA86;Schienenfahrzeuge;227803;249089;-21286
01.08.20;WA87;Kraftfahrzeuge, Landfahrzeuge;12640710;8762253;3878457
01.08.20;WA88;Luftfahrzeuge, Raumfahrzeuge;1379221;1185063;194158
01.08.20;WA89;Wasserfahrzeuge;402225;32774;369451
01.08.20;WA90;Optische, photografische usw. Erzeugnisse;5046283;2963200;2083083
01.08.20;WA91;Uhrmacherwaren;110491;159775;-49284
01.08.20;WA92;Musikinstrumente;43032;51233;-8201
01.08.20;WA93;Waffen und Munition;35643;21711;13932
01.08.20;WA94;Möbel, Beleuchtungskörper usw.;1106553;1456109;-349556
01.08.20;WA95;Spielzeug, Spiele usw., Sportgeräte;431929;623626;-191697
01.08.20;WA96;Verschiedene Waren;307249;224732;82517
01.08.20;WA97;Kunstgegenstände, Sammlungsstücke;42387;139601;-97214
01.08.20;WA98;Vollständige Fabrikationsanlagen;58617;NULL;#WERT!
01.08.20;WA99;Zusammenstellungen verschiedener Waren;971095;834094;137001
01.08.21;WA01;Lebende Tiere;95526;92252;3274
01.08.21;WA02;Fleisch;541445;510309;31136
01.08.21;WA03;Fische, Krebs- und Weichtiere;98134;301544;-203410
01.08.21;WA04;Milch, Milcherzeugnisse, Eier, Honig;814658;681783;132875
01.08.21;WA05;Andere Waren tierischen Ursprungs;64129;79215;-15086
01.08.21;WA06;Pflanzen, Waren des Blumenhandels;66718;216693;-149975
01.08.21;WA07;Gemüse, Pflanzen für Ernährung;73349;416607;-343258
01.08.21;WA08;Geniessbare Früchte und Nüsse;147428;885675;-738247
01.08.21;WA09;Kaffee, Tee, Mate, Gewürze;258373;340583;-82210
01.08.21;WA10;Getreide;233073;242871;-9798
01.08.21;WA11;Müllereierzeugnisse, Malz usw.;132087;60083;72004
01.08.21;WA12;Ölsamen usw., Heilpflanzen usw.;115755;684105;-568350
01.08.21;WA13;Schellack, Gummen, Harz, Pflanzensaft;56323;48235;8088
01.08.21;WA14;Flechtstoffe usw. pflanzlichen Ursprungs;810;3947;-3137
01.08.21;WA15;Tierische und pflanzliche Fette, Öle, Wachs;309015;388680;-79665
01.08.21;WA16;Zubereitungen von Fleisch, Fisch usw.;263881;256194;7687
01.08.21;WA17;Zucker und Zuckerwaren;236520;139938;96582
01.08.21;WA18;Kakao und Zubereitungen aus Kakao;493077;385068;108009
01.08.21;WA19;Zubereitungen aus Getreide usw., Backwaren;576948;370641;206307
01.08.21;WA20;Zubereitungen von Gemüse, Früchten usw.;226902;424341;-197439
01.08.21;WA21;Verschiedene Lebensmittelzubereitungen;519849;339984;179865
01.08.21;WA22;Getränke, alkoholhaltige Flüssigkeiten, Essig;520983;631241;-110258
01.08.21;WA23;Rückstände der Lebensmittelindustrie, Futter;467051;328650;138401
01.08.21;WA24;Tabak;207953;233899;-25946
01.08.21;WA25;Salz, Schwefel, Steine, Erden usw.;141381;154824;-13443
01.08.21;WA26;Erze, Schlacken, Aschen;65082;1101573;-1036491
01.08.21;WA27;Mineralische Brennstoffe usw.;2361344;7983426;-5622082
01.08.21;WA28;Anorganische chemische Erzeugnisse;1127988;560502;567486
01.08.21;WA29;Organische chemische Erzeugnisse;2351784;3276819;-925035
01.08.21;WA30;Pharmazeutische Erzeugnisse;8711003;4621292;4089711
01.08.21;WA31;Düngemittel;187677;61880;125797
01.08.21;WA32;Gerb- und Farbstoffe, Farben, Lacke usw.;949930;523442;426488
01.08.21;WA33;Etherische Öle, Riech-, Schönheitsmittel;852301;604936;247365
01.08.21;WA34;Seifen, Waschmittel usw.;676181;371685;304496
01.08.21;WA35;Eiweissstoffe, Klebstoffe, Enzyme;338770;218861;119909
01.08.21;WA36;Sprengstoffe, pyrotechnische Artikel usw.;23110;10487;12623
01.08.21;WA37;Photochemische Erzeugnisse;82665;48272;34393
01.08.21;WA38;Verschiedene Erzeugnisse der Chemischen Industrie;2205656;1411224;794432
01.08.21;WA39;Kunststoffe und Waren daraus;5472723;3838657;1634066
01.08.21;WA40;Kautschuk und Waren daraus;1168115;1213322;-45207
01.08.21;WA41;Häute, Felle, Leder;44085;35060;9025
01.08.21;WA42;Lederwaren, Sattlerwaren;207770;351361;-143591
01.08.21;WA43;Pelzfelle, künstliches Pelzwerk;5604;8611;-3007
01.08.21;WA44;Holz, Holzwaren, Holzkohle;951476;892232;59244
01.08.21;WA45;Kork, Korkwaren;2448;10207;-7759
01.08.21;WA46;Flechtwaren, Korbmacherwaren;4484;14220;-9736
01.08.21;WA47;Halbstoffe aus Holz usw., Papierabfall;107545;355689;-248144
01.08.21;WA48;Papier, Pappe und Waren daraus;1551596;1027890;523706
01.08.21;WA49;Bücher, Zeitungen, Bilddrucke usw.;349921;246024;103897
01.08.21;WA50;Seide;798;829;-31
01.08.21;WA51;Wolle, feine und grobe Tierhaare;26452;29259;-2807
01.08.21;WA52;Baumwolle;40547;49952;-9405
01.08.21;WA53;Andere pflanzliche Spinnstoffe, Papiergarn;1830;4347;-2517
01.08.21;WA54;Synthetisches oder künstliches Filament;113979;91110;22869
01.08.21;WA55;Synthetische oder künstliche Spinnfaser;106152;99550;6602
01.08.21;WA56;Watte, Filz, Vliesstoff usw., Tauwerk;200612;138439;62173
01.08.21;WA57;Teppiche, Fussbodenbelag aus Spinnstoff;39240;84941;-45701
01.08.21;WA58;Spezialgewebe, Spitzen, Tapisserien;35435;18859;16576
01.08.21;WA59;Getränkte, bestrichene usw. Gewebe;175762;88623;87139
01.08.21;WA60;Gewirke und Gestricke;45021;28067;16954
01.08.21;WA61;Bekleidung usw. aus Gewirken, Gestricken;963087;1778881;-815794
01.08.21;WA62;Andere Bekleidung, Bekleidungszubehör;852682;1399543;-546861
01.08.21;WA63;Andere Konfektion, Spinnstoffwaren usw.;265090;453192;-188102
01.08.21;WA64;Schuhe, Gamaschen, ähnliche Waren;747273;1054846;-307573
01.08.21;WA65;Kopfbedeckungen und Teile davon;47767;76648;-28881
01.08.21;WA66;Schirme, Gehstöcke usw., Peitschen;6283;17894;-11611
01.08.21;WA67;Zugerichtete Federn, Daunen, künstliche Blumen;14609;24593;-9984
01.08.21;WA68;Waren aus Steinen, Gips, Zement usw.;396832;277057;119775
01.08.21;WA69;Keramische Waren;296167;267418;28749
01.08.21;WA70;Glas und Glaswaren;527004;405739;121265
01.08.21;WA71;Perlen, Edelsteine, Edelmetalle;1591813;2878386;-1286573
01.08.21;WA72;Eisen und Stahl;2172943;2613495;-440552
01.08.21;WA73;Waren aus Eisen oder Stahl;2269718;1947470;322248
01.08.21;WA74;Kupfer und Waren daraus;1111453;815862;295591
01.08.21;WA75;Nickel und Waren daraus;109942;128807;-18865
01.08.21;WA76;Aluminium und Waren daraus;1214550;1444486;-229936
01.08.21;WA78;Blei und Waren daraus;43555;38006;5549
01.08.21;WA79;Zink und Waren daraus;53674;116294;-62620
01.08.21;WA80;Zinn und Waren daraus;10158;48805;-38647
01.08.21;WA81;Andere unedle Metalle, Cermets usw.;94966;118994;-24028
01.08.21;WA82;Werkzeuge, Schneidwaren, Essbestecke;710406;465724;244682
01.08.21;WA83;Verschiedene Waren aus unedlen Metallen;600185;414454;185731
01.08.21;WA84;Maschinen, Apparate, mechanische Geräte;17854876;11168158;6686718
01.08.21;WA85;Elektrotechnische Erzeugnisse;11945474;11548421;397053
01.08.21;WA86;Schienenfahrzeuge;223766;168084;55682
01.08.21;WA87;Kraftfahrzeuge, Landfahrzeuge;11344019;6631180;4712839
01.08.21;WA88;Luftfahrzeuge, Raumfahrzeuge;1628924;1378169;250755
01.08.21;WA89;Wasserfahrzeuge;136255;164146;-27891
01.08.21;WA90;Optische, photografische usw. Erzeugnisse;5694876;3289747;2405129
01.08.21;WA91;Uhrmacherwaren;128529;173140;-44611
01.08.21;WA92;Musikinstrumente;55531;60680;-5149
01.08.21;WA93;Waffen und Munition;38281;21655;16626
01.08.21;WA94;Möbel, Beleuchtungskörper usw.;1181649;1644926;-463277
01.08.21;WA95;Spielzeug, Spiele usw., Sportgeräte;430892;748976;-318084
01.08.21;WA96;Verschiedene Waren;311370;274345;37025
01.08.21;WA97;Kunstgegenstände, Sammlungsstücke;86580;48590;37990
01.08.21;WA98;Vollständige Fabrikationsanlagen;53217;NULL;#WERT!
01.08.21;WA99;Zusammenstellungen verschiedener Waren;1374935;824463;550472
01.08.22;WA01;Lebende Tiere;121852;107931;13921
01.08.22;WA02;Fleisch;700240;631661;68579
01.08.22;WA03;Fische, Krebs- und Weichtiere;143110;401040;-257930
01.08.22;WA04;Milch, Milcherzeugnisse, Eier, Honig;1157895;953431;204464
01.08.22;WA05;Andere Waren tierischen Ursprungs;86516;112736;-26220
01.08.22;WA06;Pflanzen, Waren des Blumenhandels;76936;188805;-111869
01.08.22;WA07;Gemüse, Pflanzen für Ernährung;103933;450525;-346592
01.08.22;WA08;Geniessbare Früchte und Nüsse;164054;1070145;-906091
01.08.22;WA09;Kaffee, Tee, Mate, Gewürze;339236;554202;-214966
01.08.22;WA10;Getreide;380102;338364;41738
01.08.22;WA11;Müllereierzeugnisse, Malz usw.;179578;75768;103810
01.08.22;WA12;Ölsamen usw., Heilpflanzen usw.;126663;574011;-447348
01.08.22;WA13;Schellack, Gummen, Harz, Pflanzensaft;62409;69822;-7413
01.08.22;WA14;Flechtstoffe usw. pflanzlichen Ursprungs;985;4810;-3825
01.08.22;WA15;Tierische und pflanzliche Fette, Öle, Wachs;372722;635343;-262621
01.08.22;WA16;Zubereitungen von Fleisch, Fisch usw.;312969;310248;2721
01.08.22;WA17;Zucker und Zuckerwaren;291239;163501;127738
01.08.22;WA18;Kakao und Zubereitungen aus Kakao;580397;404301;176096
01.08.22;WA19;Zubereitungen aus Getreide usw., Backwaren;740537;453269;287268
01.08.22;WA20;Zubereitungen von Gemüse, Früchten usw.;271564;487717;-216153
01.08.22;WA21;Verschiedene Lebensmittelzubereitungen;682681;390001;292680
01.08.22;WA22;Getränke, alkoholhaltige Flüssigkeiten, Essig;652811;794148;-141337
01.08.22;WA23;Rückstände der Lebensmittelindustrie, Futter;572860;475157;97703
01.08.22;WA24;Tabak;261734;290502;-28768
01.08.22;WA25;Salz, Schwefel, Steine, Erden usw.;179634;195566;-15932
01.08.22;WA26;Erze, Schlacken, Aschen;91259;857168;-765909
01.08.22;WA27;Mineralische Brennstoffe usw.;5910151;22738663;-16828512
01.08.22;WA28;Anorganische chemische Erzeugnisse;1409386;852656;556730
01.08.22;WA29;Organische chemische Erzeugnisse;2807413;4955604;-2148191
01.08.22;WA30;Pharmazeutische Erzeugnisse;9848377;6516826;3331551
01.08.22;WA31;Düngemittel;387007;209189;177818
01.08.22;WA32;Gerb- und Farbstoffe, Farben, Lacke usw.;1046322;553753;492569
01.08.22;WA33;Etherische Öle, Riech-, Schönheitsmittel;1024089;687620;336469
01.08.22;WA34;Seifen, Waschmittel usw.;793204;466467;326737
01.08.22;WA35;Eiweissstoffe, Klebstoffe, Enzyme;407881;253583;154298
01.08.22;WA36;Sprengstoffe, pyrotechnische Artikel usw.;20911;19865;1046
01.08.22;WA37;Photochemische Erzeugnisse;92936;57622;35314
01.08.22;WA38;Verschiedene Erzeugnisse der Chemischen Industrie;2851302;2061913;789389
01.08.22;WA39;Kunststoffe und Waren daraus;6266631;4478359;1788272
01.08.22;WA40;Kautschuk und Waren daraus;1389816;1396694;-6878
01.08.22;WA41;Häute, Felle, Leder;45822;35505;10317
01.08.22;WA42;Lederwaren, Sattlerwaren;270763;434032;-163269
01.08.22;WA43;Pelzfelle, künstliches Pelzwerk;6504;9591;-3087
01.08.22;WA44;Holz, Holzwaren, Holzkohle;926405;855718;70687
01.08.22;WA45;Kork, Korkwaren;1955;8720;-6765
01.08.22;WA46;Flechtwaren, Korbmacherwaren;5932;16553;-10621
01.08.22;WA47;Halbstoffe aus Holz usw., Papierabfall;130503;494137;-363634
01.08.22;WA48;Papier, Pappe und Waren daraus;2094299;1383316;710983
01.08.22;WA49;Bücher, Zeitungen, Bilddrucke usw.;326303;268919;57384
01.08.22;WA50;Seide;1536;2349;-813
01.08.22;WA51;Wolle, feine und grobe Tierhaare;39624;44868;-5244
01.08.22;WA52;Baumwolle;55998;75246;-19248
01.08.22;WA53;Andere pflanzliche Spinnstoffe, Papiergarn;3513;6326;-2813
01.08.22;WA54;Synthetisches oder künstliches Filament;133580;119130;14450
01.08.22;WA55;Synthetische oder künstliche Spinnfaser;117396;117711;-315
01.08.22;WA56;Watte, Filz, Vliesstoff usw., Tauwerk;223658;152153;71505
01.08.22;WA57;Teppiche, Fussbodenbelag aus Spinnstoff;43382;94852;-51470
01.08.22;WA58;Spezialgewebe, Spitzen, Tapisserien;41338;21299;20039
01.08.22;WA59;Getränkte, bestrichene usw. Gewebe;221449;100170;121279
01.08.22;WA60;Gewirke und Gestricke;47029;28876;18153
01.08.22;WA61;Bekleidung usw. aus Gewirken, Gestricken;1159011;2402227;-1243216
01.08.22;WA62;Andere Bekleidung, Bekleidungszubehör;1017165;1982952;-965787
01.08.22;WA63;Andere Konfektion, Spinnstoffwaren usw.;280787;523119;-242332
01.08.22;WA64;Schuhe, Gamaschen, ähnliche Waren;982822;1407805;-424983
01.08.22;WA65;Kopfbedeckungen und Teile davon;62034;104933;-42899
01.08.22;WA66;Schirme, Gehstöcke usw., Peitschen;10914;18123;-7209
01.08.22;WA67;Zugerichtete Federn, Daunen, künstliche Blumen;14681;39559;-24878
01.08.22;WA68;Waren aus Steinen, Gips, Zement usw.;453125;328707;124418
01.08.22;WA69;Keramische Waren;328143;295866;32277
01.08.22;WA70;Glas und Glaswaren;653939;478926;175013
01.08.22;WA71;Perlen, Edelsteine, Edelmetalle;1825246;2519379;-694133
01.08.22;WA72;Eisen und Stahl;2554808;2857516;-302708
01.08.22;WA73;Waren aus Eisen oder Stahl;2647210;2435923;211287
01.08.22;WA74;Kupfer und Waren daraus;1038539;1104489;-65950
01.08.22;WA75;Nickel und Waren daraus;166179;194492;-28313
01.08.22;WA76;Aluminium und Waren daraus;1663490;2048011;-384521
01.08.22;WA78;Blei und Waren daraus;23837;37386;-13549
01.08.22;WA79;Zink und Waren daraus;61293;140945;-79652
01.08.22;WA80;Zinn und Waren daraus;13900;46754;-32854
01.08.22;WA81;Andere unedle Metalle, Cermets usw.;152804;206652;-53848
01.08.22;WA82;Werkzeuge, Schneidwaren, Essbestecke;754625;531312;223313
01.08.22;WA83;Verschiedene Waren aus unedlen Metallen;679633;471837;207796
01.08.22;WA84;Maschinen, Apparate, mechanische Geräte;20204460;13097998;7106462
01.08.22;WA85;Elektrotechnische Erzeugnisse;14638237;16269048;-1630811
01.08.22;WA86;Schienenfahrzeuge;186217;263927;-77710
01.08.22;WA87;Kraftfahrzeuge, Landfahrzeuge;18047974;9120075;8927899
01.08.22;WA88;Luftfahrzeuge, Raumfahrzeuge;1605379;1015717;589662
01.08.22;WA89;Wasserfahrzeuge;252505;105780;146725
01.08.22;WA90;Optische, photografische usw. Erzeugnisse;6362505;3703164;2659341
01.08.22;WA91;Uhrmacherwaren;155708;226241;-70533
01.08.22;WA92;Musikinstrumente;71555;67663;3892
01.08.22;WA93;Waffen und Munition;57584;35503;22081
01.08.22;WA94;Möbel, Beleuchtungskörper usw.;1380760;1788745;-407985
01.08.22;WA95;Spielzeug, Spiele usw., Sportgeräte;501923;812014;-310091
01.08.22;WA96;Verschiedene Waren;375519;313490;62029
01.08.22;WA97;Kunstgegenstände, Sammlungsstücke;83192;42820;40372
01.08.22;WA98;Vollständige Fabrikationsanlagen;61327;95;61232
01.08.22;WA99;Zusammenstellungen verschiedener Waren;1516173;860136;656037
01.08.23;WA01;Lebende Tiere;140705;165907;-25202
01.08.23;WA02;Fleisch;654778;631787;22991
01.08.23;WA03;Fische, Krebs- und Weichtiere;130875;320266;-189391
01.08.23;WA04;Milch, Milcherzeugnisse, Eier, Honig;1013223;857104;156119
01.08.23;WA05;Andere Waren tierischen Ursprungs;73563;93780;-20217
01.08.23;WA06;Pflanzen, Waren des Blumenhandels;61146;183648;-122502
01.08.23;WA07;Gemüse, Pflanzen für Ernährung;136289;513878;-377589
01.08.23;WA08;Geniessbare Früchte und Nüsse;165204;973275;-808071
01.08.23;WA09;Kaffee, Tee, Mate, Gewürze;305723;400045;-94322
01.08.23;WA10;Getreide;206415;295542;-89127
01.08.23;WA11;Müllereierzeugnisse, Malz usw.;195698;85180;110518
01.08.23;WA12;Ölsamen usw., Heilpflanzen usw.;138491;685515;-547024
01.08.23;WA13;Schellack, Gummen, Harz, Pflanzensaft;47841;49439;-1598
01.08.23;WA14;Flechtstoffe usw. pflanzlichen Ursprungs;850;3617;-2767
01.08.23;WA15;Tierische und pflanzliche Fette, Öle, Wachs;313807;450455;-136648
01.08.23;WA16;Zubereitungen von Fleisch, Fisch usw.;328303;320108;8195
01.08.23;WA17;Zucker und Zuckerwaren;295968;230474;65494
01.08.23;WA18;Kakao und Zubereitungen aus Kakao;619684;480201;139483
01.08.23;WA19;Zubereitungen aus Getreide usw., Backwaren;852641;546090;306551
01.08.23;WA20;Zubereitungen von Gemüse, Früchten usw.;292385;532739;-240354
01.08.23;WA21;Verschiedene Lebensmittelzubereitungen;729152;577542;151610
01.08.23;WA22;Getränke, alkoholhaltige Flüssigkeiten, Essig;650647;729853;-79206
01.08.23;WA23;Rückstände der Lebensmittelindustrie, Futter;606259;432701;173558
01.08.23;WA24;Tabak;278515;467418;-188903
01.08.23;WA25;Salz, Schwefel, Steine, Erden usw.;185175;158538;26637
01.08.23;WA26;Erze, Schlacken, Aschen;58341;733549;-675208
01.08.23;WA27;Mineralische Brennstoffe usw.;2705973;9472582;-6766609
01.08.23;WA28;Anorganische chemische Erzeugnisse;1046228;626906;419322
01.08.23;WA29;Organische chemische Erzeugnisse;2198449;2956473;-758024
01.08.23;WA30;Pharmazeutische Erzeugnisse;9255562;5411234;3844328
01.08.23;WA31;Düngemittel;229817;112201;117616
01.08.23;WA32;Gerb- und Farbstoffe, Farben, Lacke usw.;950036;432271;517765
01.08.23;WA33;Etherische Öle, Riech-, Schönheitsmittel;1076598;761790;314808
01.08.23;WA34;Seifen, Waschmittel usw.;727888;469247;258641
01.08.23;WA35;Eiweissstoffe, Klebstoffe, Enzyme;358508;219781;138727
01.08.23;WA36;Sprengstoffe, pyrotechnische Artikel usw.;30352;30538;-186
01.08.23;WA37;Photochemische Erzeugnisse;74866;45166;29700
01.08.23;WA38;Verschiedene Erzeugnisse der Chemischen Industrie;2552536;1637894;914642
01.08.23;WA39;Kunststoffe und Waren daraus;5393927;3507659;1886268
01.08.23;WA40;Kautschuk und Waren daraus;1381990;1240743;141247
01.08.23;WA41;Häute, Felle, Leder;36159;26013;10146
01.08.23;WA42;Lederwaren, Sattlerwaren;261845;391691;-129846
01.08.23;WA43;Pelzfelle, künstliches Pelzwerk;5040;9597;-4557
01.08.23;WA44;Holz, Holzwaren, Holzkohle;745936;633036;112900
01.08.23;WA45;Kork, Korkwaren;1852;5283;-3431
01.08.23;WA46;Flechtwaren, Korbmacherwaren;4879;9252;-4373
01.08.23;WA47;Halbstoffe aus Holz usw., Papierabfall;101466;267899;-166433
01.08.23;WA48;Papier, Pappe und Waren daraus;1617679;1073821;543858
01.08.23;WA49;Bücher, Zeitungen, Bilddrucke usw.;288947;228160;60787
01.08.23;WA50;Seide;1304;2469;-1165
01.08.23;WA51;Wolle, feine und grobe Tierhaare;28488;33679;-5191
01.08.23;WA52;Baumwolle;50095;47244;2851
01.08.23;WA53;Andere pflanzliche Spinnstoffe, Papiergarn;2434;4379;-1945
01.08.23;WA54;Synthetisches oder künstliches Filament;125458;102462;22996
01.08.23;WA55;Synthetische oder künstliche Spinnfaser;110360;98775;11585
01.08.23;WA56;Watte, Filz, Vliesstoff usw., Tauwerk;204515;131289;73226
01.08.23;WA57;Teppiche, Fussbodenbelag aus Spinnstoff;46404;78356;-31952
01.08.23;WA58;Spezialgewebe, Spitzen, Tapisserien;41858;20614;21244
01.08.23;WA59;Getränkte, bestrichene usw. Gewebe;212309;99275;113034
01.08.23;WA60;Gewirke und Gestricke;49696;29476;20220
01.08.23;WA61;Bekleidung usw. aus Gewirken, Gestricken;1185453;1906260;-720807
01.08.23;WA62;Andere Bekleidung, Bekleidungszubehör;1114594;1638094;-523500
01.08.23;WA63;Andere Konfektion, Spinnstoffwaren usw.;267663;375720;-108057
01.08.23;WA64;Schuhe, Gamaschen, ähnliche Waren;936433;1075346;-138913
01.08.23;WA65;Kopfbedeckungen und Teile davon;64421;81556;-17135
01.08.23;WA66;Schirme, Gehstöcke usw., Peitschen;8021;15960;-7939
01.08.23;WA67;Zugerichtete Federn, Daunen, künstliche Blumen;13751;26002;-12251
01.08.23;WA68;Waren aus Steinen, Gips, Zement usw.;429166;295912;133254
01.08.23;WA69;Keramische Waren;307245;227152;80093
01.08.23;WA70;Glas und Glaswaren;607497;464168;143329
01.08.23;WA71;Perlen, Edelsteine, Edelmetalle;1405868;1610784;-204916
01.08.23;WA72;Eisen und Stahl;2312807;2051995;260812
01.08.23;WA73;Waren aus Eisen oder Stahl;2780094;2091834;688260
01.08.23;WA74;Kupfer und Waren daraus;1092953;882187;210766
01.08.23;WA75;Nickel und Waren daraus;172721;176050;-3329
01.08.23;WA76;Aluminium und Waren daraus;1425395;1638589;-213194
01.08.23;WA78;Blei und Waren daraus;39798;40098;-300
01.08.23;WA79;Zink und Waren daraus;46200;131862;-85662
01.08.23;WA80;Zinn und Waren daraus;11110;42251;-31141
01.08.23;WA81;Andere unedle Metalle, Cermets usw.;125062;160762;-35700
01.08.23;WA82;Werkzeuge, Schneidwaren, Essbestecke;750782;465534;285248
01.08.23;WA83;Verschiedene Waren aus unedlen Metallen;662017;426192;235825
01.08.23;WA84;Maschinen, Apparate, mechanische Geräte;20464353;12727445;7736908
01.08.23;WA85;Elektrotechnische Erzeugnisse;14527084;16033675;-1506591
01.08.23;WA86;Schienenfahrzeuge;220873;256262;-35389
01.08.23;WA87;Kraftfahrzeuge, Landfahrzeuge;19637385;10667468;8969917
01.08.23;WA88;Luftfahrzeuge, Raumfahrzeuge;2241203;839864;1401339
01.08.23;WA89;Wasserfahrzeuge;526745;150722;376023
01.08.23;WA90;Optische, photografische usw. Erzeugnisse;6447365;3629699;2817666
01.08.23;WA91;Uhrmacherwaren;144052;191472;-47420
01.08.23;WA92;Musikinstrumente;74643;57893;16750
01.08.23;WA93;Waffen und Munition;51891;56468;-4577
01.08.23;WA94;Möbel, Beleuchtungskörper usw.;1380884;1580570;-199686
01.08.23;WA95;Spielzeug, Spiele usw., Sportgeräte;441538;687673;-246135
01.08.23;WA96;Verschiedene Waren;347380;289991;57389
01.08.23;WA97;Kunstgegenstände, Sammlungsstücke;67357;45176;22181
01.08.23;WA98;Vollständige Fabrikationsanlagen;271285;7;271278
01.08.23;WA99;Zusammenstellungen verschiedener Waren;1266097;926273;339824
01.08.24;WA01;Lebende Tiere;129168;132850;-3682
01.08.24;WA02;Fleisch;634806;623249;11557
01.08.24;WA03;Fische, Krebs- und Weichtiere;128056;320076;-192020
01.08.24;WA04;Milch, Milcherzeugnisse, Eier, Honig;1052709;918945;133764
01.08.24;WA05;Andere Waren tierischen Ursprungs;67820;88508;-20688
01.08.24;WA06;Pflanzen, Waren des Blumenhandels;61730;184200;-122470
01.08.24;WA07;Gemüse, Pflanzen für Ernährung;139498;516559;-377061
01.08.24;WA08;Geniessbare Früchte und Nüsse;157802;1070760;-912958
01.08.24;WA09;Kaffee, Tee, Mate, Gewürze;350204;503606;-153402
01.08.24;WA10;Getreide;167727;263220;-95493
01.08.24;WA11;Müllereierzeugnisse, Malz usw.;173078;83383;89695
01.08.24;WA12;Ölsamen usw., Heilpflanzen usw.;116983;614952;-497969
01.08.24;WA13;Schellack, Gummen, Harz, Pflanzensaft;51760;51859;-99
01.08.24;WA14;Flechtstoffe usw. pflanzlichen Ursprungs;1084;3696;-2612
01.08.24;WA15;Tierische und pflanzliche Fette, Öle, Wachs;272337;417020;-144683
01.08.24;WA16;Zubereitungen von Fleisch, Fisch usw.;307483;309131;-1648
01.08.24;WA17;Zucker und Zuckerwaren;333350;217787;115563
01.08.24;WA18;Kakao und Zubereitungen aus Kakao;900699;760566;140133
01.08.24;WA19;Zubereitungen aus Getreide usw., Backwaren;855564;536204;319360
01.08.24;WA20;Zubereitungen von Gemüse, Früchten usw.;296097;544763;-248666
01.08.24;WA21;Verschiedene Lebensmittelzubereitungen;759644;469513;290131
01.08.24;WA22;Getränke, alkoholhaltige Flüssigkeiten, Essig;653309;704141;-50832
01.08.24;WA23;Rückstände der Lebensmittelindustrie, Futter;562200;432159;130041
01.08.24;WA24;Tabak;288278;468531;-180253
01.08.24;WA25;Salz, Schwefel, Steine, Erden usw.;179424;164228;15196
01.08.24;WA26;Erze, Schlacken, Aschen;44303;753463;-709160
01.08.24;WA27;Mineralische Brennstoffe usw.;2514771;9500485;-6985714
01.08.24;WA28;Anorganische chemische Erzeugnisse;1146398;660594;485804
01.08.24;WA29;Organische chemische Erzeugnisse;2123525;2516689;-393164
01.08.24;WA30;Pharmazeutische Erzeugnisse;9790141;5634514;4155627
01.08.24;WA31;Düngemittel;228625;92020;136605
01.08.24;WA32;Gerb- und Farbstoffe, Farben, Lacke usw.;926122;452545;473577
01.08.24;WA33;Etherische Öle, Riech-, Schönheitsmittel;966939;745029;221910
01.08.24;WA34;Seifen, Waschmittel usw.;749819;465497;284322
01.08.24;WA35;Eiweissstoffe, Klebstoffe, Enzyme;382232;234700;147532
01.08.24;WA36;Sprengstoffe, pyrotechnische Artikel usw.;30240;49025;-18785
01.08.24;WA37;Photochemische Erzeugnisse;75826;47907;27919
01.08.24;WA38;Verschiedene Erzeugnisse der Chemischen Industrie;2511881;1506102;1005779
01.08.24;WA39;Kunststoffe und Waren daraus;5288380;3597922;1690458
01.08.24;WA40;Kautschuk und Waren daraus;1269068;1267440;1628
01.08.24;WA41;Häute, Felle, Leder;32026;24152;7874
01.08.24;WA42;Lederwaren, Sattlerwaren;261991;402501;-140510
01.08.24;WA43;Pelzfelle, künstliches Pelzwerk;4364;7290;-2926
01.08.24;WA44;Holz, Holzwaren, Holzkohle;711425;604884;106541
01.08.24;WA45;Kork, Korkwaren;2048;6834;-4786
01.08.24;WA46;Flechtwaren, Korbmacherwaren;4578;11117;-6539
01.08.24;WA47;Halbstoffe aus Holz usw., Papierabfall;113450;377590;-264140
01.08.24;WA48;Papier, Pappe und Waren daraus;1606817;1085894;520923
01.08.24;WA49;Bücher, Zeitungen, Bilddrucke usw.;296367;201335;95032
01.08.24;WA50;Seide;1184;2502;-1318
01.08.24;WA51;Wolle, feine und grobe Tierhaare;24188;23473;715
01.08.24;WA52;Baumwolle;35724;40836;-5112
01.08.24;WA53;Andere pflanzliche Spinnstoffe, Papiergarn;2245;3610;-1365
01.08.24;WA54;Synthetisches oder künstliches Filament;112122;101574;10548
01.08.24;WA55;Synthetische oder künstliche Spinnfaser;104234;93956;10278
01.08.24;WA56;Watte, Filz, Vliesstoff usw., Tauwerk;201086;131430;69656
01.08.24;WA57;Teppiche, Fussbodenbelag aus Spinnstoff;48878;85901;-37023
01.08.24;WA58;Spezialgewebe, Spitzen, Tapisserien;38549;18780;19769
01.08.24;WA59;Getränkte, bestrichene usw. Gewebe;198841;93464;105377
01.08.24;WA60;Gewirke und Gestricke;42505;25060;17445
01.08.24;WA61;Bekleidung usw. aus Gewirken, Gestricken;1136593;1929053;-792460
01.08.24;WA62;Andere Bekleidung, Bekleidungszubehör;1033499;1618515;-585016
01.08.24;WA63;Andere Konfektion, Spinnstoffwaren usw.;253260;385376;-132116
01.08.24;WA64;Schuhe, Gamaschen, ähnliche Waren;960724;1079884;-119160
01.08.24;WA65;Kopfbedeckungen und Teile davon;59683;86290;-26607
01.08.24;WA66;Schirme, Gehstöcke usw., Peitschen;8203;14561;-6358
01.08.24;WA67;Zugerichtete Federn, Daunen, künstliche Blumen;12668;30515;-17847
01.08.24;WA68;Waren aus Steinen, Gips, Zement usw.;430393;283891;146502
01.08.24;WA69;Keramische Waren;302301;249023;53278
01.08.24;WA70;Glas und Glaswaren;573508;451921;121587
01.08.24;WA71;Perlen, Edelsteine, Edelmetalle;1700861;1463991;236870
01.08.24;WA72;Eisen und Stahl;2172363;1891696;280667
01.08.24;WA73;Waren aus Eisen oder Stahl;2518709;1929554;589155
01.08.24;WA74;Kupfer und Waren daraus;1068664;958238;110426
01.08.24;WA75;Nickel und Waren daraus;151548;178394;-26846
01.08.24;WA76;Aluminium und Waren daraus;1405805;1531325;-125520
01.08.24;WA78;Blei und Waren daraus;46046;43376;2670
01.08.24;WA79;Zink und Waren daraus;58352;110217;-51865
01.08.24;WA80;Zinn und Waren daraus;11110;40495;-29385
01.08.24;WA81;Andere unedle Metalle, Cermets usw.;132434;173435;-41001
01.08.24;WA82;Werkzeuge, Schneidwaren, Essbestecke;683655;463650;220005
01.08.24;WA83;Verschiedene Waren aus unedlen Metallen;641644;431732;209912
01.08.24;WA84;Maschinen, Apparate, mechanische Geräte;19200896;12541812;6659084
01.08.24;WA85;Elektrotechnische Erzeugnisse;13341577;14379089;-1037512
01.08.24;WA86;Schienenfahrzeuge;269317;242172;27145
01.08.24;WA87;Kraftfahrzeuge, Landfahrzeuge;19135041;9519861;9615180
01.08.24;WA88;Luftfahrzeuge, Raumfahrzeuge;2277187;1085596;1191591
01.08.24;WA89;Wasserfahrzeuge;190039;139939;50100
01.08.24;WA90;Optische, photografische usw. Erzeugnisse;6083208;3525508;2557700
01.08.24;WA91;Uhrmacherwaren;150214;195538;-45324
01.08.24;WA92;Musikinstrumente;70962;58680;12282
01.08.24;WA93;Waffen und Munition;56975;24294;32681
01.08.24;WA94;Möbel, Beleuchtungskörper usw.;1329063;1652690;-323627
01.08.24;WA95;Spielzeug, Spiele usw., Sportgeräte;424616;653199;-228583
01.08.24;WA96;Verschiedene Waren;325211;283337;41874
01.08.24;WA97;Kunstgegenstände, Sammlungsstücke;49404;40968;8436
01.08.24;WA98;Vollständige Fabrikationsanlagen;60472;NULL;#WERT!
01.08.24;WA99;Zusammenstellungen verschiedener Waren;1382295;989123;393172
01.08.25;WA01;Lebende Tiere;NULL;NULL;#WERT!
01.08.25;WA02;Fleisch;NULL;NULL;#WERT!
01.08.25;WA03;Fische, Krebs- und Weichtiere;NULL;NULL;#WERT!
01.08.25;WA04;Milch, Milcherzeugnisse, Eier, Honig;NULL;NULL;#WERT!
01.08.25;WA05;Andere Waren tierischen Ursprungs;NULL;NULL;#WERT!
01.08.25;WA06;Pflanzen, Waren des Blumenhandels;NULL;NULL;#WERT!
01.08.25;WA07;Gemüse, Pflanzen für Ernährung;NULL;NULL;#WERT!
01.08.25;WA08;Geniessbare Früchte und Nüsse;NULL;NULL;#WERT!
01.08.25;WA09;Kaffee, Tee, Mate, Gewürze;NULL;NULL;#WERT!
01.08.25;WA10;Getreide;NULL;NULL;#WERT!
01.08.25;WA11;Müllereierzeugnisse, Malz usw.;NULL;NULL;#WERT!
01.08.25;WA12;Ölsamen usw., Heilpflanzen usw.;NULL;NULL;#WERT!
01.08.25;WA13;Schellack, Gummen, Harz, Pflanzensaft;NULL;NULL;#WERT!
01.08.25;WA14;Flechtstoffe usw. pflanzlichen Ursprungs;NULL;NULL;#WERT!
01.08.25;WA15;Tierische und pflanzliche Fette, Öle, Wachs;NULL;NULL;#WERT!
01.08.25;WA16;Zubereitungen von Fleisch, Fisch usw.;NULL;NULL;#WERT!
01.08.25;WA17;Zucker und Zuckerwaren;NULL;NULL;#WERT!
01.08.25;WA18;Kakao und Zubereitungen aus Kakao;NULL;NULL;#WERT!
01.08.25;WA19;Zubereitungen aus Getreide usw., Backwaren;NULL;NULL;#WERT!
01.08.25;WA20;Zubereitungen von Gemüse, Früchten usw.;NULL;NULL;#WERT!
01.08.25;WA21;Verschiedene Lebensmittelzubereitungen;NULL;NULL;#WERT!
01.08.25;WA22;Getränke, alkoholhaltige Flüssigkeiten, Essig;NULL;NULL;#WERT!
01.08.25;WA23;Rückstände der Lebensmittelindustrie, Futter;NULL;NULL;#WERT!
01.08.25;WA24;Tabak;NULL;NULL;#WERT!
01.08.25;WA25;Salz, Schwefel, Steine, Erden usw.;NULL;NULL;#WERT!
01.08.25;WA26;Erze, Schlacken, Aschen;NULL;NULL;#WERT!
01.08.25;WA27;Mineralische Brennstoffe usw.;NULL;NULL;#WERT!
01.08.25;WA28;Anorganische chemische Erzeugnisse;NULL;NULL;#WERT!
01.08.25;WA29;Organische chemische Erzeugnisse;NULL;NULL;#WERT!
01.08.25;WA30;Pharmazeutische Erzeugnisse;NULL;NULL;#WERT!
01.08.25;WA31;Düngemittel;NULL;NULL;#WERT!
01.08.25;WA32;Gerb- und Farbstoffe, Farben, Lacke usw.;NULL;NULL;#WERT!
01.08.25;WA33;Etherische Öle, Riech-, Schönheitsmittel;NULL;NULL;#WERT!
01.08.25;WA34;Seifen, Waschmittel usw.;NULL;NULL;#WERT!
01.08.25;WA35;Eiweissstoffe, Klebstoffe, Enzyme;NULL;NULL;#WERT!
01.08.25;WA36;Sprengstoffe, pyrotechnische Artikel usw.;NULL;NULL;#WERT!
01.08.25;WA37;Photochemische Erzeugnisse;NULL;NULL;#WERT!
01.08.25;WA38;Verschiedene Erzeugnisse der Chemischen Industrie;NULL;NULL;#WERT!
01.08.25;WA39;Kunststoffe und Waren daraus;NULL;NULL;#WERT!
01.08.25;WA40;Kautschuk und Waren daraus;NULL;NULL;#WERT!
01.08.25;WA41;Häute, Felle, Leder;NULL;NULL;#WERT!
01.08.25;WA42;Lederwaren, Sattlerwaren;NULL;NULL;#WERT!
01.08.25;WA43;Pelzfelle, künstliches Pelzwerk;NULL;NULL;#WERT!
01.08.25;WA44;Holz, Holzwaren, Holzkohle;NULL;NULL;#WERT!
01.08.25;WA45;Kork, Korkwaren;NULL;NULL;#WERT!
01.08.25;WA46;Flechtwaren, Korbmacherwaren;NULL;NULL;#WERT!
01.08.25;WA47;Halbstoffe aus Holz usw., Papierabfall;NULL;NULL;#WERT!
01.08.25;WA48;Papier, Pappe und Waren daraus;NULL;NULL;#WERT!
01.08.25;WA49;Bücher, Zeitungen, Bilddrucke usw.;NULL;NULL;#WERT!
01.08.25;WA50;Seide;NULL;NULL;#WERT!
01.08.25;WA51;Wolle, feine und grobe Tierhaare;NULL;NULL;#WERT!
01.08.25;WA52;Baumwolle;NULL;NULL;#WERT!
01.08.25;WA53;Andere pflanzliche Spinnstoffe, Papiergarn;NULL;NULL;#WERT!
01.08.25;WA54;Synthetisches oder künstliches Filament;NULL;NULL;#WERT!
01.08.25;WA55;Synthetische oder künstliche Spinnfaser;NULL;NULL;#WERT!
01.08.25;WA56;Watte, Filz, Vliesstoff usw., Tauwerk;NULL;NULL;#WERT!
01.08.25;WA57;Teppiche, Fussbodenbelag aus Spinnstoff;NULL;NULL;#WERT!
01.08.25;WA58;Spezialgewebe, Spitzen, Tapisserien;NULL;NULL;#WERT!
01.08.25;WA59;Getränkte, bestrichene usw. Gewebe;NULL;NULL;#WERT!
01.08.25;WA60;Gewirke und Gestricke;NULL;NULL;#WERT!
01.08.25;WA61;Bekleidung usw. aus Gewirken, Gestricken;NULL;NULL;#WERT!
01.08.25;WA62;Andere Bekleidung, Bekleidungszubehör;NULL;NULL;#WERT!
01.08.25;WA63;Andere Konfektion, Spinnstoffwaren usw.;NULL;NULL;#WERT!
01.08.25;WA64;Schuhe, Gamaschen, ähnliche Waren;NULL;NULL;#WERT!
01.08.25;WA65;Kopfbedeckungen und Teile davon;NULL;NULL;#WERT!
01.08.25;WA66;Schirme, Gehstöcke usw., Peitschen;NULL;NULL;#WERT!
01.08.25;WA67;Zugerichtete Federn, Daunen, künstliche Blumen;NULL;NULL;#WERT!
01.08.25;WA68;Waren aus Steinen, Gips, Zement usw.;NULL;NULL;#WERT!
01.08.25;WA69;Keramische Waren;NULL;NULL;#WERT!
01.08.25;WA70;Glas und Glaswaren;NULL;NULL;#WERT!
01.08.25;WA71;Perlen, Edelsteine, Edelmetalle;NULL;NULL;#WERT!
01.08.25;WA72;Eisen und Stahl;NULL;NULL;#WERT!
01.08.25;WA73;Waren aus Eisen oder Stahl;NULL;NULL;#WERT!
01.08.25;WA74;Kupfer und Waren daraus;NULL;NULL;#WERT!
01.08.25;WA75;Nickel und Waren daraus;NULL;NULL;#WERT!
01.08.25;WA76;Aluminium und Waren daraus;NULL;NULL;#WERT!
01.08.25;WA78;Blei und Waren daraus;NULL;NULL;#WERT!
01.08.25;WA79;Zink und Waren daraus;NULL;NULL;#WERT!
01.08.25;WA80;Zinn und Waren daraus;NULL;NULL;#WERT!
01.08.25;WA81;Andere unedle Metalle, Cermets usw.;NULL;NULL;#WERT!
01.08.25;WA82;Werkzeuge, Schneidwaren, Essbestecke;NULL;NULL;#WERT!
01.08.25;WA83;Verschiedene Waren aus unedlen Metallen;NULL;NULL;#WERT!
01.08.25;WA84;Maschinen, Apparate, mechanische Geräte;NULL;NULL;#WERT!
01.08.25;WA85;Elektrotechnische Erzeugnisse;NULL;NULL;#WERT!
01.08.25;WA86;Schienenfahrzeuge;NULL;NULL;#WERT!
01.08.25;WA87;Kraftfahrzeuge, Landfahrzeuge;NULL;NULL;#WERT!
01.08.25;WA88;Luftfahrzeuge, Raumfahrzeuge;NULL;NULL;#WERT!
01.08.25;WA89;Wasserfahrzeuge;NULL;NULL;#WERT!
01.08.25;WA90;Optische, photografische usw. Erzeugnisse;NULL;NULL;#WERT!
01.08.25;WA91;Uhrmacherwaren;NULL;NULL;#WERT!
01.08.25;WA92;Musikinstrumente;NULL;NULL;#WERT!
01.08.25;WA93;Waffen und Munition;NULL;NULL;#WERT!
01.08.25;WA94;Möbel, Beleuchtungskörper usw.;NULL;NULL;#WERT!
01.08.25;WA95;Spielzeug, Spiele usw., Sportgeräte;NULL;NULL;#WERT!
01.08.25;WA96;Verschiedene Waren;NULL;NULL;#WERT!
01.08.25;WA97;Kunstgegenstände, Sammlungsstücke;NULL;NULL;#WERT!
01.08.25;WA98;Vollständige Fabrikationsanlagen;NULL;NULL;#WERT!
01.08.25;WA99;Zusammenstellungen verschiedener Waren;NULL;NULL;#WERT!
01.09.08;WA01;Lebende Tiere;82163;118169;-36006
01.09.08;WA02;Fleisch;591650;441451;150199
01.09.08;WA03;Fische, Krebs- und Weichtiere;76285;203202;-126917
01.09.08;WA04;Milch, Milcherzeugnisse, Eier, Honig;571101;497582;73519
01.09.08;WA05;Andere Waren tierischen Ursprungs;51604;53459;-1855
01.09.08;WA06;Pflanzen, Waren des Blumenhandels;63793;174584;-110791
01.09.08;WA07;Gemüse, Pflanzen für Ernährung;71410;268552;-197142
01.09.08;WA08;Geniessbare Früchte und Nüsse;96440;539992;-443552
01.09.08;WA09;Kaffee, Tee, Mate, Gewürze;119968;226985;-107017
01.09.08;WA10;Getreide;240469;131253;109216
01.09.08;WA11;Müllereierzeugnisse, Malz usw.;70089;46475;23614
01.09.08;WA12;Ölsamen usw., Heilpflanzen usw.;75582;394307;-318725
01.09.08;WA13;Schellack, Gummen, Harz, Pflanzensaft;40050;22302;17748
01.09.08;WA14;Flechtstoffe usw. pflanzlichen Ursprungs;995;3195;-2200
01.09.08;WA15;Tierische und pflanzliche Fette, Öle, Wachs;187296;255725;-68429
01.09.08;WA16;Zubereitungen von Fleisch, Fisch usw.;212553;168027;44526
01.09.08;WA17;Zucker und Zuckerwaren;110551;144807;-34256
01.09.08;WA18;Kakao und Zubereitungen aus Kakao;292267;210731;81536
01.09.08;WA19;Zubereitungen aus Getreide usw., Backwaren;334443;190717;143726
01.09.08;WA20;Zubereitungen von Gemüse, Früchten usw.;190520;302112;-111592
01.09.08;WA21;Verschiedene Lebensmittelzubereitungen;281264;204978;76286
01.09.08;WA22;Getränke, alkoholhaltige Flüssigkeiten, Essig;374094;443277;-69183
01.09.08;WA23;Rückstände der Lebensmittelindustrie, Futter;225837;198061;27776
01.09.08;WA24;Tabak;302138;136118;166020
01.09.08;WA25;Salz, Schwefel, Steine, Erden usw.;198837;162966;35871
01.09.08;WA26;Erze, Schlacken, Aschen;22492;578143;-555651
01.09.08;WA27;Mineralische Brennstoffe usw.;2015585;10580911;-8565326
01.09.08;WA28;Anorganische chemische Erzeugnisse;670944;810969;-140025
01.09.08;WA29;Organische chemische Erzeugnisse;2076752;1850334;226418
01.09.08;WA30;Pharmazeutische Erzeugnisse;3721700;2802857;918843
01.09.08;WA31;Düngemittel;335551;149557;185994
01.09.08;WA32;Gerb- und Farbstoffe, Farben, Lacke usw.;701887;300388;401499
01.09.08;WA33;Etherische Öle, Riech-, Schönheitsmittel;638065;366757;271308
01.09.08;WA34;Seifen, Waschmittel usw.;460477;255765;204712
01.09.08;WA35;Eiweissstoffe, Klebstoffe, Enzyme;174170;136532;37638
01.09.08;WA36;Sprengstoffe, pyrotechnische Artikel usw.;16865;12149;4716
01.09.08;WA37;Photochemische Erzeugnisse;90556;72345;18211
01.09.08;WA38;Verschiedene Erzeugnisse der Chemischen Industrie;1239847;827556;412291
01.09.08;WA39;Kunststoffe und Waren daraus;3959359;2366095;1593264
01.09.08;WA40;Kautschuk und Waren daraus;960041;866493;93548
01.09.08;WA41;Häute, Felle, Leder;71985;69036;2949
01.09.08;WA42;Lederwaren, Sattlerwaren;136954;214362;-77408
01.09.08;WA43;Pelzfelle, künstliches Pelzwerk;20992;18451;2541
01.09.08;WA44;Holz, Holzwaren, Holzkohle;640736;457588;183148
01.09.08;WA45;Kork, Korkwaren;3396;8726;-5330
01.09.08;WA46;Flechtwaren, Korbmacherwaren;4260;10688;-6428
01.09.08;WA47;Halbstoffe aus Holz usw., Papierabfall;82938;278381;-195443
01.09.08;WA48;Papier, Pappe und Waren daraus;1514378;978475;535903
01.09.08;WA49;Bücher, Zeitungen, Bilddrucke usw.;448685;181788;266897
01.09.08;WA50;Seide;5619;5938;-319
01.09.08;WA51;Wolle, feine und grobe Tierhaare;51015;53846;-2831
01.09.08;WA52;Baumwolle;87416;79535;7881
01.09.08;WA53;Andere pflanzliche Spinnstoffe, Papiergarn;3616;6636;-3020
01.09.08;WA54;Synthetisches oder künstliches Filament;201242;132940;68302
01.09.08;WA55;Synthetische oder künstliche Spinnfaser;144542;121645;22897
01.09.08;WA56;Watte, Filz, Vliesstoff usw., Tauwerk;159137;89770;69367
01.09.08;WA57;Teppiche, Fussbodenbelag aus Spinnstoff;44493;83364;-38871
01.09.08;WA58;Spezialgewebe, Spitzen, Tapisserien;42863;25375;17488
01.09.08;WA59;Getränkte, bestrichene usw. Gewebe;157287;106623;50664
01.09.08;WA60;Gewirke und Gestricke;70710;32233;38477
01.09.08;WA61;Bekleidung usw. aus Gewirken, Gestricken;516321;1005815;-489494
01.09.08;WA62;Andere Bekleidung, Bekleidungszubehör;760607;1080560;-319953
01.09.08;WA63;Andere Konfektion, Spinnstoffwaren usw.;138380;216411;-78031
01.09.08;WA64;Schuhe, Gamaschen, ähnliche Waren;282493;463474;-180981
01.09.08;WA65;Kopfbedeckungen und Teile davon;23328;34243;-10915
01.09.08;WA66;Schirme, Gehstöcke usw., Peitschen;10608;11179;-571
01.09.08;WA67;Zugerichtete Federn, Daunen, künstliche Blumen;7335;14720;-7385
01.09.08;WA68;Waren aus Steinen, Gips, Zement usw.;304874;202530;102344
01.09.08;WA69;Keramische Waren;249129;180821;68308
01.09.08;WA70;Glas und Glaswaren;444089;313678;130411
01.09.08;WA71;Perlen, Edelsteine, Edelmetalle;727877;843091;-115214
01.09.08;WA72;Eisen und Stahl;2457359;2655757;-198398
01.09.08;WA73;Waren aus Eisen oder Stahl;2299412;1517650;781762
01.09.08;WA74;Kupfer und Waren daraus;925283;782837;142446
01.09.08;WA75;Nickel und Waren daraus;102552;152434;-49882
01.09.08;WA76;Aluminium und Waren daraus;1080061;1032505;47556
01.09.08;WA78;Blei und Waren daraus;38472;17404;21068
01.09.08;WA79;Zink und Waren daraus;49977;65675;-15698
01.09.08;WA80;Zinn und Waren daraus;11933;36051;-24118
01.09.08;WA81;Andere unedle Metalle, Cermets usw.;95772;126739;-30967
01.09.08;WA82;Werkzeuge, Schneidwaren, Essbestecke;554636;349360;205276
01.09.08;WA83;Verschiedene Waren aus unedlen Metallen;567956;324734;243222
01.09.08;WA84;Maschinen, Apparate, mechanische Geräte;16039274;9232650;6806624
01.09.08;WA85;Elektrotechnische Erzeugnisse;8630643;7633654;996989
01.09.08;WA86;Schienenfahrzeuge;325141;136604;188537
01.09.08;WA87;Kraftfahrzeuge, Landfahrzeuge;14386523;5900446;8486077
01.09.08;WA88;Luftfahrzeuge, Raumfahrzeuge;1790881;1297503;493378
01.09.08;WA89;Wasserfahrzeuge;618858;118626;500232
01.09.08;WA90;Optische, photografische usw. Erzeugnisse;3328734;1804262;1524472
01.09.08;WA91;Uhrmacherwaren;103349;125662;-22313
01.09.08;WA92;Musikinstrumente;42464;36197;6267
01.09.08;WA93;Waffen und Munition;30082;9638;20444
01.09.08;WA94;Möbel, Beleuchtungskörper usw.;1075401;1010238;65163
01.09.08;WA95;Spielzeug, Spiele usw., Sportgeräte;533812;786334;-252522
01.09.08;WA96;Verschiedene Waren;187154;103967;83187
01.09.08;WA97;Kunstgegenstände, Sammlungsstücke;47548;19884;27664
01.09.08;WA98;Vollständige Fabrikationsanlagen;444434;8541;435893
01.09.08;WA99;Zusammenstellungen verschiedener Waren;1199432;873633;325799
01.09.09;WA01;Lebende Tiere;90787;110520;-19733
01.09.09;WA02;Fleisch;492521;377602;114919
01.09.09;WA03;Fische, Krebs- und Weichtiere;85092;211550;-126458
01.09.09;WA04;Milch, Milcherzeugnisse, Eier, Honig;487385;438488;48897
01.09.09;WA05;Andere Waren tierischen Ursprungs;45709;54923;-9214
01.09.09;WA06;Pflanzen, Waren des Blumenhandels;55714;180637;-124923
01.09.09;WA07;Gemüse, Pflanzen für Ernährung;66425;249061;-182636
01.09.09;WA08;Geniessbare Früchte und Nüsse;85681;438689;-353008
01.09.09;WA09;Kaffee, Tee, Mate, Gewürze;121881;221855;-99974
01.09.09;WA10;Getreide;171386;112003;59383
01.09.09;WA11;Müllereierzeugnisse, Malz usw.;76213;35296;40917
01.09.09;WA12;Ölsamen usw., Heilpflanzen usw.;59130;271373;-212243
01.09.09;WA13;Schellack, Gummen, Harz, Pflanzensaft;30446;25466;4980
01.09.09;WA14;Flechtstoffe usw. pflanzlichen Ursprungs;973;2306;-1333
01.09.09;WA15;Tierische und pflanzliche Fette, Öle, Wachs;123417;237873;-114456
01.09.09;WA16;Zubereitungen von Fleisch, Fisch usw.;183431;162225;21206
01.09.09;WA17;Zucker und Zuckerwaren;125402;101660;23742
01.09.09;WA18;Kakao und Zubereitungen aus Kakao;311274;250474;60800
01.09.09;WA19;Zubereitungen aus Getreide usw., Backwaren;353567;188984;164583
01.09.09;WA20;Zubereitungen von Gemüse, Früchten usw.;159942;278152;-118210
01.09.09;WA21;Verschiedene Lebensmittelzubereitungen;281950;232210;49740
01.09.09;WA22;Getränke, alkoholhaltige Flüssigkeiten, Essig;329031;452342;-123311
01.09.09;WA23;Rückstände der Lebensmittelindustrie, Futter;220363;266701;-46338
01.09.09;WA24;Tabak;274023;150036;123987
01.09.09;WA25;Salz, Schwefel, Steine, Erden usw.;165604;119197;46407
01.09.09;WA26;Erze, Schlacken, Aschen;32344;382251;-349907
01.09.09;WA27;Mineralische Brennstoffe usw.;1383605;7258190;-5874585
01.09.09;WA28;Anorganische chemische Erzeugnisse;529443;343345;186098
01.09.09;WA29;Organische chemische Erzeugnisse;1479052;1589784;-110732
01.09.09;WA30;Pharmazeutische Erzeugnisse;3801640;2810816;990824
01.09.09;WA31;Düngemittel;169597;57183;112414
01.09.09;WA32;Gerb- und Farbstoffe, Farben, Lacke usw.;666145;298470;367675
01.09.09;WA33;Etherische Öle, Riech-, Schönheitsmittel;547443;385702;161741
01.09.09;WA34;Seifen, Waschmittel usw.;419719;250448;169271
01.09.09;WA35;Eiweissstoffe, Klebstoffe, Enzyme;169157;116025;53132
01.09.09;WA36;Sprengstoffe, pyrotechnische Artikel usw.;15365;23399;-8034
01.09.09;WA37;Photochemische Erzeugnisse;96399;76074;20325
01.09.09;WA38;Verschiedene Erzeugnisse der Chemischen Industrie;1074594;658265;416329
01.09.09;WA39;Kunststoffe und Waren daraus;3433517;1983884;1449633
01.09.09;WA40;Kautschuk und Waren daraus;845642;792359;53283
01.09.09;WA41;Häute, Felle, Leder;53050;47074;5976
01.09.09;WA42;Lederwaren, Sattlerwaren;110544;179862;-69318
01.09.09;WA43;Pelzfelle, künstliches Pelzwerk;13604;13180;424
01.09.09;WA44;Holz, Holzwaren, Holzkohle;510818;418905;91913
01.09.09;WA45;Kork, Korkwaren;2969;8709;-5740
01.09.09;WA46;Flechtwaren, Korbmacherwaren;4461;10122;-5661
01.09.09;WA47;Halbstoffe aus Holz usw., Papierabfall;69168;197968;-128800
01.09.09;WA48;Papier, Pappe und Waren daraus;1397866;919438;478428
01.09.09;WA49;Bücher, Zeitungen, Bilddrucke usw.;396866;179379;217487
01.09.09;WA50;Seide;4492;4802;-310
01.09.09;WA51;Wolle, feine und grobe Tierhaare;39994;42410;-2416
01.09.09;WA52;Baumwolle;70585;58906;11679
01.09.09;WA53;Andere pflanzliche Spinnstoffe, Papiergarn;2918;4705;-1787
01.09.09;WA54;Synthetisches oder künstliches Filament;153696;95156;58540
01.09.09;WA55;Synthetische oder künstliche Spinnfaser;133405;93278;40127
01.09.09;WA56;Watte, Filz, Vliesstoff usw., Tauwerk;148248;84394;63854
01.09.09;WA57;Teppiche, Fussbodenbelag aus Spinnstoff;38681;81965;-43284
01.09.09;WA58;Spezialgewebe, Spitzen, Tapisserien;36384;22888;13496
01.09.09;WA59;Getränkte, bestrichene usw. Gewebe;135691;91136;44555
01.09.09;WA60;Gewirke und Gestricke;61034;30307;30727
01.09.09;WA61;Bekleidung usw. aus Gewirken, Gestricken;524891;993357;-468466
01.09.09;WA62;Andere Bekleidung, Bekleidungszubehör;658936;1013795;-354859
01.09.09;WA63;Andere Konfektion, Spinnstoffwaren usw.;142849;203366;-60517
01.09.09;WA64;Schuhe, Gamaschen, ähnliche Waren;234423;431348;-196925
01.09.09;WA65;Kopfbedeckungen und Teile davon;25055;36030;-10975
01.09.09;WA66;Schirme, Gehstöcke usw., Peitschen;14805;7303;7502
01.09.09;WA67;Zugerichtete Federn, Daunen, künstliche Blumen;7144;12735;-5591
01.09.09;WA68;Waren aus Steinen, Gips, Zement usw.;253103;172505;80598
01.09.09;WA69;Keramische Waren;218014;150501;67513
01.09.09;WA70;Glas und Glaswaren;403845;303679;100166
01.09.09;WA71;Perlen, Edelsteine, Edelmetalle;633194;737053;-103859
01.09.09;WA72;Eisen und Stahl;1484256;1366046;118210
01.09.09;WA73;Waren aus Eisen oder Stahl;1697697;1014631;683066
01.09.09;WA74;Kupfer und Waren daraus;676034;554899;121135
01.09.09;WA75;Nickel und Waren daraus;49518;81780;-32262
01.09.09;WA76;Aluminium und Waren daraus;830820;756293;74527
01.09.09;WA78;Blei und Waren daraus;50362;17301;33061
01.09.09;WA79;Zink und Waren daraus;46175;71265;-25090
01.09.09;WA80;Zinn und Waren daraus;6035;15693;-9658
01.09.09;WA81;Andere unedle Metalle, Cermets usw.;56475;69897;-13422
01.09.09;WA82;Werkzeuge, Schneidwaren, Essbestecke;411158;236654;174504
01.09.09;WA83;Verschiedene Waren aus unedlen Metallen;468474;275127;193347
01.09.09;WA84;Maschinen, Apparate, mechanische Geräte;12289848;7305608;4984240
01.09.09;WA85;Elektrotechnische Erzeugnisse;7300119;6932737;367382
01.09.09;WA86;Schienenfahrzeuge;257822;121793;136029
01.09.09;WA87;Kraftfahrzeuge, Landfahrzeuge;11764158;5051687;6712471
01.09.09;WA88;Luftfahrzeuge, Raumfahrzeuge;1459106;1269107;189999
01.09.09;WA89;Wasserfahrzeuge;22794;896179;-873385
01.09.09;WA90;Optische, photografische usw. Erzeugnisse;3023128;1641353;1381775
01.09.09;WA91;Uhrmacherwaren;92288;97017;-4729
01.09.09;WA92;Musikinstrumente;37529;39230;-1701
01.09.09;WA93;Waffen und Munition;33461;13703;19758
01.09.09;WA94;Möbel, Beleuchtungskörper usw.;954398;965479;-11081
01.09.09;WA95;Spielzeug, Spiele usw., Sportgeräte;545071;660361;-115290
01.09.09;WA96;Verschiedene Waren;146767;102240;44527
01.09.09;WA97;Kunstgegenstände, Sammlungsstücke;37767;24255;13512
01.09.09;WA98;Vollständige Fabrikationsanlagen;301313;6693;294620
01.09.09;WA99;Zusammenstellungen verschiedener Waren;1309276;983122;326154
01.09.10;WA01;Lebende Tiere;95035;107260;-12225
01.09.10;WA02;Fleisch;568859;443428;125431
01.09.10;WA03;Fische, Krebs- und Weichtiere;103994;246820;-142826
01.09.10;WA04;Milch, Milcherzeugnisse, Eier, Honig;626977;485275;141702
01.09.10;WA05;Andere Waren tierischen Ursprungs;48841;52696;-3855
01.09.10;WA06;Pflanzen, Waren des Blumenhandels;62381;185641;-123260
01.09.10;WA07;Gemüse, Pflanzen für Ernährung;75168;317324;-242156
01.09.10;WA08;Geniessbare Früchte und Nüsse;102978;534134;-431156
01.09.10;WA09;Kaffee, Tee, Mate, Gewürze;175786;313637;-137851
01.09.10;WA10;Getreide;237185;180771;56414
01.09.10;WA11;Müllereierzeugnisse, Malz usw.;79404;34402;45002
01.09.10;WA12;Ölsamen usw., Heilpflanzen usw.;50021;280307;-230286
01.09.10;WA13;Schellack, Gummen, Harz, Pflanzensaft;33820;33392;428
01.09.10;WA14;Flechtstoffe usw. pflanzlichen Ursprungs;675;1910;-1235
01.09.10;WA15;Tierische und pflanzliche Fette, Öle, Wachs;172065;257512;-85447
01.09.10;WA16;Zubereitungen von Fleisch, Fisch usw.;178524;158932;19592
01.09.10;WA17;Zucker und Zuckerwaren;115944;107272;8672
01.09.10;WA18;Kakao und Zubereitungen aus Kakao;335646;287673;47973
01.09.10;WA19;Zubereitungen aus Getreide usw., Backwaren;374948;197446;177502
01.09.10;WA20;Zubereitungen von Gemüse, Früchten usw.;147705;287301;-139596
01.09.10;WA21;Verschiedene Lebensmittelzubereitungen;303881;166190;137691
01.09.10;WA22;Getränke, alkoholhaltige Flüssigkeiten, Essig;349968;499908;-149940
01.09.10;WA23;Rückstände der Lebensmittelindustrie, Futter;236399;250774;-14375
01.09.10;WA24;Tabak;288368;138198;150170
01.09.10;WA25;Salz, Schwefel, Steine, Erden usw.;184084;164987;19097
01.09.10;WA26;Erze, Schlacken, Aschen;28279;548384;-520105
01.09.10;WA27;Mineralische Brennstoffe usw.;1589223;7208319;-5619096
01.09.10;WA28;Anorganische chemische Erzeugnisse;640985;514048;126937
01.09.10;WA29;Organische chemische Erzeugnisse;1813297;1830861;-17564
01.09.10;WA30;Pharmazeutische Erzeugnisse;4122505;2281834;1840671
01.09.10;WA31;Düngemittel;178802;129505;49297
01.09.10;WA32;Gerb- und Farbstoffe, Farben, Lacke usw.;770777;389729;381048
01.09.10;WA33;Etherische Öle, Riech-, Schönheitsmittel;667507;417848;249659
01.09.10;WA34;Seifen, Waschmittel usw.;466860;247815;219045
01.09.10;WA35;Eiweissstoffe, Klebstoffe, Enzyme;200601;133450;67151
01.09.10;WA36;Sprengstoffe, pyrotechnische Artikel usw.;15011;22249;-7238
01.09.10;WA37;Photochemische Erzeugnisse;97243;65185;32058
01.09.10;WA38;Verschiedene Erzeugnisse der Chemischen Industrie;1318921;891872;427049
01.09.10;WA39;Kunststoffe und Waren daraus;4071711;2436482;1635229
01.09.10;WA40;Kautschuk und Waren daraus;1072493;1003089;69404
01.09.10;WA41;Häute, Felle, Leder;77736;59682;18054
01.09.10;WA42;Lederwaren, Sattlerwaren;129032;243234;-114202
01.09.10;WA43;Pelzfelle, künstliches Pelzwerk;17201;14712;2489
01.09.10;WA44;Holz, Holzwaren, Holzkohle;604403;484129;120274
01.09.10;WA45;Kork, Korkwaren;2283;7474;-5191
01.09.10;WA46;Flechtwaren, Korbmacherwaren;3352;10557;-7205
01.09.10;WA47;Halbstoffe aus Holz usw., Papierabfall;99927;337808;-237881
01.09.10;WA48;Papier, Pappe und Waren daraus;1604665;1022082;582583
01.09.10;WA49;Bücher, Zeitungen, Bilddrucke usw.;448477;195481;252996
01.09.10;WA50;Seide;4823;5088;-265
01.09.10;WA51;Wolle, feine und grobe Tierhaare;53514;58507;-4993
01.09.10;WA52;Baumwolle;87605;83656;3949
01.09.10;WA53;Andere pflanzliche Spinnstoffe, Papiergarn;3108;4846;-1738
01.09.10;WA54;Synthetisches oder künstliches Filament;160597;114326;46271
01.09.10;WA55;Synthetische oder künstliche Spinnfaser;163909;123700;40209
01.09.10;WA56;Watte, Filz, Vliesstoff usw., Tauwerk;174979;89096;85883
01.09.10;WA57;Teppiche, Fussbodenbelag aus Spinnstoff;45956;83650;-37694
01.09.10;WA58;Spezialgewebe, Spitzen, Tapisserien;39008;27066;11942
01.09.10;WA59;Getränkte, bestrichene usw. Gewebe;161092;82862;78230
01.09.10;WA60;Gewirke und Gestricke;63656;34562;29094
01.09.10;WA61;Bekleidung usw. aus Gewirken, Gestricken;642220;1244710;-602490
01.09.10;WA62;Andere Bekleidung, Bekleidungszubehör;738606;1242201;-503595
01.09.10;WA63;Andere Konfektion, Spinnstoffwaren usw.;167447;250699;-83252
01.09.10;WA64;Schuhe, Gamaschen, ähnliche Waren;313715;615832;-302117
01.09.10;WA65;Kopfbedeckungen und Teile davon;30087;46275;-16188
01.09.10;WA66;Schirme, Gehstöcke usw., Peitschen;6278;8892;-2614
01.09.10;WA67;Zugerichtete Federn, Daunen, künstliche Blumen;7556;14959;-7403
01.09.10;WA68;Waren aus Steinen, Gips, Zement usw.;301502;205137;96365
01.09.10;WA69;Keramische Waren;243304;187251;56053
01.09.10;WA70;Glas und Glaswaren;431846;339846;92000
01.09.10;WA71;Perlen, Edelsteine, Edelmetalle;1046415;1070090;-23675
01.09.10;WA72;Eisen und Stahl;1998232;2057166;-58934
01.09.10;WA73;Waren aus Eisen oder Stahl;1963966;1292342;671624
01.09.10;WA74;Kupfer und Waren daraus;916470;826599;89871
01.09.10;WA75;Nickel und Waren daraus;71960;123118;-51158
01.09.10;WA76;Aluminium und Waren daraus;928166;1051883;-123717
01.09.10;WA78;Blei und Waren daraus;43014;27604;15410
01.09.10;WA79;Zink und Waren daraus;55300;95597;-40297
01.09.10;WA80;Zinn und Waren daraus;9312;36932;-27620
01.09.10;WA81;Andere unedle Metalle, Cermets usw.;88480;93415;-4935
01.09.10;WA82;Werkzeuge, Schneidwaren, Essbestecke;501891;300185;201706
01.09.10;WA83;Verschiedene Waren aus unedlen Metallen;543114;319674;223440
01.09.10;WA84;Maschinen, Apparate, mechanische Geräte;15132092;9374880;5757212
01.09.10;WA85;Elektrotechnische Erzeugnisse;9207557;8949594;257963
01.09.10;WA86;Schienenfahrzeuge;315783;133298;182485
01.09.10;WA87;Kraftfahrzeuge, Landfahrzeuge;14745434;5557876;9187558
01.09.10;WA88;Luftfahrzeuge, Raumfahrzeuge;1899920;1570254;329666
01.09.10;WA89;Wasserfahrzeuge;593966;473175;120791
01.09.10;WA90;Optische, photografische usw. Erzeugnisse;3839153;2085125;1754028
01.09.10;WA91;Uhrmacherwaren;126010;138898;-12888
01.09.10;WA92;Musikinstrumente;46310;47813;-1503
01.09.10;WA93;Waffen und Munition;33896;13666;20230
01.09.10;WA94;Möbel, Beleuchtungskörper usw.;1036917;1108700;-71783
01.09.10;WA95;Spielzeug, Spiele usw., Sportgeräte;409209;608272;-199063
01.09.10;WA96;Verschiedene Waren;161128;113981;47147
01.09.10;WA97;Kunstgegenstände, Sammlungsstücke;46076;22667;23409
01.09.10;WA98;Vollständige Fabrikationsanlagen;329312;1922;327390
01.09.10;WA99;Zusammenstellungen verschiedener Waren;1051936;912007;139929
01.09.11;WA01;Lebende Tiere;114345;135017;-20672
01.09.11;WA02;Fleisch;707817;515627;192190
01.09.11;WA03;Fische, Krebs- und Weichtiere;105051;247729;-142678
01.09.11;WA04;Milch, Milcherzeugnisse, Eier, Honig;697993;494837;203156
01.09.11;WA05;Andere Waren tierischen Ursprungs;52649;66875;-14226
01.09.11;WA06;Pflanzen, Waren des Blumenhandels;72616;212641;-140025
01.09.11;WA07;Gemüse, Pflanzen für Ernährung;64950;282731;-217781
01.09.11;WA08;Geniessbare Früchte und Nüsse;98622;507122;-408500
01.09.11;WA09;Kaffee, Tee, Mate, Gewürze;210244;412085;-201841
01.09.11;WA10;Getreide;235529;255935;-20406
01.09.11;WA11;Müllereierzeugnisse, Malz usw.;100858;45639;55219
01.09.11;WA12;Ölsamen usw., Heilpflanzen usw.;60908;307122;-246214
01.09.11;WA13;Schellack, Gummen, Harz, Pflanzensaft;36400;33068;3332
01.09.11;WA14;Flechtstoffe usw. pflanzlichen Ursprungs;1184;2763;-1579
01.09.11;WA15;Tierische und pflanzliche Fette, Öle, Wachs;209573;331233;-121660
01.09.11;WA16;Zubereitungen von Fleisch, Fisch usw.;206145;187521;18624
01.09.11;WA17;Zucker und Zuckerwaren;135785;127801;7984
01.09.11;WA18;Kakao und Zubereitungen aus Kakao;422724;321476;101248
01.09.11;WA19;Zubereitungen aus Getreide usw., Backwaren;399546;223753;175793
01.09.11;WA20;Zubereitungen von Gemüse, Früchten usw.;170897;328813;-157916
01.09.11;WA21;Verschiedene Lebensmittelzubereitungen;346958;173714;173244
01.09.11;WA22;Getränke, alkoholhaltige Flüssigkeiten, Essig;381361;532647;-151286
01.09.11;WA23;Rückstände der Lebensmittelindustrie, Futter;253382;239198;14184
01.09.11;WA24;Tabak;359770;162133;197637
01.09.11;WA25;Salz, Schwefel, Steine, Erden usw.;192166;173256;18910
01.09.11;WA26;Erze, Schlacken, Aschen;36168;967972;-931804
01.09.11;WA27;Mineralische Brennstoffe usw.;2254549;9816482;-7561933
01.09.11;WA28;Anorganische chemische Erzeugnisse;774432;567429;207003
01.09.11;WA29;Organische chemische Erzeugnisse;2066639;2251979;-185340
01.09.11;WA30;Pharmazeutische Erzeugnisse;4150871;2865397;1285474
01.09.11;WA31;Düngemittel;208113;113316;94797
01.09.11;WA32;Gerb- und Farbstoffe, Farben, Lacke usw.;839466;379878;459588
01.09.11;WA33;Etherische Öle, Riech-, Schönheitsmittel;722328;411174;311154
01.09.11;WA34;Seifen, Waschmittel usw.;513371;275296;238075
01.09.11;WA35;Eiweissstoffe, Klebstoffe, Enzyme;236880;145874;91006
01.09.11;WA36;Sprengstoffe, pyrotechnische Artikel usw.;20445;25183;-4738
01.09.11;WA37;Photochemische Erzeugnisse;87741;67515;20226
01.09.11;WA38;Verschiedene Erzeugnisse der Chemischen Industrie;1509037;952159;556878
01.09.11;WA39;Kunststoffe und Waren daraus;4386000;2628323;1757677
01.09.11;WA40;Kautschuk und Waren daraus;1261789;1275398;-13609
01.09.11;WA41;Häute, Felle, Leder;94486;74914;19572
01.09.11;WA42;Lederwaren, Sattlerwaren;143317;247607;-104290
01.09.11;WA43;Pelzfelle, künstliches Pelzwerk;20852;16916;3936
01.09.11;WA44;Holz, Holzwaren, Holzkohle;585526;538320;47206
01.09.11;WA45;Kork, Korkwaren;2517;7474;-4957
01.09.11;WA46;Flechtwaren, Korbmacherwaren;3369;9006;-5637
01.09.11;WA47;Halbstoffe aus Holz usw., Papierabfall;112661;295237;-182576
01.09.11;WA48;Papier, Pappe und Waren daraus;1572472;1023732;548740
01.09.11;WA49;Bücher, Zeitungen, Bilddrucke usw.;414084;173061;241023
01.09.11;WA50;Seide;7182;5959;1223
01.09.11;WA51;Wolle, feine und grobe Tierhaare;59577;70180;-10603
01.09.11;WA52;Baumwolle;96718;87100;9618
01.09.11;WA53;Andere pflanzliche Spinnstoffe, Papiergarn;3766;7332;-3566
01.09.11;WA54;Synthetisches oder künstliches Filament;175272;124786;50486
01.09.11;WA55;Synthetische oder künstliche Spinnfaser;165152;125846;39306
01.09.11;WA56;Watte, Filz, Vliesstoff usw., Tauwerk;194194;88228;105966
01.09.11;WA57;Teppiche, Fussbodenbelag aus Spinnstoff;43721;86629;-42908
01.09.11;WA58;Spezialgewebe, Spitzen, Tapisserien;44485;28942;15543
01.09.11;WA59;Getränkte, bestrichene usw. Gewebe;174471;90670;83801
01.09.11;WA60;Gewirke und Gestricke;73777;40498;33279
01.09.11;WA61;Bekleidung usw. aus Gewirken, Gestricken;666521;1283579;-617058
01.09.11;WA62;Andere Bekleidung, Bekleidungszubehör;764183;1337820;-573637
01.09.11;WA63;Andere Konfektion, Spinnstoffwaren usw.;180782;288486;-107704
01.09.11;WA64;Schuhe, Gamaschen, ähnliche Waren;406005;678817;-272812
01.09.11;WA65;Kopfbedeckungen und Teile davon;34212;54719;-20507
01.09.11;WA66;Schirme, Gehstöcke usw., Peitschen;7300;12638;-5338
01.09.11;WA67;Zugerichtete Federn, Daunen, künstliche Blumen;9410;14225;-4815
01.09.11;WA68;Waren aus Steinen, Gips, Zement usw.;371766;228564;143202
01.09.11;WA69;Keramische Waren;253645;198223;55422
01.09.11;WA70;Glas und Glaswaren;449713;360408;89305
01.09.11;WA71;Perlen, Edelsteine, Edelmetalle;1903470;1709176;194294
01.09.11;WA72;Eisen und Stahl;2247117;2230966;16151
01.09.11;WA73;Waren aus Eisen oder Stahl;2151269;1551885;599384
01.09.11;WA74;Kupfer und Waren daraus;1074621;899174;175447
01.09.11;WA75;Nickel und Waren daraus;90438;161810;-71372
01.09.11;WA76;Aluminium und Waren daraus;1098619;1170336;-71717
01.09.11;WA78;Blei und Waren daraus;45263;35494;9769
01.09.11;WA79;Zink und Waren daraus;55964;92592;-36628
01.09.11;WA80;Zinn und Waren daraus;11490;28581;-17091
01.09.11;WA81;Andere unedle Metalle, Cermets usw.;110158;136119;-25961
01.09.11;WA82;Werkzeuge, Schneidwaren, Essbestecke;558380;350951;207429
01.09.11;WA83;Verschiedene Waren aus unedlen Metallen;577443;330611;246832
01.09.11;WA84;Maschinen, Apparate, mechanische Geräte;16653778;9431038;7222740
01.09.11;WA85;Elektrotechnische Erzeugnisse;9317550;8550371;767179
01.09.11;WA86;Schienenfahrzeuge;283383;138936;144447
01.09.11;WA87;Kraftfahrzeuge, Landfahrzeuge;16305876;6396373;9909503
01.09.11;WA88;Luftfahrzeuge, Raumfahrzeuge;2663686;2019765;643921
01.09.11;WA89;Wasserfahrzeuge;151355;308034;-156679
01.09.11;WA90;Optische, photografische usw. Erzeugnisse;4098831;2288224;1810607
01.09.11;WA91;Uhrmacherwaren;141284;164361;-23077
01.09.11;WA92;Musikinstrumente;53062;51062;2000
01.09.11;WA93;Waffen und Munition;34819;15739;19080
01.09.11;WA94;Möbel, Beleuchtungskörper usw.;1205204;1205961;-757
01.09.11;WA95;Spielzeug, Spiele usw., Sportgeräte;465609;578104;-112495
01.09.11;WA96;Verschiedene Waren;167155;118168;48987
01.09.11;WA97;Kunstgegenstände, Sammlungsstücke;46972;33724;13248
01.09.11;WA98;Vollständige Fabrikationsanlagen;275816;1579;274237
01.09.11;WA99;Zusammenstellungen verschiedener Waren;1338992;987015;351977
01.09.12;WA01;Lebende Tiere;128276;147155;-18879
01.09.12;WA02;Fleisch;598197;473165;125032
01.09.12;WA03;Fische, Krebs- und Weichtiere;98986;232330;-133344
01.09.12;WA04;Milch, Milcherzeugnisse, Eier, Honig;633381;501638;131743
01.09.12;WA05;Andere Waren tierischen Ursprungs;66036;66935;-899
01.09.12;WA06;Pflanzen, Waren des Blumenhandels;64093;188752;-124659
01.09.12;WA07;Gemüse, Pflanzen für Ernährung;86498;296378;-209880
01.09.12;WA08;Geniessbare Früchte und Nüsse;91020;556483;-465463
01.09.12;WA09;Kaffee, Tee, Mate, Gewürze;196200;323325;-127125
01.09.12;WA10;Getreide;218913;206127;12786
01.09.12;WA11;Müllereierzeugnisse, Malz usw.;97441;45309;52132
01.09.12;WA12;Ölsamen usw., Heilpflanzen usw.;53295;439806;-386511
01.09.12;WA13;Schellack, Gummen, Harz, Pflanzensaft;36603;31494;5109
01.09.12;WA14;Flechtstoffe usw. pflanzlichen Ursprungs;1161;2426;-1265
01.09.12;WA15;Tierische und pflanzliche Fette, Öle, Wachs;288430;318776;-30346
01.09.12;WA16;Zubereitungen von Fleisch, Fisch usw.;206469;188723;17746
01.09.12;WA17;Zucker und Zuckerwaren;169351;133644;35707
01.09.12;WA18;Kakao und Zubereitungen aus Kakao;359579;275394;84185
01.09.12;WA19;Zubereitungen aus Getreide usw., Backwaren;390381;225223;165158
01.09.12;WA20;Zubereitungen von Gemüse, Früchten usw.;188299;338523;-150224
01.09.12;WA21;Verschiedene Lebensmittelzubereitungen;343378;190198;153180
01.09.12;WA22;Getränke, alkoholhaltige Flüssigkeiten, Essig;397474;536556;-139082
01.09.12;WA23;Rückstände der Lebensmittelindustrie, Futter;304823;337183;-32360
01.09.12;WA24;Tabak;325603;167084;158519
01.09.12;WA25;Salz, Schwefel, Steine, Erden usw.;163407;169189;-5782
01.09.12;WA26;Erze, Schlacken, Aschen;21872;600748;-578876
01.09.12;WA27;Mineralische Brennstoffe usw.;2500811;10262491;-7761680
01.09.12;WA28;Anorganische chemische Erzeugnisse;815425;627875;187550
01.09.12;WA29;Organische chemische Erzeugnisse;2033812;2419227;-385415
01.09.12;WA30;Pharmazeutische Erzeugnisse;4833827;2826258;2007569
01.09.12;WA31;Düngemittel;185876;121225;64651
01.09.12;WA32;Gerb- und Farbstoffe, Farben, Lacke usw.;819448;465386;354062
01.09.12;WA33;Etherische Öle, Riech-, Schönheitsmittel;696935;429239;267696
01.09.12;WA34;Seifen, Waschmittel usw.;493604;265457;228147
01.09.12;WA35;Eiweissstoffe, Klebstoffe, Enzyme;225335;151191;74144
01.09.12;WA36;Sprengstoffe, pyrotechnische Artikel usw.;19948;27170;-7222
01.09.12;WA37;Photochemische Erzeugnisse;89331;68359;20972
01.09.12;WA38;Verschiedene Erzeugnisse der Chemischen Industrie;1344801;872633;472168
01.09.12;WA39;Kunststoffe und Waren daraus;4153630;2598195;1555435
01.09.12;WA40;Kautschuk und Waren daraus;1178939;1122614;56325
01.09.12;WA41;Häute, Felle, Leder;81026;62729;18297
01.09.12;WA42;Lederwaren, Sattlerwaren;139404;243136;-103732
01.09.12;WA43;Pelzfelle, künstliches Pelzwerk;19174;15974;3200
01.09.12;WA44;Holz, Holzwaren, Holzkohle;518911;509254;9657
01.09.12;WA45;Kork, Korkwaren;2514;5838;-3324
01.09.12;WA46;Flechtwaren, Korbmacherwaren;3400;8517;-5117
01.09.12;WA47;Halbstoffe aus Holz usw., Papierabfall;94848;265020;-170172
01.09.12;WA48;Papier, Pappe und Waren daraus;1409911;936133;473778
01.09.12;WA49;Bücher, Zeitungen, Bilddrucke usw.;358526;164130;194396
01.09.12;WA50;Seide;6662;6810;-148
01.09.12;WA51;Wolle, feine und grobe Tierhaare;47100;62334;-15234
01.09.12;WA52;Baumwolle;82387;79295;3092
01.09.12;WA53;Andere pflanzliche Spinnstoffe, Papiergarn;3110;5105;-1995
01.09.12;WA54;Synthetisches oder künstliches Filament;148498;106976;41522
01.09.12;WA55;Synthetische oder künstliche Spinnfaser;152134;124242;27892
01.09.12;WA56;Watte, Filz, Vliesstoff usw., Tauwerk;176641;92017;84624
01.09.12;WA57;Teppiche, Fussbodenbelag aus Spinnstoff;40169;79743;-39574
01.09.12;WA58;Spezialgewebe, Spitzen, Tapisserien;35980;24864;11116
01.09.12;WA59;Getränkte, bestrichene usw. Gewebe;153947;89000;64947
01.09.12;WA60;Gewirke und Gestricke;60900;37329;23571
01.09.12;WA61;Bekleidung usw. aus Gewirken, Gestricken;630488;1183744;-553256
01.09.12;WA62;Andere Bekleidung, Bekleidungszubehör;741722;1278162;-536440
01.09.12;WA63;Andere Konfektion, Spinnstoffwaren usw.;174084;255731;-81647
01.09.12;WA64;Schuhe, Gamaschen, ähnliche Waren;311685;614334;-302649
01.09.12;WA65;Kopfbedeckungen und Teile davon;28159;44266;-16107
01.09.12;WA66;Schirme, Gehstöcke usw., Peitschen;5782;8563;-2781
01.09.12;WA67;Zugerichtete Federn, Daunen, künstliche Blumen;9852;15557;-5705
01.09.12;WA68;Waren aus Steinen, Gips, Zement usw.;295813;211524;84289
01.09.12;WA69;Keramische Waren;233697;196539;37158
01.09.12;WA70;Glas und Glaswaren;406264;324393;81871
01.09.12;WA71;Perlen, Edelsteine, Edelmetalle;1297307;1578201;-280894
01.09.12;WA72;Eisen und Stahl;2039822;1917840;121982
01.09.12;WA73;Waren aus Eisen oder Stahl;1997645;1405812;591833
01.09.12;WA74;Kupfer und Waren daraus;881713;860814;20899
01.09.12;WA75;Nickel und Waren daraus;88322;139437;-51115
01.09.12;WA76;Aluminium und Waren daraus;992648;1057129;-64481
01.09.12;WA78;Blei und Waren daraus;36927;21964;14963
01.09.12;WA79;Zink und Waren daraus;50767;88131;-37364
01.09.12;WA80;Zinn und Waren daraus;7740;23434;-15694
01.09.12;WA81;Andere unedle Metalle, Cermets usw.;99226;113665;-14439
01.09.12;WA82;Werkzeuge, Schneidwaren, Essbestecke;532471;337699;194772
01.09.12;WA83;Verschiedene Waren aus unedlen Metallen;523925;305395;218530
01.09.12;WA84;Maschinen, Apparate, mechanische Geräte;15143824;8864501;6279323
01.09.12;WA85;Elektrotechnische Erzeugnisse;8738019;8363226;374793
01.09.12;WA86;Schienenfahrzeuge;292751;144184;148567
01.09.12;WA87;Kraftfahrzeuge, Landfahrzeuge;15278343;5929080;9349263
01.09.12;WA88;Luftfahrzeuge, Raumfahrzeuge;3297889;1121299;2176590
01.09.12;WA89;Wasserfahrzeuge;625867;339848;286019
01.09.12;WA90;Optische, photografische usw. Erzeugnisse;4077872;2204983;1872889
01.09.12;WA91;Uhrmacherwaren;145759;193395;-47636
01.09.12;WA92;Musikinstrumente;46645;50720;-4075
01.09.12;WA93;Waffen und Munition;39356;17258;22098
01.09.12;WA94;Möbel, Beleuchtungskörper usw.;1096279;1145789;-49510
01.09.12;WA95;Spielzeug, Spiele usw., Sportgeräte;332460;483786;-151326
01.09.12;WA96;Verschiedene Waren;295151;175289;119862
01.09.12;WA97;Kunstgegenstände, Sammlungsstücke;52389;21313;31076
01.09.12;WA98;Vollständige Fabrikationsanlagen;316661;2595;314066
01.09.12;WA99;Zusammenstellungen verschiedener Waren;1469714;841954;627760
01.09.13;WA01;Lebende Tiere;146996;179226;-32230
01.09.13;WA02;Fleisch;656189;506654;149535
01.09.13;WA03;Fische, Krebs- und Weichtiere;121056;255468;-134412
01.09.13;WA04;Milch, Milcherzeugnisse, Eier, Honig;781293;563270;218023
01.09.13;WA05;Andere Waren tierischen Ursprungs;65624;73184;-7560
01.09.13;WA06;Pflanzen, Waren des Blumenhandels;75616;170012;-94396
01.09.13;WA07;Gemüse, Pflanzen für Ernährung;92053;287756;-195703
01.09.13;WA08;Geniessbare Früchte und Nüsse;109805;586284;-476479
01.09.13;WA09;Kaffee, Tee, Mate, Gewürze;181421;271989;-90568
01.09.13;WA10;Getreide;245954;188384;57570
01.09.13;WA11;Müllereierzeugnisse, Malz usw.;103868;42740;61128
01.09.13;WA12;Ölsamen usw., Heilpflanzen usw.;54944;492681;-437737
01.09.13;WA13;Schellack, Gummen, Harz, Pflanzensaft;36926;31854;5072
01.09.13;WA14;Flechtstoffe usw. pflanzlichen Ursprungs;622;2110;-1488
01.09.13;WA15;Tierische und pflanzliche Fette, Öle, Wachs;252004;330991;-78987
01.09.13;WA16;Zubereitungen von Fleisch, Fisch usw.;228667;201546;27121
01.09.13;WA17;Zucker und Zuckerwaren;156242;141790;14452
01.09.13;WA18;Kakao und Zubereitungen aus Kakao;387218;280864;106354
01.09.13;WA19;Zubereitungen aus Getreide usw., Backwaren;443074;254603;188471
01.09.13;WA20;Zubereitungen von Gemüse, Früchten usw.;189566;327607;-138041
01.09.13;WA21;Verschiedene Lebensmittelzubereitungen;378960;203357;175603
01.09.13;WA22;Getränke, alkoholhaltige Flüssigkeiten, Essig;441277;560283;-119006
01.09.13;WA23;Rückstände der Lebensmittelindustrie, Futter;286744;336350;-49606
01.09.13;WA24;Tabak;317577;159168;158409
01.09.13;WA25;Salz, Schwefel, Steine, Erden usw.;170620;158960;11660
01.09.13;WA26;Erze, Schlacken, Aschen;25852;523163;-497311
01.09.13;WA27;Mineralische Brennstoffe usw.;2236120;9717938;-7481818
01.09.13;WA28;Anorganische chemische Erzeugnisse;585066;603619;-18553
01.09.13;WA29;Organische chemische Erzeugnisse;1949020;2081012;-131992
01.09.13;WA30;Pharmazeutische Erzeugnisse;4784321;2890662;1893659
01.09.13;WA31;Düngemittel;213550;86288;127262
01.09.13;WA32;Gerb- und Farbstoffe, Farben, Lacke usw.;870078;495447;374631
01.09.13;WA33;Etherische Öle, Riech-, Schönheitsmittel;726482;466194;260288
01.09.13;WA34;Seifen, Waschmittel usw.;526295;283777;242518
01.09.13;WA35;Eiweissstoffe, Klebstoffe, Enzyme;232906;165048;67858
01.09.13;WA36;Sprengstoffe, pyrotechnische Artikel usw.;17768;21159;-3391
01.09.13;WA37;Photochemische Erzeugnisse;93596;64970;28626
01.09.13;WA38;Verschiedene Erzeugnisse der Chemischen Industrie;1502937;897982;604955
01.09.13;WA39;Kunststoffe und Waren daraus;4341247;2785720;1555527
01.09.13;WA40;Kautschuk und Waren daraus;1188204;1155936;32268
01.09.13;WA41;Häute, Felle, Leder;89141;73976;15165
01.09.13;WA42;Lederwaren, Sattlerwaren;139224;262787;-123563
01.09.13;WA43;Pelzfelle, künstliches Pelzwerk;20488;16639;3849
01.09.13;WA44;Holz, Holzwaren, Holzkohle;590560;557034;33526
01.09.13;WA45;Kork, Korkwaren;2233;7756;-5523
01.09.13;WA46;Flechtwaren, Korbmacherwaren;3465;8950;-5485
01.09.13;WA47;Halbstoffe aus Holz usw., Papierabfall;92979;283960;-190981
01.09.13;WA48;Papier, Pappe und Waren daraus;1397903;974416;423487
01.09.13;WA49;Bücher, Zeitungen, Bilddrucke usw.;365636;162534;203102
01.09.13;WA50;Seide;4943;6020;-1077
01.09.13;WA51;Wolle, feine und grobe Tierhaare;43345;48426;-5081
01.09.13;WA52;Baumwolle;78420;76078;2342
01.09.13;WA53;Andere pflanzliche Spinnstoffe, Papiergarn;2786;4544;-1758
01.09.13;WA54;Synthetisches oder künstliches Filament;147297;111755;35542
01.09.13;WA55;Synthetische oder künstliche Spinnfaser;167602;128878;38724
01.09.13;WA56;Watte, Filz, Vliesstoff usw., Tauwerk;186386;97186;89200
01.09.13;WA57;Teppiche, Fussbodenbelag aus Spinnstoff;42284;77388;-35104
01.09.13;WA58;Spezialgewebe, Spitzen, Tapisserien;38229;22318;15911
01.09.13;WA59;Getränkte, bestrichene usw. Gewebe;170849;87410;83439
01.09.13;WA60;Gewirke und Gestricke;61966;31781;30185
01.09.13;WA61;Bekleidung usw. aus Gewirken, Gestricken;657481;1293795;-636314
01.09.13;WA62;Andere Bekleidung, Bekleidungszubehör;796810;1365305;-568495
01.09.13;WA63;Andere Konfektion, Spinnstoffwaren usw.;191299;272971;-81672
01.09.13;WA64;Schuhe, Gamaschen, ähnliche Waren;383953;700884;-316931
01.09.13;WA65;Kopfbedeckungen und Teile davon;39813;49856;-10043
01.09.13;WA66;Schirme, Gehstöcke usw., Peitschen;6126;9460;-3334
01.09.13;WA67;Zugerichtete Federn, Daunen, künstliche Blumen;9783;15046;-5263
01.09.13;WA68;Waren aus Steinen, Gips, Zement usw.;317956;225442;92514
01.09.13;WA69;Keramische Waren;240574;195480;45094
01.09.13;WA70;Glas und Glaswaren;466038;362209;103829
01.09.13;WA71;Perlen, Edelsteine, Edelmetalle;968954;1323576;-354622
01.09.13;WA72;Eisen und Stahl;1816418;1719315;97103
01.09.13;WA73;Waren aus Eisen oder Stahl;2134470;1468709;665761
01.09.13;WA74;Kupfer und Waren daraus;834749;864864;-30115
01.09.13;WA75;Nickel und Waren daraus;86436;102417;-15981
01.09.13;WA76;Aluminium und Waren daraus;1054819;1075029;-20210
01.09.13;WA78;Blei und Waren daraus;36459;25252;11207
01.09.13;WA79;Zink und Waren daraus;48334;89731;-41397
01.09.13;WA80;Zinn und Waren daraus;9124;30333;-21209
01.09.13;WA81;Andere unedle Metalle, Cermets usw.;103036;108460;-5424
01.09.13;WA82;Werkzeuge, Schneidwaren, Essbestecke;571476;339436;232040
01.09.13;WA83;Verschiedene Waren aus unedlen Metallen;531845;325668;206177
01.09.13;WA84;Maschinen, Apparate, mechanische Geräte;15889844;8906976;6982868
01.09.13;WA85;Elektrotechnische Erzeugnisse;9276594;8576700;699894
01.09.13;WA86;Schienenfahrzeuge;382514;177310;205204
01.09.13;WA87;Kraftfahrzeuge, Landfahrzeuge;16738752;6094717;10644035
01.09.13;WA88;Luftfahrzeuge, Raumfahrzeuge;3381895;738117;2643778
01.09.13;WA89;Wasserfahrzeuge;138769;179431;-40662
01.09.13;WA90;Optische, photografische usw. Erzeugnisse;4395372;2266538;2128834
01.09.13;WA91;Uhrmacherwaren;169016;187044;-18028
01.09.13;WA92;Musikinstrumente;55172;44838;10334
01.09.13;WA93;Waffen und Munition;52744;14061;38683
01.09.13;WA94;Möbel, Beleuchtungskörper usw.;1102168;1242681;-140513
01.09.13;WA95;Spielzeug, Spiele usw., Sportgeräte;313248;459968;-146720
01.09.13;WA96;Verschiedene Waren;289708;188855;100853
01.09.13;WA97;Kunstgegenstände, Sammlungsstücke;61620;18893;42727
01.09.13;WA98;Vollständige Fabrikationsanlagen;218214;2394;215820
01.09.13;WA99;Zusammenstellungen verschiedener Waren;1385902;791597;594305
01.09.14;WA01;Lebende Tiere;128606;163181;-34575
01.09.14;WA02;Fleisch;679332;532557;146775
01.09.14;WA03;Fische, Krebs- und Weichtiere;117174;310668;-193494
01.09.14;WA04;Milch, Milcherzeugnisse, Eier, Honig;739721;579669;160052
01.09.14;WA05;Andere Waren tierischen Ursprungs;74115;77942;-3827
01.09.14;WA06;Pflanzen, Waren des Blumenhandels;76661;188008;-111347
01.09.14;WA07;Gemüse, Pflanzen für Ernährung;71266;325103;-253837
01.09.14;WA08;Geniessbare Früchte und Nüsse;133991;595819;-461828
01.09.14;WA09;Kaffee, Tee, Mate, Gewürze;190840;360367;-169527
01.09.14;WA10;Getreide;207792;203549;4243
01.09.14;WA11;Müllereierzeugnisse, Malz usw.;110229;39285;70944
01.09.14;WA12;Ölsamen usw., Heilpflanzen usw.;59821;386431;-326610
01.09.14;WA13;Schellack, Gummen, Harz, Pflanzensaft;40713;35690;5023
01.09.14;WA14;Flechtstoffe usw. pflanzlichen Ursprungs;560;3207;-2647
01.09.14;WA15;Tierische und pflanzliche Fette, Öle, Wachs;221348;296001;-74653
01.09.14;WA16;Zubereitungen von Fleisch, Fisch usw.;245985;197661;48324
01.09.14;WA17;Zucker und Zuckerwaren;168041;127754;40287
01.09.14;WA18;Kakao und Zubereitungen aus Kakao;486192;369743;116449
01.09.14;WA19;Zubereitungen aus Getreide usw., Backwaren;487505;282728;204777
01.09.14;WA20;Zubereitungen von Gemüse, Früchten usw.;199675;336007;-136332
01.09.14;WA21;Verschiedene Lebensmittelzubereitungen;388242;224200;164042
01.09.14;WA22;Getränke, alkoholhaltige Flüssigkeiten, Essig;452132;554069;-101937
01.09.14;WA23;Rückstände der Lebensmittelindustrie, Futter;336546;311553;24993
01.09.14;WA24;Tabak;337001;171590;165411
01.09.14;WA25;Salz, Schwefel, Steine, Erden usw.;178454;156494;21960
01.09.14;WA26;Erze, Schlacken, Aschen;25219;640813;-615594
01.09.14;WA27;Mineralische Brennstoffe usw.;2411585;9553027;-7141442
01.09.14;WA28;Anorganische chemische Erzeugnisse;758944;547360;211584
01.09.14;WA29;Organische chemische Erzeugnisse;2152767;2097117;55650
01.09.14;WA30;Pharmazeutische Erzeugnisse;5021512;3281327;1740185
01.09.14;WA31;Düngemittel;173992;119505;54487
01.09.14;WA32;Gerb- und Farbstoffe, Farben, Lacke usw.;909615;496513;413102
01.09.14;WA33;Etherische Öle, Riech-, Schönheitsmittel;758198;494773;263425
01.09.14;WA34;Seifen, Waschmittel usw.;571861;317977;253884
01.09.14;WA35;Eiweissstoffe, Klebstoffe, Enzyme;253307;159371;93936
01.09.14;WA36;Sprengstoffe, pyrotechnische Artikel usw.;18654;28816;-10162
01.09.14;WA37;Photochemische Erzeugnisse;95962;62314;33648
01.09.14;WA38;Verschiedene Erzeugnisse der Chemischen Industrie;1589101;971788;617313
01.09.14;WA39;Kunststoffe und Waren daraus;4701334;2939836;1761498
01.09.14;WA40;Kautschuk und Waren daraus;1243915;1163556;80359
01.09.14;WA41;Häute, Felle, Leder;101798;76283;25515
01.09.14;WA42;Lederwaren, Sattlerwaren;157600;295954;-138354
01.09.14;WA43;Pelzfelle, künstliches Pelzwerk;17361;15744;1617
01.09.14;WA44;Holz, Holzwaren, Holzkohle;609433;599805;9628
01.09.14;WA45;Kork, Korkwaren;1981;5893;-3912
01.09.14;WA46;Flechtwaren, Korbmacherwaren;3686;9901;-6215
01.09.14;WA47;Halbstoffe aus Holz usw., Papierabfall;98422;302171;-203749
01.09.14;WA48;Papier, Pappe und Waren daraus;1463149;1045568;417581
01.09.14;WA49;Bücher, Zeitungen, Bilddrucke usw.;375654;169180;206474
01.09.14;WA50;Seide;4327;5239;-912
01.09.14;WA51;Wolle, feine und grobe Tierhaare;39367;50881;-11514
01.09.14;WA52;Baumwolle;76940;74694;2246
01.09.14;WA53;Andere pflanzliche Spinnstoffe, Papiergarn;2444;5542;-3098
01.09.14;WA54;Synthetisches oder künstliches Filament;168735;120797;47938
01.09.14;WA55;Synthetische oder künstliche Spinnfaser;162921;136384;26537
01.09.14;WA56;Watte, Filz, Vliesstoff usw., Tauwerk;210378;106655;103723
01.09.14;WA57;Teppiche, Fussbodenbelag aus Spinnstoff;42937;83723;-40786
01.09.14;WA58;Spezialgewebe, Spitzen, Tapisserien;38179;22755;15424
01.09.14;WA59;Getränkte, bestrichene usw. Gewebe;182563;93603;88960
01.09.14;WA60;Gewirke und Gestricke;60189;34708;25481
01.09.14;WA61;Bekleidung usw. aus Gewirken, Gestricken;704947;1381796;-676849
01.09.14;WA62;Andere Bekleidung, Bekleidungszubehör;812297;1433678;-621381
01.09.14;WA63;Andere Konfektion, Spinnstoffwaren usw.;205045;293026;-87981
01.09.14;WA64;Schuhe, Gamaschen, ähnliche Waren;427922;818590;-390668
01.09.14;WA65;Kopfbedeckungen und Teile davon;38219;55550;-17331
01.09.14;WA66;Schirme, Gehstöcke usw., Peitschen;6382;9203;-2821
01.09.14;WA67;Zugerichtete Federn, Daunen, künstliche Blumen;11250;16562;-5312
01.09.14;WA68;Waren aus Steinen, Gips, Zement usw.;329652;236902;92750
01.09.14;WA69;Keramische Waren;264888;208669;56219
01.09.14;WA70;Glas und Glaswaren;484461;381369;103092
01.09.14;WA71;Perlen, Edelsteine, Edelmetalle;962954;1066842;-103888
01.09.14;WA72;Eisen und Stahl;1997813;2005728;-7915
01.09.14;WA73;Waren aus Eisen oder Stahl;2283537;1601550;681987
01.09.14;WA74;Kupfer und Waren daraus;946175;718072;228103
01.09.14;WA75;Nickel und Waren daraus;99481;145323;-45842
01.09.14;WA76;Aluminium und Waren daraus;1145856;1195474;-49618
01.09.14;WA78;Blei und Waren daraus;52444;22350;30094
01.09.14;WA79;Zink und Waren daraus;62865;105777;-42912
01.09.14;WA80;Zinn und Waren daraus;11054;27445;-16391
01.09.14;WA81;Andere unedle Metalle, Cermets usw.;134038;132220;1818
01.09.14;WA82;Werkzeuge, Schneidwaren, Essbestecke;636958;360095;276863
01.09.14;WA83;Verschiedene Waren aus unedlen Metallen;586290;356491;229799
01.09.14;WA84;Maschinen, Apparate, mechanische Geräte;17010731;10162221;6848510
01.09.14;WA85;Elektrotechnische Erzeugnisse;9990904;9280592;710312
01.09.14;WA86;Schienenfahrzeuge;284650;194072;90578
01.09.14;WA87;Kraftfahrzeuge, Landfahrzeuge;17992549;6911081;11081468
01.09.14;WA88;Luftfahrzeuge, Raumfahrzeuge;3105766;1634888;1470878
01.09.14;WA89;Wasserfahrzeuge;1008955;249114;759841
01.09.14;WA90;Optische, photografische usw. Erzeugnisse;4562019;2568628;1993391
01.09.14;WA91;Uhrmacherwaren;192356;194040;-1684
01.09.14;WA92;Musikinstrumente;51116;46785;4331
01.09.14;WA93;Waffen und Munition;37352;15870;21482
01.09.14;WA94;Möbel, Beleuchtungskörper usw.;1250862;1467459;-216597
01.09.14;WA95;Spielzeug, Spiele usw., Sportgeräte;357751;513148;-155397
01.09.14;WA96;Verschiedene Waren;308599;210503;98096
01.09.14;WA97;Kunstgegenstände, Sammlungsstücke;59105;33339;25766
01.09.14;WA98;Vollständige Fabrikationsanlagen;156730;7395;149335
01.09.14;WA99;Zusammenstellungen verschiedener Waren;2241423;840875;1400548
01.09.15;WA01;Lebende Tiere;143386;142700;686
01.09.15;WA02;Fleisch;647892;536240;111652
01.09.15;WA03;Fische, Krebs- und Weichtiere;128911;304641;-175730
01.09.15;WA04;Milch, Milcherzeugnisse, Eier, Honig;690367;581972;108395
01.09.15;WA05;Andere Waren tierischen Ursprungs;67478;67198;280
01.09.15;WA06;Pflanzen, Waren des Blumenhandels;74712;189720;-115008
01.09.15;WA07;Gemüse, Pflanzen für Ernährung;91327;385237;-293910
01.09.15;WA08;Geniessbare Früchte und Nüsse;158654;762675;-604021
01.09.15;WA09;Kaffee, Tee, Mate, Gewürze;219925;315705;-95780
01.09.15;WA10;Getreide;141347;213034;-71687
01.09.15;WA11;Müllereierzeugnisse, Malz usw.;124489;46020;78469
01.09.15;WA12;Ölsamen usw., Heilpflanzen usw.;65916;480433;-414517
01.09.15;WA13;Schellack, Gummen, Harz, Pflanzensaft;42879;34763;8116
01.09.15;WA14;Flechtstoffe usw. pflanzlichen Ursprungs;711;3659;-2948
01.09.15;WA15;Tierische und pflanzliche Fette, Öle, Wachs;231540;341784;-110244
01.09.15;WA16;Zubereitungen von Fleisch, Fisch usw.;230630;202953;27677
01.09.15;WA17;Zucker und Zuckerwaren;156222;142019;14203
01.09.15;WA18;Kakao und Zubereitungen aus Kakao;463675;372455;91220
01.09.15;WA19;Zubereitungen aus Getreide usw., Backwaren;505914;362379;143535
01.09.15;WA20;Zubereitungen von Gemüse, Früchten usw.;222965;398407;-175442
01.09.15;WA21;Verschiedene Lebensmittelzubereitungen;411554;241737;169817
01.09.15;WA22;Getränke, alkoholhaltige Flüssigkeiten, Essig;450785;580292;-129507
01.09.15;WA23;Rückstände der Lebensmittelindustrie, Futter;369977;354162;15815
01.09.15;WA24;Tabak;379337;179934;199403
01.09.15;WA25;Salz, Schwefel, Steine, Erden usw.;180815;144790;36025
01.09.15;WA26;Erze, Schlacken, Aschen;29689;543566;-513877
01.09.15;WA27;Mineralische Brennstoffe usw.;2329936;7274887;-4944951
01.09.15;WA28;Anorganische chemische Erzeugnisse;701294;478919;222375
01.09.15;WA29;Organische chemische Erzeugnisse;1930921;2372509;-441588
01.09.15;WA30;Pharmazeutische Erzeugnisse;6186245;3844719;2341526
01.09.15;WA31;Düngemittel;182699;94167;88532
01.09.15;WA32;Gerb- und Farbstoffe, Farben, Lacke usw.;899228;445184;454044
01.09.15;WA33;Etherische Öle, Riech-, Schönheitsmittel;791341;581891;209450
01.09.15;WA34;Seifen, Waschmittel usw.;611720;333084;278636
01.09.15;WA35;Eiweissstoffe, Klebstoffe, Enzyme;268071;175681;92390
01.09.15;WA36;Sprengstoffe, pyrotechnische Artikel usw.;18968;36681;-17713
01.09.15;WA37;Photochemische Erzeugnisse;103579;61549;42030
01.09.15;WA38;Verschiedene Erzeugnisse der Chemischen Industrie;1592904;978643;614261
01.09.15;WA39;Kunststoffe und Waren daraus;4747727;3146513;1601214
01.09.15;WA40;Kautschuk und Waren daraus;1261591;1221572;40019
01.09.15;WA41;Häute, Felle, Leder;97572;69315;28257
01.09.15;WA42;Lederwaren, Sattlerwaren;170594;327904;-157310
01.09.15;WA43;Pelzfelle, künstliches Pelzwerk;14682;14020;662
01.09.15;WA44;Holz, Holzwaren, Holzkohle;636290;651298;-15008
01.09.15;WA45;Kork, Korkwaren;2490;6212;-3722
01.09.15;WA46;Flechtwaren, Korbmacherwaren;4118;10060;-5942
01.09.15;WA47;Halbstoffe aus Holz usw., Papierabfall;97658;362924;-265266
01.09.15;WA48;Papier, Pappe und Waren daraus;1480016;1036123;443893
01.09.15;WA49;Bücher, Zeitungen, Bilddrucke usw.;380492;218567;161925
01.09.15;WA50;Seide;4995;4068;927
01.09.15;WA51;Wolle, feine und grobe Tierhaare;49881;51155;-1274
01.09.15;WA52;Baumwolle;74477;77009;-2532
01.09.15;WA53;Andere pflanzliche Spinnstoffe, Papiergarn;3420;6115;-2695
01.09.15;WA54;Synthetisches oder künstliches Filament;166082;130808;35274
01.09.15;WA55;Synthetische oder künstliche Spinnfaser;159049;137827;21222
01.09.15;WA56;Watte, Filz, Vliesstoff usw., Tauwerk;204801;115367;89434
01.09.15;WA57;Teppiche, Fussbodenbelag aus Spinnstoff;48576;87464;-38888
01.09.15;WA58;Spezialgewebe, Spitzen, Tapisserien;47197;22970;24227
01.09.15;WA59;Getränkte, bestrichene usw. Gewebe;185286;91289;93997
01.09.15;WA60;Gewirke und Gestricke;67317;38569;28748
01.09.15;WA61;Bekleidung usw. aus Gewirken, Gestricken;733640;1454574;-720934
01.09.15;WA62;Andere Bekleidung, Bekleidungszubehör;796575;1494179;-697604
01.09.15;WA63;Andere Konfektion, Spinnstoffwaren usw.;223060;319498;-96438
01.09.15;WA64;Schuhe, Gamaschen, ähnliche Waren;455819;856392;-400573
01.09.15;WA65;Kopfbedeckungen und Teile davon;39541;53642;-14101
01.09.15;WA66;Schirme, Gehstöcke usw., Peitschen;7326;12885;-5559
01.09.15;WA67;Zugerichtete Federn, Daunen, künstliche Blumen;10887;17315;-6428
01.09.15;WA68;Waren aus Steinen, Gips, Zement usw.;370473;268464;102009
01.09.15;WA69;Keramische Waren;265000;230558;34442
01.09.15;WA70;Glas und Glaswaren;552452;440001;112451
01.09.15;WA71;Perlen, Edelsteine, Edelmetalle;862750;1264083;-401333
01.09.15;WA72;Eisen und Stahl;1772565;1920641;-148076
01.09.15;WA73;Waren aus Eisen oder Stahl;2277690;1655308;622382
01.09.15;WA74;Kupfer und Waren daraus;876532;690598;185934
01.09.15;WA75;Nickel und Waren daraus;86181;99890;-13709
01.09.15;WA76;Aluminium und Waren daraus;1216795;1333816;-117021
01.09.15;WA78;Blei und Waren daraus;45858;17420;28438
01.09.15;WA79;Zink und Waren daraus;51026;105369;-54343
01.09.15;WA80;Zinn und Waren daraus;8826;28463;-19637
01.09.15;WA81;Andere unedle Metalle, Cermets usw.;124369;143927;-19558
01.09.15;WA82;Werkzeuge, Schneidwaren, Essbestecke;686940;398527;288413
01.09.15;WA83;Verschiedene Waren aus unedlen Metallen;604212;392393;211819
01.09.15;WA84;Maschinen, Apparate, mechanische Geräte;17092429;10396668;6695761
01.09.15;WA85;Elektrotechnische Erzeugnisse;10474047;10039829;434218
01.09.15;WA86;Schienenfahrzeuge;333292;202442;130850
01.09.15;WA87;Kraftfahrzeuge, Landfahrzeuge;20026340;8274109;11752231
01.09.15;WA88;Luftfahrzeuge, Raumfahrzeuge;3237014;1568218;1668796
01.09.15;WA89;Wasserfahrzeuge;996644;657968;338676
01.09.15;WA90;Optische, photografische usw. Erzeugnisse;4885386;2823011;2062375
01.09.15;WA91;Uhrmacherwaren;189223;230721;-41498
01.09.15;WA92;Musikinstrumente;55879;52267;3612
01.09.15;WA93;Waffen und Munition;37320;16760;20560
01.09.15;WA94;Möbel, Beleuchtungskörper usw.;1341059;1526934;-185875
01.09.15;WA95;Spielzeug, Spiele usw., Sportgeräte;453766;691854;-238088
01.09.15;WA96;Verschiedene Waren;323777;212361;111416
01.09.15;WA97;Kunstgegenstände, Sammlungsstücke;45920;38295;7625
01.09.15;WA98;Vollständige Fabrikationsanlagen;257770;719;257051
01.09.15;WA99;Zusammenstellungen verschiedener Waren;1875025;813686;1061339
01.09.16;WA01;Lebende Tiere;132805;176891;-44086
01.09.16;WA02;Fleisch;714815;523892;190923
01.09.16;WA03;Fische, Krebs- und Weichtiere;152418;351549;-199131
01.09.16;WA04;Milch, Milcherzeugnisse, Eier, Honig;717017;586189;130828
01.09.16;WA05;Andere Waren tierischen Ursprungs;71734;70682;1052
01.09.16;WA06;Pflanzen, Waren des Blumenhandels;78013;181040;-103027
01.09.16;WA07;Gemüse, Pflanzen für Ernährung;89857;378670;-288813
01.09.16;WA08;Geniessbare Früchte und Nüsse;156971;782186;-625215
01.09.16;WA09;Kaffee, Tee, Mate, Gewürze;248508;342347;-93839
01.09.16;WA10;Getreide;179959;192381;-12422
01.09.16;WA11;Müllereierzeugnisse, Malz usw.;126392;47659;78733
01.09.16;WA12;Ölsamen usw., Heilpflanzen usw.;67568;509967;-442399
01.09.16;WA13;Schellack, Gummen, Harz, Pflanzensaft;47264;36950;10314
01.09.16;WA14;Flechtstoffe usw. pflanzlichen Ursprungs;552;3229;-2677
01.09.16;WA15;Tierische und pflanzliche Fette, Öle, Wachs;258727;337721;-78994
01.09.16;WA16;Zubereitungen von Fleisch, Fisch usw.;246160;213849;32311
01.09.16;WA17;Zucker und Zuckerwaren;180116;144241;35875
01.09.16;WA18;Kakao und Zubereitungen aus Kakao;592791;475196;117595
01.09.16;WA19;Zubereitungen aus Getreide usw., Backwaren;541003;338559;202444
01.09.16;WA20;Zubereitungen von Gemüse, Früchten usw.;233549;385991;-152442
01.09.16;WA21;Verschiedene Lebensmittelzubereitungen;437548;256729;180819
01.09.16;WA22;Getränke, alkoholhaltige Flüssigkeiten, Essig;505243;592604;-87361
01.09.16;WA23;Rückstände der Lebensmittelindustrie, Futter;314648;321705;-7057
01.09.16;WA24;Tabak;354273;154229;200044
01.09.16;WA25;Salz, Schwefel, Steine, Erden usw.;179063;147562;31501
01.09.16;WA26;Erze, Schlacken, Aschen;34176;477623;-443447
01.09.16;WA27;Mineralische Brennstoffe usw.;1819457;5620047;-3800590
01.09.16;WA28;Anorganische chemische Erzeugnisse;685510;520591;164919
01.09.16;WA29;Organische chemische Erzeugnisse;1932125;2059126;-127001
01.09.16;WA30;Pharmazeutische Erzeugnisse;5787432;3677885;2109547
01.09.16;WA31;Düngemittel;155057;74411;80646
01.09.16;WA32;Gerb- und Farbstoffe, Farben, Lacke usw.;959849;510851;448998
01.09.16;WA33;Etherische Öle, Riech-, Schönheitsmittel;793994;624043;169951
01.09.16;WA34;Seifen, Waschmittel usw.;635249;340315;294934
01.09.16;WA35;Eiweissstoffe, Klebstoffe, Enzyme;282186;165433;116753
01.09.16;WA36;Sprengstoffe, pyrotechnische Artikel usw.;20361;24800;-4439
01.09.16;WA37;Photochemische Erzeugnisse;105869;68754;37115
01.09.16;WA38;Verschiedene Erzeugnisse der Chemischen Industrie;1740257;1010618;729639
01.09.16;WA39;Kunststoffe und Waren daraus;4904225;3050363;1853862
01.09.16;WA40;Kautschuk und Waren daraus;1234867;1193608;41259
01.09.16;WA41;Häute, Felle, Leder;86653;63047;23606
01.09.16;WA42;Lederwaren, Sattlerwaren;175324;319640;-144316
01.09.16;WA43;Pelzfelle, künstliches Pelzwerk;10532;11088;-556
01.09.16;WA44;Holz, Holzwaren, Holzkohle;663743;636607;27136
01.09.16;WA45;Kork, Korkwaren;2244;7377;-5133
01.09.16;WA46;Flechtwaren, Korbmacherwaren;3753;9579;-5826
01.09.16;WA47;Halbstoffe aus Holz usw., Papierabfall;100846;296391;-195545
01.09.16;WA48;Papier, Pappe und Waren daraus;1520205;1027986;492219
01.09.16;WA49;Bücher, Zeitungen, Bilddrucke usw.;376457;231903;144554
01.09.16;WA50;Seide;4319;4760;-441
01.09.16;WA51;Wolle, feine und grobe Tierhaare;44779;53931;-9152
01.09.16;WA52;Baumwolle;80223;71179;9044
01.09.16;WA53;Andere pflanzliche Spinnstoffe, Papiergarn;2973;5754;-2781
01.09.16;WA54;Synthetisches oder künstliches Filament;162808;124945;37863
01.09.16;WA55;Synthetische oder künstliche Spinnfaser;158055;121352;36703
01.09.16;WA56;Watte, Filz, Vliesstoff usw., Tauwerk;202468;113409;89059
01.09.16;WA57;Teppiche, Fussbodenbelag aus Spinnstoff;46207;89709;-43502
01.09.16;WA58;Spezialgewebe, Spitzen, Tapisserien;45621;22600;23021
01.09.16;WA59;Getränkte, bestrichene usw. Gewebe;203388;92812;110576
01.09.16;WA60;Gewirke und Gestricke;65082;34668;30414
01.09.16;WA61;Bekleidung usw. aus Gewirken, Gestricken;643567;1434348;-790781
01.09.16;WA62;Andere Bekleidung, Bekleidungszubehör;757577;1426699;-669122
01.09.16;WA63;Andere Konfektion, Spinnstoffwaren usw.;215670;320319;-104649
01.09.16;WA64;Schuhe, Gamaschen, ähnliche Waren;438187;907393;-469206
01.09.16;WA65;Kopfbedeckungen und Teile davon;40444;57934;-17490
01.09.16;WA66;Schirme, Gehstöcke usw., Peitschen;5036;12222;-7186
01.09.16;WA67;Zugerichtete Federn, Daunen, künstliche Blumen;12965;19754;-6789
01.09.16;WA68;Waren aus Steinen, Gips, Zement usw.;387103;269522;117581
01.09.16;WA69;Keramische Waren;268874;231020;37854
01.09.16;WA70;Glas und Glaswaren;551895;439775;112120
01.09.16;WA71;Perlen, Edelsteine, Edelmetalle;1060613;1122243;-61630
01.09.16;WA72;Eisen und Stahl;1727045;1839470;-112425
01.09.16;WA73;Waren aus Eisen oder Stahl;2255706;1616886;638820
01.09.16;WA74;Kupfer und Waren daraus;834042;720552;113490
01.09.16;WA75;Nickel und Waren daraus;79221;97930;-18709
01.09.16;WA76;Aluminium und Waren daraus;1190214;1341654;-151440
01.09.16;WA78;Blei und Waren daraus;34363;25233;9130
01.09.16;WA79;Zink und Waren daraus;52826;112200;-59374
01.09.16;WA80;Zinn und Waren daraus;10135;33944;-23809
01.09.16;WA81;Andere unedle Metalle, Cermets usw.;120806;137499;-16693
01.09.16;WA82;Werkzeuge, Schneidwaren, Essbestecke;655528;401154;254374
01.09.16;WA83;Verschiedene Waren aus unedlen Metallen;637014;384672;252342
01.09.16;WA84;Maschinen, Apparate, mechanische Geräte;17561148;10509821;7051327
01.09.16;WA85;Elektrotechnische Erzeugnisse;11120525;10303935;816590
01.09.16;WA86;Schienenfahrzeuge;359983;259777;100206
01.09.16;WA87;Kraftfahrzeuge, Landfahrzeuge;20234631;9112302;11122329
01.09.16;WA88;Luftfahrzeuge, Raumfahrzeuge;3099263;1275274;1823989
01.09.16;WA89;Wasserfahrzeuge;60412;639169;-578757
01.09.16;WA90;Optische, photografische usw. Erzeugnisse;5252909;2895719;2357190
01.09.16;WA91;Uhrmacherwaren;161647;176083;-14436
01.09.16;WA92;Musikinstrumente;56969;55192;1777
01.09.16;WA93;Waffen und Munition;49018;21259;27759
01.09.16;WA94;Möbel, Beleuchtungskörper usw.;1347492;1571214;-223722
01.09.16;WA95;Spielzeug, Spiele usw., Sportgeräte;429964;592310;-162346
01.09.16;WA96;Verschiedene Waren;318632;240987;77645
01.09.16;WA97;Kunstgegenstände, Sammlungsstücke;56270;37779;18491
01.09.16;WA98;Vollständige Fabrikationsanlagen;199716;28;199688
01.09.16;WA99;Zusammenstellungen verschiedener Waren;1643012;901880;741132
01.09.17;WA01;Lebende Tiere;130685;162413;-31728
01.09.17;WA02;Fleisch;715322;587541;127781
01.09.17;WA03;Fische, Krebs- und Weichtiere;146129;342214;-196085
01.09.17;WA04;Milch, Milcherzeugnisse, Eier, Honig;765213;721654;43559
01.09.17;WA05;Andere Waren tierischen Ursprungs;69657;79884;-10227
01.09.17;WA06;Pflanzen, Waren des Blumenhandels;87120;205135;-118015
01.09.17;WA07;Gemüse, Pflanzen für Ernährung;105850;401050;-295200
01.09.17;WA08;Geniessbare Früchte und Nüsse;148473;848150;-699677
01.09.17;WA09;Kaffee, Tee, Mate, Gewürze;247785;333451;-85666
01.09.17;WA10;Getreide;147070;204188;-57118
01.09.17;WA11;Müllereierzeugnisse, Malz usw.;128947;46238;82709
01.09.17;WA12;Ölsamen usw., Heilpflanzen usw.;79201;612280;-533079
01.09.17;WA13;Schellack, Gummen, Harz, Pflanzensaft;44776;36541;8235
01.09.17;WA14;Flechtstoffe usw. pflanzlichen Ursprungs;546;3111;-2565
01.09.17;WA15;Tierische und pflanzliche Fette, Öle, Wachs;254253;328454;-74201
01.09.17;WA16;Zubereitungen von Fleisch, Fisch usw.;244801;258882;-14081
01.09.17;WA17;Zucker und Zuckerwaren;186321;142627;43694
01.09.17;WA18;Kakao und Zubereitungen aus Kakao;526171;396786;129385
01.09.17;WA19;Zubereitungen aus Getreide usw., Backwaren;551871;407568;144303
01.09.17;WA20;Zubereitungen von Gemüse, Früchten usw.;242425;425566;-183141
01.09.17;WA21;Verschiedene Lebensmittelzubereitungen;498871;294826;204045
01.09.17;WA22;Getränke, alkoholhaltige Flüssigkeiten, Essig;490854;602723;-111869
01.09.17;WA23;Rückstände der Lebensmittelindustrie, Futter;346581;353043;-6462
01.09.17;WA24;Tabak;309832;186644;123188
01.09.17;WA25;Salz, Schwefel, Steine, Erden usw.;176913;162821;14092
01.09.17;WA26;Erze, Schlacken, Aschen;50044;666350;-616306
01.09.17;WA27;Mineralische Brennstoffe usw.;1812898;6458670;-4645772
01.09.17;WA28;Anorganische chemische Erzeugnisse;701232;505673;195559
01.09.17;WA29;Organische chemische Erzeugnisse;1967844;2107262;-139418
01.09.17;WA30;Pharmazeutische Erzeugnisse;6038449;3953894;2084555
01.09.17;WA31;Düngemittel;162994;81610;81384
01.09.17;WA32;Gerb- und Farbstoffe, Farben, Lacke usw.;969517;526542;442975
01.09.17;WA33;Etherische Öle, Riech-, Schönheitsmittel;804279;634597;169682
01.09.17;WA34;Seifen, Waschmittel usw.;657275;368028;289247
01.09.17;WA35;Eiweissstoffe, Klebstoffe, Enzyme;299199;178886;120313
01.09.17;WA36;Sprengstoffe, pyrotechnische Artikel usw.;24428;29867;-5439
01.09.17;WA37;Photochemische Erzeugnisse;94223;73106;21117
01.09.17;WA38;Verschiedene Erzeugnisse der Chemischen Industrie;1713572;1009629;703943
01.09.17;WA39;Kunststoffe und Waren daraus;5140454;3337396;1803058
01.09.17;WA40;Kautschuk und Waren daraus;1280733;1231439;49294
01.09.17;WA41;Häute, Felle, Leder;86457;57174;29283
01.09.17;WA42;Lederwaren, Sattlerwaren;189819;326000;-136181
01.09.17;WA43;Pelzfelle, künstliches Pelzwerk;12272;11558;714
01.09.17;WA44;Holz, Holzwaren, Holzkohle;681755;650490;31265
01.09.17;WA45;Kork, Korkwaren;2220;8428;-6208
01.09.17;WA46;Flechtwaren, Korbmacherwaren;3923;8333;-4410
01.09.17;WA47;Halbstoffe aus Holz usw., Papierabfall;100073;330183;-230110
01.09.17;WA48;Papier, Pappe und Waren daraus;1610232;1059842;550390
01.09.17;WA49;Bücher, Zeitungen, Bilddrucke usw.;363864;212693;151171
01.09.17;WA50;Seide;3780;4135;-355
01.09.17;WA51;Wolle, feine und grobe Tierhaare;43373;52489;-9116
01.09.17;WA52;Baumwolle;71519;71797;-278
01.09.17;WA53;Andere pflanzliche Spinnstoffe, Papiergarn;2677;5097;-2420
01.09.17;WA54;Synthetisches oder künstliches Filament;165752;129407;36345
01.09.17;WA55;Synthetische oder künstliche Spinnfaser;148869;113597;35272
01.09.17;WA56;Watte, Filz, Vliesstoff usw., Tauwerk;212414;117041;95373
01.09.17;WA57;Teppiche, Fussbodenbelag aus Spinnstoff;51066;90289;-39223
01.09.17;WA58;Spezialgewebe, Spitzen, Tapisserien;43452;20694;22758
01.09.17;WA59;Getränkte, bestrichene usw. Gewebe;206878;95886;110992
01.09.17;WA60;Gewirke und Gestricke;64505;33467;31038
01.09.17;WA61;Bekleidung usw. aus Gewirken, Gestricken;847247;1550447;-703200
01.09.17;WA62;Andere Bekleidung, Bekleidungszubehör;930115;1528475;-598360
01.09.17;WA63;Andere Konfektion, Spinnstoffwaren usw.;212518;330410;-117892
01.09.17;WA64;Schuhe, Gamaschen, ähnliche Waren;643152;965136;-321984
01.09.17;WA65;Kopfbedeckungen und Teile davon;44686;61452;-16766
01.09.17;WA66;Schirme, Gehstöcke usw., Peitschen;8813;12197;-3384
01.09.17;WA67;Zugerichtete Federn, Daunen, künstliche Blumen;13662;17282;-3620
01.09.17;WA68;Waren aus Steinen, Gips, Zement usw.;398703;271634;127069
01.09.17;WA69;Keramische Waren;268851;244545;24306
01.09.17;WA70;Glas und Glaswaren;549546;451946;97600
01.09.17;WA71;Perlen, Edelsteine, Edelmetalle;927127;1320262;-393135
01.09.17;WA72;Eisen und Stahl;1980130;2130261;-150131
01.09.17;WA73;Waren aus Eisen oder Stahl;2335493;1703381;632112
01.09.17;WA74;Kupfer und Waren daraus;946163;786896;159267
01.09.17;WA75;Nickel und Waren daraus;95892;109767;-13875
01.09.17;WA76;Aluminium und Waren daraus;1242335;1353283;-110948
01.09.17;WA78;Blei und Waren daraus;36685;38996;-2311
01.09.17;WA79;Zink und Waren daraus;78956;143272;-64316
01.09.17;WA80;Zinn und Waren daraus;9418;40792;-31374
01.09.17;WA81;Andere unedle Metalle, Cermets usw.;120423;162600;-42177
01.09.17;WA82;Werkzeuge, Schneidwaren, Essbestecke;691967;417712;274255
01.09.17;WA83;Verschiedene Waren aus unedlen Metallen;637419;420454;216965
01.09.17;WA84;Maschinen, Apparate, mechanische Geräte;19002234;11180502;7821732
01.09.17;WA85;Elektrotechnische Erzeugnisse;11581558;11000498;581060
01.09.17;WA86;Schienenfahrzeuge;339601;242538;97063
01.09.17;WA87;Kraftfahrzeuge, Landfahrzeuge;19968063;9125132;10842931
01.09.17;WA88;Luftfahrzeuge, Raumfahrzeuge;2859117;933777;1925340
01.09.17;WA89;Wasserfahrzeuge;1564405;147894;1416511
01.09.17;WA90;Optische, photografische usw. Erzeugnisse;5608844;3005983;2602861
01.09.17;WA91;Uhrmacherwaren;158952;166622;-7670
01.09.17;WA92;Musikinstrumente;61314;51412;9902
01.09.17;WA93;Waffen und Munition;41682;20509;21173
01.09.17;WA94;Möbel, Beleuchtungskörper usw.;1345047;1576861;-231814
01.09.17;WA95;Spielzeug, Spiele usw., Sportgeräte;487485;724056;-236571
01.09.17;WA96;Verschiedene Waren;323607;227794;95813
01.09.17;WA97;Kunstgegenstände, Sammlungsstücke;76019;35969;40050
01.09.17;WA98;Vollständige Fabrikationsanlagen;123323;9576;113747
01.09.17;WA99;Zusammenstellungen verschiedener Waren;1357115;888795;468320
01.09.18;WA01;Lebende Tiere;118059;118032;27
01.09.18;WA02;Fleisch;622297;553550;68747
01.09.18;WA03;Fische, Krebs- und Weichtiere;117721;324411;-206690
01.09.18;WA04;Milch, Milcherzeugnisse, Eier, Honig;718021;665946;52075
01.09.18;WA05;Andere Waren tierischen Ursprungs;82012;76546;5466
01.09.18;WA06;Pflanzen, Waren des Blumenhandels;78281;201626;-123345
01.09.18;WA07;Gemüse, Pflanzen für Ernährung;93466;416584;-323118
01.09.18;WA08;Geniessbare Früchte und Nüsse;142836;746869;-604033
01.09.18;WA09;Kaffee, Tee, Mate, Gewürze;213652;273635;-59983
01.09.18;WA10;Getreide;81936;224100;-142164
01.09.18;WA11;Müllereierzeugnisse, Malz usw.;117275;51412;65863
01.09.18;WA12;Ölsamen usw., Heilpflanzen usw.;83247;455929;-372682
01.09.18;WA13;Schellack, Gummen, Harz, Pflanzensaft;48712;43914;4798
01.09.18;WA14;Flechtstoffe usw. pflanzlichen Ursprungs;908;3246;-2338
01.09.18;WA15;Tierische und pflanzliche Fette, Öle, Wachs;199749;279878;-80129
01.09.18;WA16;Zubereitungen von Fleisch, Fisch usw.;251285;256771;-5486
01.09.18;WA17;Zucker und Zuckerwaren;181483;127444;54039
01.09.18;WA18;Kakao und Zubereitungen aus Kakao;541055;406461;134594
01.09.18;WA19;Zubereitungen aus Getreide usw., Backwaren;554620;355321;199299
01.09.18;WA20;Zubereitungen von Gemüse, Früchten usw.;231059;409355;-178296
01.09.18;WA21;Verschiedene Lebensmittelzubereitungen;452373;264671;187702
01.09.18;WA22;Getränke, alkoholhaltige Flüssigkeiten, Essig;499154;607277;-108123
01.09.18;WA23;Rückstände der Lebensmittelindustrie, Futter;313547;331506;-17959
01.09.18;WA24;Tabak;288281;197979;90302
01.09.18;WA25;Salz, Schwefel, Steine, Erden usw.;170219;161907;8312
01.09.18;WA26;Erze, Schlacken, Aschen;39628;657166;-617538
01.09.18;WA27;Mineralische Brennstoffe usw.;2312098;8368319;-6056221
01.09.18;WA28;Anorganische chemische Erzeugnisse;769273;590433;178840
01.09.18;WA29;Organische chemische Erzeugnisse;1914118;3912711;-1998593
01.09.18;WA30;Pharmazeutische Erzeugnisse;6981079;3819365;3161714
01.09.18;WA31;Düngemittel;138192;50424;87768
01.09.18;WA32;Gerb- und Farbstoffe, Farben, Lacke usw.;936421;476914;459507
01.09.18;WA33;Etherische Öle, Riech-, Schönheitsmittel;778746;614219;164527
01.09.18;WA34;Seifen, Waschmittel usw.;622879;350216;272663
01.09.18;WA35;Eiweissstoffe, Klebstoffe, Enzyme;301318;173675;127643
01.09.18;WA36;Sprengstoffe, pyrotechnische Artikel usw.;26541;22462;4079
01.09.18;WA37;Photochemische Erzeugnisse;101514;74266;27248
01.09.18;WA38;Verschiedene Erzeugnisse der Chemischen Industrie;1762043;1125564;636479
01.09.18;WA39;Kunststoffe und Waren daraus;5076221;3381691;1694530
01.09.18;WA40;Kautschuk und Waren daraus;1265811;1194889;70922
01.09.18;WA41;Häute, Felle, Leder;73472;57662;15810
01.09.18;WA42;Lederwaren, Sattlerwaren;193846;307247;-113401
01.09.18;WA43;Pelzfelle, künstliches Pelzwerk;10639;11860;-1221
01.09.18;WA44;Holz, Holzwaren, Holzkohle;705319;687757;17562
01.09.18;WA45;Kork, Korkwaren;2082;6782;-4700
01.09.18;WA46;Flechtwaren, Korbmacherwaren;3204;7547;-4343
01.09.18;WA47;Halbstoffe aus Holz usw., Papierabfall;96718;335642;-238924
01.09.18;WA48;Papier, Pappe und Waren daraus;1571922;1061746;510176
01.09.18;WA49;Bücher, Zeitungen, Bilddrucke usw.;387206;225625;161581
01.09.18;WA50;Seide;4509;3467;1042
01.09.18;WA51;Wolle, feine und grobe Tierhaare;41239;44049;-2810
01.09.18;WA52;Baumwolle;64183;61965;2218
01.09.18;WA53;Andere pflanzliche Spinnstoffe, Papiergarn;3132;5563;-2431
01.09.18;WA54;Synthetisches oder künstliches Filament;152880;115755;37125
01.09.18;WA55;Synthetische oder künstliche Spinnfaser;146242;112860;33382
01.09.18;WA56;Watte, Filz, Vliesstoff usw., Tauwerk;198397;114988;83409
01.09.18;WA57;Teppiche, Fussbodenbelag aus Spinnstoff;43125;83303;-40178
01.09.18;WA58;Spezialgewebe, Spitzen, Tapisserien;42994;20970;22024
01.09.18;WA59;Getränkte, bestrichene usw. Gewebe;197421;88193;109228
01.09.18;WA60;Gewirke und Gestricke;57713;32626;25087
01.09.18;WA61;Bekleidung usw. aus Gewirken, Gestricken;868307;1514416;-646109
01.09.18;WA62;Andere Bekleidung, Bekleidungszubehör;960814;1503703;-542889
01.09.18;WA63;Andere Konfektion, Spinnstoffwaren usw.;218832;312740;-93908
01.09.18;WA64;Schuhe, Gamaschen, ähnliche Waren;656983;920805;-263822
01.09.18;WA65;Kopfbedeckungen und Teile davon;42646;59253;-16607
01.09.18;WA66;Schirme, Gehstöcke usw., Peitschen;7298;9694;-2396
01.09.18;WA67;Zugerichtete Federn, Daunen, künstliche Blumen;12631;19019;-6388
01.09.18;WA68;Waren aus Steinen, Gips, Zement usw.;401437;287361;114076
01.09.18;WA69;Keramische Waren;281894;234423;47471
01.09.18;WA70;Glas und Glaswaren;561544;441898;119646
01.09.18;WA71;Perlen, Edelsteine, Edelmetalle;1035013;1434020;-399007
01.09.18;WA72;Eisen und Stahl;2049416;2232053;-182637
01.09.18;WA73;Waren aus Eisen oder Stahl;2364854;1882574;482280
01.09.18;WA74;Kupfer und Waren daraus;914884;824368;90516
01.09.18;WA75;Nickel und Waren daraus;108536;135101;-26565
01.09.18;WA76;Aluminium und Waren daraus;1234761;1394096;-159335
01.09.18;WA78;Blei und Waren daraus;37138;38627;-1489
01.09.18;WA79;Zink und Waren daraus;63521;120024;-56503
01.09.18;WA80;Zinn und Waren daraus;8182;34581;-26399
01.09.18;WA81;Andere unedle Metalle, Cermets usw.;125150;158166;-33016
01.09.18;WA82;Werkzeuge, Schneidwaren, Essbestecke;647154;415854;231300
01.09.18;WA83;Verschiedene Waren aus unedlen Metallen;606560;394531;212029
01.09.18;WA84;Maschinen, Apparate, mechanische Geräte;19270027;11860020;7410007
01.09.18;WA85;Elektrotechnische Erzeugnisse;12006468;11933409;73059
01.09.18;WA86;Schienenfahrzeuge;244950;243009;1941
01.09.18;WA87;Kraftfahrzeuge, Landfahrzeuge;18100272;9127972;8972300
01.09.18;WA88;Luftfahrzeuge, Raumfahrzeuge;3135509;806881;2328628
01.09.18;WA89;Wasserfahrzeuge;204052;41413;162639
01.09.18;WA90;Optische, photografische usw. Erzeugnisse;5754180;3129602;2624578
01.09.18;WA91;Uhrmacherwaren;146557;166240;-19683
01.09.18;WA92;Musikinstrumente;62321;53327;8994
01.09.18;WA93;Waffen und Munition;34184;15430;18754
01.09.18;WA94;Möbel, Beleuchtungskörper usw.;1327888;1471642;-143754
01.09.18;WA95;Spielzeug, Spiele usw., Sportgeräte;554429;773196;-218767
01.09.18;WA96;Verschiedene Waren;314755;225799;88956
01.09.18;WA97;Kunstgegenstände, Sammlungsstücke;67950;24351;43599
01.09.18;WA98;Vollständige Fabrikationsanlagen;90238;439;89799
01.09.18;WA99;Zusammenstellungen verschiedener Waren;1398241;978471;419770
01.09.19;WA01;Lebende Tiere;117525;150688;-33163
01.09.19;WA02;Fleisch;717487;595993;121494
01.09.19;WA03;Fische, Krebs- und Weichtiere;119479;337992;-218513
01.09.19;WA04;Milch, Milcherzeugnisse, Eier, Honig;803225;695259;107966
01.09.19;WA05;Andere Waren tierischen Ursprungs;76362;84950;-8588
01.09.19;WA06;Pflanzen, Waren des Blumenhandels;87758;194015;-106257
01.09.19;WA07;Gemüse, Pflanzen für Ernährung;101016;398841;-297825
01.09.19;WA08;Geniessbare Früchte und Nüsse;145017;799856;-654839
01.09.19;WA09;Kaffee, Tee, Mate, Gewürze;232038;292244;-60206
01.09.19;WA10;Getreide;119936;198120;-78184
01.09.19;WA11;Müllereierzeugnisse, Malz usw.;141120;61967;79153
01.09.19;WA12;Ölsamen usw., Heilpflanzen usw.;84333;469710;-385377
01.09.19;WA13;Schellack, Gummen, Harz, Pflanzensaft;48661;38861;9800
01.09.19;WA14;Flechtstoffe usw. pflanzlichen Ursprungs;701;3632;-2931
01.09.19;WA15;Tierische und pflanzliche Fette, Öle, Wachs;216593;302130;-85537
01.09.19;WA16;Zubereitungen von Fleisch, Fisch usw.;273460;252453;21007
01.09.19;WA17;Zucker und Zuckerwaren;189370;142115;47255
01.09.19;WA18;Kakao und Zubereitungen aus Kakao;550190;421951;128239
01.09.19;WA19;Zubereitungen aus Getreide usw., Backwaren;593449;375012;218437
01.09.19;WA20;Zubereitungen von Gemüse, Früchten usw.;241254;438814;-197560
01.09.19;WA21;Verschiedene Lebensmittelzubereitungen;479253;299759;179494
01.09.19;WA22;Getränke, alkoholhaltige Flüssigkeiten, Essig;492545;680483;-187938
01.09.19;WA23;Rückstände der Lebensmittelindustrie, Futter;362983;349989;12994
01.09.19;WA24;Tabak;284869;242775;42094
01.09.19;WA25;Salz, Schwefel, Steine, Erden usw.;170831;166968;3863
01.09.19;WA26;Erze, Schlacken, Aschen;47226;636415;-589189
01.09.19;WA27;Mineralische Brennstoffe usw.;2725459;7416256;-4690797
01.09.19;WA28;Anorganische chemische Erzeugnisse;943247;558801;384446
01.09.19;WA29;Organische chemische Erzeugnisse;2079625;2053989;25636
01.09.19;WA30;Pharmazeutische Erzeugnisse;7021622;4811201;2210421
01.09.19;WA31;Düngemittel;193506;68102;125404
01.09.19;WA32;Gerb- und Farbstoffe, Farben, Lacke usw.;989799;480436;509363
01.09.19;WA33;Etherische Öle, Riech-, Schönheitsmittel;929447;668395;261052
01.09.19;WA34;Seifen, Waschmittel usw.;678779;402228;276551
01.09.19;WA35;Eiweissstoffe, Klebstoffe, Enzyme;312572;177973;134599
01.09.19;WA36;Sprengstoffe, pyrotechnische Artikel usw.;24364;32946;-8582
01.09.19;WA37;Photochemische Erzeugnisse;103591;81254;22337
01.09.19;WA38;Verschiedene Erzeugnisse der Chemischen Industrie;1937625;1200784;736841
01.09.19;WA39;Kunststoffe und Waren daraus;5225680;3382424;1843256
01.09.19;WA40;Kautschuk und Waren daraus;1287645;1182524;105121
01.09.19;WA41;Häute, Felle, Leder;58303;49356;8947
01.09.19;WA42;Lederwaren, Sattlerwaren;209146;352716;-143570
01.09.19;WA43;Pelzfelle, künstliches Pelzwerk;10532;11404;-872
01.09.19;WA44;Holz, Holzwaren, Holzkohle;709471;656659;52812
01.09.19;WA45;Kork, Korkwaren;2371;9952;-7581
01.09.19;WA46;Flechtwaren, Korbmacherwaren;4201;8209;-4008
01.09.19;WA47;Halbstoffe aus Holz usw., Papierabfall;87156;288235;-201079
01.09.19;WA48;Papier, Pappe und Waren daraus;1598499;1051133;547366
01.09.19;WA49;Bücher, Zeitungen, Bilddrucke usw.;349069;242139;106930
01.09.19;WA50;Seide;1747;1895;-148
01.09.19;WA51;Wolle, feine und grobe Tierhaare;37353;42724;-5371
01.09.19;WA52;Baumwolle;62780;60275;2505
01.09.19;WA53;Andere pflanzliche Spinnstoffe, Papiergarn;2699;5128;-2429
01.09.19;WA54;Synthetisches oder künstliches Filament;143663;114977;28686
01.09.19;WA55;Synthetische oder künstliche Spinnfaser;138934;120169;18765
01.09.19;WA56;Watte, Filz, Vliesstoff usw., Tauwerk;215337;125628;89709
01.09.19;WA57;Teppiche, Fussbodenbelag aus Spinnstoff;48210;94875;-46665
01.09.19;WA58;Spezialgewebe, Spitzen, Tapisserien;43571;20131;23440
01.09.19;WA59;Getränkte, bestrichene usw. Gewebe;200805;96948;103857
01.09.19;WA60;Gewirke und Gestricke;59362;34615;24747
01.09.19;WA61;Bekleidung usw. aus Gewirken, Gestricken;983652;1637795;-654143
01.09.19;WA62;Andere Bekleidung, Bekleidungszubehör;1109033;1597607;-488574
01.09.19;WA63;Andere Konfektion, Spinnstoffwaren usw.;242482;340438;-97956
01.09.19;WA64;Schuhe, Gamaschen, ähnliche Waren;753782;1077276;-323494
01.09.19;WA65;Kopfbedeckungen und Teile davon;47966;65521;-17555
01.09.19;WA66;Schirme, Gehstöcke usw., Peitschen;7823;11386;-3563
01.09.19;WA67;Zugerichtete Federn, Daunen, künstliche Blumen;15134;21254;-6120
01.09.19;WA68;Waren aus Steinen, Gips, Zement usw.;421223;295686;125537
01.09.19;WA69;Keramische Waren;322674;236689;85985
01.09.19;WA70;Glas und Glaswaren;563441;459728;103713
01.09.19;WA71;Perlen, Edelsteine, Edelmetalle;1859880;1582490;277390
01.09.19;WA72;Eisen und Stahl;1857643;2046138;-188495
01.09.19;WA73;Waren aus Eisen oder Stahl;2399208;1805235;593973
01.09.19;WA74;Kupfer und Waren daraus;861610;722282;139328
01.09.19;WA75;Nickel und Waren daraus;122380;146202;-23822
01.09.19;WA76;Aluminium und Waren daraus;1252684;1293676;-40992
01.09.19;WA78;Blei und Waren daraus;38519;32410;6109
01.09.19;WA79;Zink und Waren daraus;62184;114406;-52222
01.09.19;WA80;Zinn und Waren daraus;8447;29794;-21347
01.09.19;WA81;Andere unedle Metalle, Cermets usw.;126349;152052;-25703
01.09.19;WA82;Werkzeuge, Schneidwaren, Essbestecke;667129;431710;235419
01.09.19;WA83;Verschiedene Waren aus unedlen Metallen;648840;423311;225529
01.09.19;WA84;Maschinen, Apparate, mechanische Geräte;19406211;12051690;7354521
01.09.19;WA85;Elektrotechnische Erzeugnisse;12287996;11828946;459050
01.09.19;WA86;Schienenfahrzeuge;261104;297443;-36339
01.09.19;WA87;Kraftfahrzeuge, Landfahrzeuge;19253243;10851284;8401959
01.09.19;WA88;Luftfahrzeuge, Raumfahrzeuge;3018864;1474146;1544718
01.09.19;WA89;Wasserfahrzeuge;124377;34851;89526
01.09.19;WA90;Optische, photografische usw. Erzeugnisse;6171679;3370839;2800840
01.09.19;WA91;Uhrmacherwaren;146485;193264;-46779
01.09.19;WA92;Musikinstrumente;61291;66051;-4760
01.09.19;WA93;Waffen und Munition;41702;23081;18621
01.09.19;WA94;Möbel, Beleuchtungskörper usw.;1452427;1622177;-169750
01.09.19;WA95;Spielzeug, Spiele usw., Sportgeräte;557532;817948;-260416
01.09.19;WA96;Verschiedene Waren;333865;241973;91892
01.09.19;WA97;Kunstgegenstände, Sammlungsstücke;50050;30993;19057
01.09.19;WA98;Vollständige Fabrikationsanlagen;57274;315;56959
01.09.19;WA99;Zusammenstellungen verschiedener Waren;1419194;1008643;410551
01.09.20;WA01;Lebende Tiere;98189;99153;-964
01.09.20;WA02;Fleisch;613707;530434;83273
01.09.20;WA03;Fische, Krebs- und Weichtiere;117713;329608;-211895
01.09.20;WA04;Milch, Milcherzeugnisse, Eier, Honig;749767;697192;52575
01.09.20;WA05;Andere Waren tierischen Ursprungs;70181;73697;-3516
01.09.20;WA06;Pflanzen, Waren des Blumenhandels;84464;202682;-118218
01.09.20;WA07;Gemüse, Pflanzen für Ernährung;93108;470566;-377458
01.09.20;WA08;Geniessbare Früchte und Nüsse;160560;929949;-769389
01.09.20;WA09;Kaffee, Tee, Mate, Gewürze;254802;305277;-50475
01.09.20;WA10;Getreide;125034;245610;-120576
01.09.20;WA11;Müllereierzeugnisse, Malz usw.;142595;56864;85731
01.09.20;WA12;Ölsamen usw., Heilpflanzen usw.;91514;511902;-420388
01.09.20;WA13;Schellack, Gummen, Harz, Pflanzensaft;53657;43489;10168
01.09.20;WA14;Flechtstoffe usw. pflanzlichen Ursprungs;733;2705;-1972
01.09.20;WA15;Tierische und pflanzliche Fette, Öle, Wachs;257342;301290;-43948
01.09.20;WA16;Zubereitungen von Fleisch, Fisch usw.;250321;247286;3035
01.09.20;WA17;Zucker und Zuckerwaren;203705;132250;71455
01.09.20;WA18;Kakao und Zubereitungen aus Kakao;568481;415195;153286
01.09.20;WA19;Zubereitungen aus Getreide usw., Backwaren;564727;414986;149741
01.09.20;WA20;Zubereitungen von Gemüse, Früchten usw.;250058;434665;-184607
01.09.20;WA21;Verschiedene Lebensmittelzubereitungen;509408;324274;185134
01.09.20;WA22;Getränke, alkoholhaltige Flüssigkeiten, Essig;463531;696712;-233181
01.09.20;WA23;Rückstände der Lebensmittelindustrie, Futter;398510;289275;109235
01.09.20;WA24;Tabak;205254;233961;-28707
01.09.20;WA25;Salz, Schwefel, Steine, Erden usw.;154794;130855;23939
01.09.20;WA26;Erze, Schlacken, Aschen;35876;703702;-667826
01.09.20;WA27;Mineralische Brennstoffe usw.;1876066;5463831;-3587765
01.09.20;WA28;Anorganische chemische Erzeugnisse;889996;431920;458076
01.09.20;WA29;Organische chemische Erzeugnisse;1968606;2886487;-917881
01.09.20;WA30;Pharmazeutische Erzeugnisse;7310284;4623246;2687038
01.09.20;WA31;Düngemittel;176840;62293;114547
01.09.20;WA32;Gerb- und Farbstoffe, Farben, Lacke usw.;968505;493240;475265
01.09.20;WA33;Etherische Öle, Riech-, Schönheitsmittel;813677;596396;217281
01.09.20;WA34;Seifen, Waschmittel usw.;650658;368372;282286
01.09.20;WA35;Eiweissstoffe, Klebstoffe, Enzyme;324247;178476;145771
01.09.20;WA36;Sprengstoffe, pyrotechnische Artikel usw.;25624;20759;4865
01.09.20;WA37;Photochemische Erzeugnisse;86489;61418;25071
01.09.20;WA38;Verschiedene Erzeugnisse der Chemischen Industrie;2020590;1268115;752475
01.09.20;WA39;Kunststoffe und Waren daraus;5011888;3053139;1958749
01.09.20;WA40;Kautschuk und Waren daraus;1266549;1170539;96010
01.09.20;WA41;Häute, Felle, Leder;53994;35050;18944
01.09.20;WA42;Lederwaren, Sattlerwaren;202362;308059;-105697
01.09.20;WA43;Pelzfelle, künstliches Pelzwerk;6852;9612;-2760
01.09.20;WA44;Holz, Holzwaren, Holzkohle;803618;648557;155061
01.09.20;WA45;Kork, Korkwaren;2890;7987;-5097
01.09.20;WA46;Flechtwaren, Korbmacherwaren;4838;10634;-5796
01.09.20;WA47;Halbstoffe aus Holz usw., Papierabfall;77560;228126;-150566
01.09.20;WA48;Papier, Pappe und Waren daraus;1451960;899873;552087
01.09.20;WA49;Bücher, Zeitungen, Bilddrucke usw.;350272;231244;119028
01.09.20;WA50;Seide;2339;1542;797
01.09.20;WA51;Wolle, feine und grobe Tierhaare;26702;27031;-329
01.09.20;WA52;Baumwolle;49304;50470;-1166
01.09.20;WA53;Andere pflanzliche Spinnstoffe, Papiergarn;2396;4627;-2231
01.09.20;WA54;Synthetisches oder künstliches Filament;125075;95247;29828
01.09.20;WA55;Synthetische oder künstliche Spinnfaser;124945;95558;29387
01.09.20;WA56;Watte, Filz, Vliesstoff usw., Tauwerk;210315;122405;87910
01.09.20;WA57;Teppiche, Fussbodenbelag aus Spinnstoff;46220;93602;-47382
01.09.20;WA58;Spezialgewebe, Spitzen, Tapisserien;41903;18213;23690
01.09.20;WA59;Getränkte, bestrichene usw. Gewebe;192771;85354;107417
01.09.20;WA60;Gewirke und Gestricke;54616;34692;19924
01.09.20;WA61;Bekleidung usw. aus Gewirken, Gestricken;1036551;1763570;-727019
01.09.20;WA62;Andere Bekleidung, Bekleidungszubehör;1060887;1663042;-602155
01.09.20;WA63;Andere Konfektion, Spinnstoffwaren usw.;325972;568929;-242957
01.09.20;WA64;Schuhe, Gamaschen, ähnliche Waren;734421;1011152;-276731
01.09.20;WA65;Kopfbedeckungen und Teile davon;47513;66407;-18894
01.09.20;WA66;Schirme, Gehstöcke usw., Peitschen;7038;12387;-5349
01.09.20;WA67;Zugerichtete Federn, Daunen, künstliche Blumen;16056;21928;-5872
01.09.20;WA68;Waren aus Steinen, Gips, Zement usw.;407386;273723;133663
01.09.20;WA69;Keramische Waren;294299;239986;54313
01.09.20;WA70;Glas und Glaswaren;577593;439022;138571
01.09.20;WA71;Perlen, Edelsteine, Edelmetalle;2044867;1974116;70751
01.09.20;WA72;Eisen und Stahl;1685576;1641634;43942
01.09.20;WA73;Waren aus Eisen oder Stahl;2163146;1661152;501994
01.09.20;WA74;Kupfer und Waren daraus;940170;749875;190295
01.09.20;WA75;Nickel und Waren daraus;104791;104476;315
01.09.20;WA76;Aluminium und Waren daraus;1164661;1065329;99332
01.09.20;WA78;Blei und Waren daraus;25236;22779;2457
01.09.20;WA79;Zink und Waren daraus;62317;104615;-42298
01.09.20;WA80;Zinn und Waren daraus;7111;22276;-15165
01.09.20;WA81;Andere unedle Metalle, Cermets usw.;80646;98136;-17490
01.09.20;WA82;Werkzeuge, Schneidwaren, Essbestecke;670747;412033;258714
01.09.20;WA83;Verschiedene Waren aus unedlen Metallen;633955;416055;217900
01.09.20;WA84;Maschinen, Apparate, mechanische Geräte;18450075;11070244;7379831
01.09.20;WA85;Elektrotechnische Erzeugnisse;12146935;11671731;475204
01.09.20;WA86;Schienenfahrzeuge;255898;228976;26922
01.09.20;WA87;Kraftfahrzeuge, Landfahrzeuge;18767597;11075844;7691753
01.09.20;WA88;Luftfahrzeuge, Raumfahrzeuge;2111047;1132564;978483
01.09.20;WA89;Wasserfahrzeuge;773617;230709;542908
01.09.20;WA90;Optische, photografische usw. Erzeugnisse;5948226;3179531;2768695
01.09.20;WA91;Uhrmacherwaren;135289;187724;-52435
01.09.20;WA92;Musikinstrumente;67151;65717;1434
01.09.20;WA93;Waffen und Munition;34018;19439;14579
01.09.20;WA94;Möbel, Beleuchtungskörper usw.;1341548;1707345;-365797
01.09.20;WA95;Spielzeug, Spiele usw., Sportgeräte;522184;710984;-188800
01.09.20;WA96;Verschiedene Waren;333321;242438;90883
01.09.20;WA97;Kunstgegenstände, Sammlungsstücke;36391;593038;-556647
01.09.20;WA98;Vollständige Fabrikationsanlagen;90713;NULL;#WERT!
01.09.20;WA99;Zusammenstellungen verschiedener Waren;1098327;976392;121935
01.09.21;WA01;Lebende Tiere;97702;92440;5262
01.09.21;WA02;Fleisch;534830;539254;-4424
01.09.21;WA03;Fische, Krebs- und Weichtiere;114010;307854;-193844
01.09.21;WA04;Milch, Milcherzeugnisse, Eier, Honig;827955;768275;59680
01.09.21;WA05;Andere Waren tierischen Ursprungs;85721;89340;-3619
01.09.21;WA06;Pflanzen, Waren des Blumenhandels;89988;218567;-128579
01.09.21;WA07;Gemüse, Pflanzen für Ernährung;104767;459767;-355000
01.09.21;WA08;Geniessbare Früchte und Nüsse;163776;883256;-719480
01.09.21;WA09;Kaffee, Tee, Mate, Gewürze;272892;390230;-117338
01.09.21;WA10;Getreide;257003;314440;-57437
01.09.21;WA11;Müllereierzeugnisse, Malz usw.;146510;69808;76702
01.09.21;WA12;Ölsamen usw., Heilpflanzen usw.;100289;529436;-429147
01.09.21;WA13;Schellack, Gummen, Harz, Pflanzensaft;54308;55016;-708
01.09.21;WA14;Flechtstoffe usw. pflanzlichen Ursprungs;758;3723;-2965
01.09.21;WA15;Tierische und pflanzliche Fette, Öle, Wachs;341150;397962;-56812
01.09.21;WA16;Zubereitungen von Fleisch, Fisch usw.;249024;248148;876
01.09.21;WA17;Zucker und Zuckerwaren;264023;146732;117291
01.09.21;WA18;Kakao und Zubereitungen aus Kakao;592702;418762;173940
01.09.21;WA19;Zubereitungen aus Getreide usw., Backwaren;626309;425287;201022
01.09.21;WA20;Zubereitungen von Gemüse, Früchten usw.;227143;442003;-214860
01.09.21;WA21;Verschiedene Lebensmittelzubereitungen;540464;336147;204317
01.09.21;WA22;Getränke, alkoholhaltige Flüssigkeiten, Essig;523395;750577;-227182
01.09.21;WA23;Rückstände der Lebensmittelindustrie, Futter;476587;362834;113753
01.09.21;WA24;Tabak;210628;249419;-38791
01.09.21;WA25;Salz, Schwefel, Steine, Erden usw.;186343;172741;13602
01.09.21;WA26;Erze, Schlacken, Aschen;71082;1185309;-1114227
01.09.21;WA27;Mineralische Brennstoffe usw.;2897195;8874280;-5977085
01.09.21;WA28;Anorganische chemische Erzeugnisse;1094522;579278;515244
01.09.21;WA29;Organische chemische Erzeugnisse;2547340;2994439;-447099
01.09.21;WA30;Pharmazeutische Erzeugnisse;9016736;4939968;4076768
01.09.21;WA31;Düngemittel;231576;89867;141709
01.09.21;WA32;Gerb- und Farbstoffe, Farben, Lacke usw.;1047005;536173;510832
01.09.21;WA33;Etherische Öle, Riech-, Schönheitsmittel;956841;726226;230615
01.09.21;WA34;Seifen, Waschmittel usw.;711130;408796;302334
01.09.21;WA35;Eiweissstoffe, Klebstoffe, Enzyme;389237;228008;161229
01.09.21;WA36;Sprengstoffe, pyrotechnische Artikel usw.;22364;11663;10701
01.09.21;WA37;Photochemische Erzeugnisse;87281;50780;36501
01.09.21;WA38;Verschiedene Erzeugnisse der Chemischen Industrie;2313705;1435226;878479
01.09.21;WA39;Kunststoffe und Waren daraus;6111530;4068281;2043249
01.09.21;WA40;Kautschuk und Waren daraus;1319335;1319581;-246
01.09.21;WA41;Häute, Felle, Leder;54425;41658;12767
01.09.21;WA42;Lederwaren, Sattlerwaren;215901;352841;-136940
01.09.21;WA43;Pelzfelle, künstliches Pelzwerk;7501;10787;-3286
01.09.21;WA44;Holz, Holzwaren, Holzkohle;1014769;898415;116354
01.09.21;WA45;Kork, Korkwaren;1854;5917;-4063
01.09.21;WA46;Flechtwaren, Korbmacherwaren;3920;14692;-10772
01.09.21;WA47;Halbstoffe aus Holz usw., Papierabfall;110339;375842;-265503
01.09.21;WA48;Papier, Pappe und Waren daraus;1754334;1072347;681987
01.09.21;WA49;Bücher, Zeitungen, Bilddrucke usw.;371194;253941;117253
01.09.21;WA50;Seide;1792;1947;-155
01.09.21;WA51;Wolle, feine und grobe Tierhaare;39008;39055;-47
01.09.21;WA52;Baumwolle;57216;58942;-1726
01.09.21;WA53;Andere pflanzliche Spinnstoffe, Papiergarn;3937;6586;-2649
01.09.21;WA54;Synthetisches oder künstliches Filament;131994;116307;15687
01.09.21;WA55;Synthetische oder künstliche Spinnfaser;125973;121467;4506
01.09.21;WA56;Watte, Filz, Vliesstoff usw., Tauwerk;227123;142975;84148
01.09.21;WA57;Teppiche, Fussbodenbelag aus Spinnstoff;46624;94986;-48362
01.09.21;WA58;Spezialgewebe, Spitzen, Tapisserien;40848;22053;18795
01.09.21;WA59;Getränkte, bestrichene usw. Gewebe;199512;95697;103815
01.09.21;WA60;Gewirke und Gestricke;53420;35838;17582
01.09.21;WA61;Bekleidung usw. aus Gewirken, Gestricken;1043944;1862168;-818224
01.09.21;WA62;Andere Bekleidung, Bekleidungszubehör;939267;1529480;-590213
01.09.21;WA63;Andere Konfektion, Spinnstoffwaren usw.;279529;475772;-196243
01.09.21;WA64;Schuhe, Gamaschen, ähnliche Waren;716714;979640;-262926
01.09.21;WA65;Kopfbedeckungen und Teile davon;52919;73830;-20911
01.09.21;WA66;Schirme, Gehstöcke usw., Peitschen;6019;16231;-10212
01.09.21;WA67;Zugerichtete Federn, Daunen, künstliche Blumen;16123;27287;-11164
01.09.21;WA68;Waren aus Steinen, Gips, Zement usw.;461807;319525;142282
01.09.21;WA69;Keramische Waren;330397;265341;65056
01.09.21;WA70;Glas und Glaswaren;599912;445246;154666
01.09.21;WA71;Perlen, Edelsteine, Edelmetalle;1660131;2094435;-434304
01.09.21;WA72;Eisen und Stahl;2532073;2847582;-315509
01.09.21;WA73;Waren aus Eisen oder Stahl;2526020;2132907;393113
01.09.21;WA74;Kupfer und Waren daraus;1286340;1004549;281791
01.09.21;WA75;Nickel und Waren daraus;120864;166585;-45721
01.09.21;WA76;Aluminium und Waren daraus;1424468;1592705;-168237
01.09.21;WA78;Blei und Waren daraus;38994;43023;-4029
01.09.21;WA79;Zink und Waren daraus;71139;136555;-65416
01.09.21;WA80;Zinn und Waren daraus;12707;56819;-44112
01.09.21;WA81;Andere unedle Metalle, Cermets usw.;125865;142742;-16877
01.09.21;WA82;Werkzeuge, Schneidwaren, Essbestecke;721500;505434;216066
01.09.21;WA83;Verschiedene Waren aus unedlen Metallen;666615;457759;208856
01.09.21;WA84;Maschinen, Apparate, mechanische Geräte;19693735;12649183;7044552
01.09.21;WA85;Elektrotechnische Erzeugnisse;13007326;13175525;-168199
01.09.21;WA86;Schienenfahrzeuge;241367;354645;-113278
01.09.21;WA87;Kraftfahrzeuge, Landfahrzeuge;16537386;9116596;7420790
01.09.21;WA88;Luftfahrzeuge, Raumfahrzeuge;1470708;1018818;451890
01.09.21;WA89;Wasserfahrzeuge;341543;296775;44768
01.09.21;WA90;Optische, photografische usw. Erzeugnisse;6255387;3460383;2795004
01.09.21;WA91;Uhrmacherwaren;156202;218900;-62698
01.09.21;WA92;Musikinstrumente;67668;64168;3500
01.09.21;WA93;Waffen und Munition;49868;21064;28804
01.09.21;WA94;Möbel, Beleuchtungskörper usw.;1446388;1876032;-429644
01.09.21;WA95;Spielzeug, Spiele usw., Sportgeräte;549487;840096;-290609
01.09.21;WA96;Verschiedene Waren;347982;286211;61771
01.09.21;WA97;Kunstgegenstände, Sammlungsstücke;121628;50606;71022
01.09.21;WA98;Vollständige Fabrikationsanlagen;44383;NULL;#WERT!
01.09.21;WA99;Zusammenstellungen verschiedener Waren;1345748;875908;469840
01.09.22;WA01;Lebende Tiere;134702;117588;17114
01.09.22;WA02;Fleisch;710738;698460;12278
01.09.22;WA03;Fische, Krebs- und Weichtiere;164445;427582;-263137
01.09.22;WA04;Milch, Milcherzeugnisse, Eier, Honig;1156534;986608;169926
01.09.22;WA05;Andere Waren tierischen Ursprungs;85088;109553;-24465
01.09.22;WA06;Pflanzen, Waren des Blumenhandels;92971;215319;-122348
01.09.22;WA07;Gemüse, Pflanzen für Ernährung;124003;490575;-366572
01.09.22;WA08;Geniessbare Früchte und Nüsse;164735;930426;-765691
01.09.22;WA09;Kaffee, Tee, Mate, Gewürze;343238;539580;-196342
01.09.22;WA10;Getreide;386998;370845;16153
01.09.22;WA11;Müllereierzeugnisse, Malz usw.;199642;84048;115594
01.09.22;WA12;Ölsamen usw., Heilpflanzen usw.;117846;626522;-508676
01.09.22;WA13;Schellack, Gummen, Harz, Pflanzensaft;64156;67156;-3000
01.09.22;WA14;Flechtstoffe usw. pflanzlichen Ursprungs;1064;4672;-3608
01.09.22;WA15;Tierische und pflanzliche Fette, Öle, Wachs;421324;572586;-151262
01.09.22;WA16;Zubereitungen von Fleisch, Fisch usw.;327107;327333;-226
01.09.22;WA17;Zucker und Zuckerwaren;316469;170819;145650
01.09.22;WA18;Kakao und Zubereitungen aus Kakao;693903;434127;259776
01.09.22;WA19;Zubereitungen aus Getreide usw., Backwaren;776573;506201;270372
01.09.22;WA20;Zubereitungen von Gemüse, Früchten usw.;277030;521002;-243972
01.09.22;WA21;Verschiedene Lebensmittelzubereitungen;673425;410923;262502
01.09.22;WA22;Getränke, alkoholhaltige Flüssigkeiten, Essig;637956;827726;-189770
01.09.22;WA23;Rückstände der Lebensmittelindustrie, Futter;582942;492896;90046
01.09.22;WA24;Tabak;254266;303666;-49400
01.09.22;WA25;Salz, Schwefel, Steine, Erden usw.;212130;192142;19988
01.09.22;WA26;Erze, Schlacken, Aschen;93181;1092273;-999092
01.09.22;WA27;Mineralische Brennstoffe usw.;5538672;19138572;-13599900
01.09.22;WA28;Anorganische chemische Erzeugnisse;1438996;961503;477493
01.09.22;WA29;Organische chemische Erzeugnisse;3924525;4786184;-861659
01.09.22;WA30;Pharmazeutische Erzeugnisse;10883008;8187673;2695335
01.09.22;WA31;Düngemittel;418406;281547;136859
01.09.22;WA32;Gerb- und Farbstoffe, Farben, Lacke usw.;1098629;558723;539906
01.09.22;WA33;Etherische Öle, Riech-, Schönheitsmittel;1104075;776215;327860
01.09.22;WA34;Seifen, Waschmittel usw.;847714;520563;327151
01.09.22;WA35;Eiweissstoffe, Klebstoffe, Enzyme;442570;277807;164763
01.09.22;WA36;Sprengstoffe, pyrotechnische Artikel usw.;35879;25845;10034
01.09.22;WA37;Photochemische Erzeugnisse;97010;57344;39666
01.09.22;WA38;Verschiedene Erzeugnisse der Chemischen Industrie;2964665;2009508;955157
01.09.22;WA39;Kunststoffe und Waren daraus;6710531;4614710;2095821
01.09.22;WA40;Kautschuk und Waren daraus;1547020;1620604;-73584
01.09.22;WA41;Häute, Felle, Leder;58979;45169;13810
01.09.22;WA42;Lederwaren, Sattlerwaren;281940;453490;-171550
01.09.22;WA43;Pelzfelle, künstliches Pelzwerk;5986;10869;-4883
01.09.22;WA44;Holz, Holzwaren, Holzkohle;1092868;938088;154780
01.09.22;WA45;Kork, Korkwaren;2242;8166;-5924
01.09.22;WA46;Flechtwaren, Korbmacherwaren;5730;18886;-13156
01.09.22;WA47;Halbstoffe aus Holz usw., Papierabfall;145989;408246;-262257
01.09.22;WA48;Papier, Pappe und Waren daraus;2231811;1389196;842615
01.09.22;WA49;Bücher, Zeitungen, Bilddrucke usw.;352881;286990;65891
01.09.22;WA50;Seide;2286;4672;-2386
01.09.22;WA51;Wolle, feine und grobe Tierhaare;47688;48579;-891
01.09.22;WA52;Baumwolle;67509;74229;-6720
01.09.22;WA53;Andere pflanzliche Spinnstoffe, Papiergarn;3781;7558;-3777
01.09.22;WA54;Synthetisches oder künstliches Filament;162944;144884;18060
01.09.22;WA55;Synthetische oder künstliche Spinnfaser;143242;144759;-1517
01.09.22;WA56;Watte, Filz, Vliesstoff usw., Tauwerk;245993;159713;86280
01.09.22;WA57;Teppiche, Fussbodenbelag aus Spinnstoff;53163;98720;-45557
01.09.22;WA58;Spezialgewebe, Spitzen, Tapisserien;51540;25107;26433
01.09.22;WA59;Getränkte, bestrichene usw. Gewebe;241471;119878;121593
01.09.22;WA60;Gewirke und Gestricke;67592;45100;22492
01.09.22;WA61;Bekleidung usw. aus Gewirken, Gestricken;1266622;2546244;-1279622
01.09.22;WA62;Andere Bekleidung, Bekleidungszubehör;1160023;2150721;-990698
01.09.22;WA63;Andere Konfektion, Spinnstoffwaren usw.;300244;514174;-213930
01.09.22;WA64;Schuhe, Gamaschen, ähnliche Waren;942067;1431532;-489465
01.09.22;WA65;Kopfbedeckungen und Teile davon;69646;109503;-39857
01.09.22;WA66;Schirme, Gehstöcke usw., Peitschen;9203;16169;-6966
01.09.22;WA67;Zugerichtete Federn, Daunen, künstliche Blumen;19598;34860;-15262
01.09.22;WA68;Waren aus Steinen, Gips, Zement usw.;495835;350114;145721
01.09.22;WA69;Keramische Waren;378865;321862;57003
01.09.22;WA70;Glas und Glaswaren;769532;540557;228975
01.09.22;WA71;Perlen, Edelsteine, Edelmetalle;2021684;2835082;-813398
01.09.22;WA72;Eisen und Stahl;2977004;2885479;91525
01.09.22;WA73;Waren aus Eisen oder Stahl;2973516;2717761;255755
01.09.22;WA74;Kupfer und Waren daraus;1285084;1146365;138719
01.09.22;WA75;Nickel und Waren daraus;185165;199200;-14035
01.09.22;WA76;Aluminium und Waren daraus;1761987;2255728;-493741
01.09.22;WA78;Blei und Waren daraus;30818;40932;-10114
01.09.22;WA79;Zink und Waren daraus;76171;160310;-84139
01.09.22;WA80;Zinn und Waren daraus;11726;55310;-43584
01.09.22;WA81;Andere unedle Metalle, Cermets usw.;156650;219356;-62706
01.09.22;WA82;Werkzeuge, Schneidwaren, Essbestecke;818514;567269;251245
01.09.22;WA83;Verschiedene Waren aus unedlen Metallen;736031;536342;199689
01.09.22;WA84;Maschinen, Apparate, mechanische Geräte;21959140;15289959;6669181
01.09.22;WA85;Elektrotechnische Erzeugnisse;15869187;18548982;-2679795
01.09.22;WA86;Schienenfahrzeuge;235803;281893;-46090
01.09.22;WA87;Kraftfahrzeuge, Landfahrzeuge;24521947;13130894;11391053
01.09.22;WA88;Luftfahrzeuge, Raumfahrzeuge;2718881;1129632;1589249
01.09.22;WA89;Wasserfahrzeuge;93953;125794;-31841
01.09.22;WA90;Optische, photografische usw. Erzeugnisse;6958341;4015813;2942528
01.09.22;WA91;Uhrmacherwaren;165278;248736;-83458
01.09.22;WA92;Musikinstrumente;92477;77502;14975
01.09.22;WA93;Waffen und Munition;63912;34618;29294
01.09.22;WA94;Möbel, Beleuchtungskörper usw.;1619046;2057570;-438524
01.09.22;WA95;Spielzeug, Spiele usw., Sportgeräte;684127;952711;-268584
01.09.22;WA96;Verschiedene Waren;378735;319072;59663
01.09.22;WA97;Kunstgegenstände, Sammlungsstücke;89783;46401;43382
01.09.22;WA98;Vollständige Fabrikationsanlagen;59377;NULL;#WERT!
01.09.22;WA99;Zusammenstellungen verschiedener Waren;1390704;930913;459791
01.09.23;WA01;Lebende Tiere;130331;146232;-15901
01.09.23;WA02;Fleisch;635584;632424;3160
01.09.23;WA03;Fische, Krebs- und Weichtiere;129693;362827;-233134
01.09.23;WA04;Milch, Milcherzeugnisse, Eier, Honig;952348;876830;75518
01.09.23;WA05;Andere Waren tierischen Ursprungs;68437;89132;-20695
01.09.23;WA06;Pflanzen, Waren des Blumenhandels;83886;190285;-106399
01.09.23;WA07;Gemüse, Pflanzen für Ernährung;151475;519120;-367645
01.09.23;WA08;Geniessbare Früchte und Nüsse;171351;914666;-743315
01.09.23;WA09;Kaffee, Tee, Mate, Gewürze;317084;415629;-98545
01.09.23;WA10;Getreide;245791;302314;-56523
01.09.23;WA11;Müllereierzeugnisse, Malz usw.;198447;84915;113532
01.09.23;WA12;Ölsamen usw., Heilpflanzen usw.;104887;541399;-436512
01.09.23;WA13;Schellack, Gummen, Harz, Pflanzensaft;53328;51768;1560
01.09.23;WA14;Flechtstoffe usw. pflanzlichen Ursprungs;1039;4267;-3228
01.09.23;WA15;Tierische und pflanzliche Fette, Öle, Wachs;309716;481120;-171404
01.09.23;WA16;Zubereitungen von Fleisch, Fisch usw.;306531;318432;-11901
01.09.23;WA17;Zucker und Zuckerwaren;304487;221940;82547
01.09.23;WA18;Kakao und Zubereitungen aus Kakao;749616;503310;246306
01.09.23;WA19;Zubereitungen aus Getreide usw., Backwaren;835606;548812;286794
01.09.23;WA20;Zubereitungen von Gemüse, Früchten usw.;283888;513281;-229393
01.09.23;WA21;Verschiedene Lebensmittelzubereitungen;681716;421615;260101
01.09.23;WA22;Getränke, alkoholhaltige Flüssigkeiten, Essig;614308;772089;-157781
01.09.23;WA23;Rückstände der Lebensmittelindustrie, Futter;553774;459421;94353
01.09.23;WA24;Tabak;261985;511281;-249296
01.09.23;WA25;Salz, Schwefel, Steine, Erden usw.;210650;161595;49055
01.09.23;WA26;Erze, Schlacken, Aschen;54617;659866;-605249
01.09.23;WA27;Mineralische Brennstoffe usw.;2862164;9453654;-6591490
01.09.23;WA28;Anorganische chemische Erzeugnisse;1000958;636249;364709
01.09.23;WA29;Organische chemische Erzeugnisse;2056418;3016579;-960161
01.09.23;WA30;Pharmazeutische Erzeugnisse;9033681;6007294;3026387
01.09.23;WA31;Düngemittel;266769;127344;139425
01.09.23;WA32;Gerb- und Farbstoffe, Farben, Lacke usw.;981557;469467;512090
01.09.23;WA33;Etherische Öle, Riech-, Schönheitsmittel;1076096;742993;333103
01.09.23;WA34;Seifen, Waschmittel usw.;733612;480207;253405
01.09.23;WA35;Eiweissstoffe, Klebstoffe, Enzyme;366072;223017;143055
01.09.23;WA36;Sprengstoffe, pyrotechnische Artikel usw.;37255;40581;-3326
01.09.23;WA37;Photochemische Erzeugnisse;80214;49163;31051
01.09.23;WA38;Verschiedene Erzeugnisse der Chemischen Industrie;2781457;1604593;1176864
01.09.23;WA39;Kunststoffe und Waren daraus;5581120;3655959;1925161
01.09.23;WA40;Kautschuk und Waren daraus;1429720;1383770;45950
01.09.23;WA41;Häute, Felle, Leder;50311;39526;10785
01.09.23;WA42;Lederwaren, Sattlerwaren;249628;373339;-123711
01.09.23;WA43;Pelzfelle, künstliches Pelzwerk;6483;7762;-1279
01.09.23;WA44;Holz, Holzwaren, Holzkohle;827434;664251;163183
01.09.23;WA45;Kork, Korkwaren;1671;6356;-4685
01.09.23;WA46;Flechtwaren, Korbmacherwaren;4752;9940;-5188
01.09.23;WA47;Halbstoffe aus Holz usw., Papierabfall;123087;284840;-161753
01.09.23;WA48;Papier, Pappe und Waren daraus;1657315;1082699;574616
01.09.23;WA49;Bücher, Zeitungen, Bilddrucke usw.;311747;239918;71829
01.09.23;WA50;Seide;1475;2559;-1084
01.09.23;WA51;Wolle, feine und grobe Tierhaare;36983;35145;1838
01.09.23;WA52;Baumwolle;56394;53013;3381
01.09.23;WA53;Andere pflanzliche Spinnstoffe, Papiergarn;3251;5883;-2632
01.09.23;WA54;Synthetisches oder künstliches Filament;133579;108165;25414
01.09.23;WA55;Synthetische oder künstliche Spinnfaser;123861;109497;14364
01.09.23;WA56;Watte, Filz, Vliesstoff usw., Tauwerk;217565;138143;79422
01.09.23;WA57;Teppiche, Fussbodenbelag aus Spinnstoff;48552;92989;-44437
01.09.23;WA58;Spezialgewebe, Spitzen, Tapisserien;47316;21431;25885
01.09.23;WA59;Getränkte, bestrichene usw. Gewebe;225443;105124;120319
01.09.23;WA60;Gewirke und Gestricke;56875;33373;23502
01.09.23;WA61;Bekleidung usw. aus Gewirken, Gestricken;1115121;1700204;-585083
01.09.23;WA62;Andere Bekleidung, Bekleidungszubehör;1056922;1489371;-432449
01.09.23;WA63;Andere Konfektion, Spinnstoffwaren usw.;254518;368284;-113766
01.09.23;WA64;Schuhe, Gamaschen, ähnliche Waren;869686;1022083;-152397
01.09.23;WA65;Kopfbedeckungen und Teile davon;68028;75455;-7427
01.09.23;WA66;Schirme, Gehstöcke usw., Peitschen;7924;13865;-5941
01.09.23;WA67;Zugerichtete Federn, Daunen, künstliche Blumen;14328;22939;-8611
01.09.23;WA68;Waren aus Steinen, Gips, Zement usw.;465499;309861;155638
01.09.23;WA69;Keramische Waren;324527;243062;81465
01.09.23;WA70;Glas und Glaswaren;635431;465424;170007
01.09.23;WA71;Perlen, Edelsteine, Edelmetalle;1552044;1593366;-41322
01.09.23;WA72;Eisen und Stahl;2483468;2282918;200550
01.09.23;WA73;Waren aus Eisen oder Stahl;2813504;2230985;582519
01.09.23;WA74;Kupfer und Waren daraus;1144370;866844;277526
01.09.23;WA75;Nickel und Waren daraus;185906;196568;-10662
01.09.23;WA76;Aluminium und Waren daraus;1443273;1651253;-207980
01.09.23;WA78;Blei und Waren daraus;37266;40267;-3001
01.09.23;WA79;Zink und Waren daraus;56140;128869;-72729
01.09.23;WA80;Zinn und Waren daraus;10893;39711;-28818
01.09.23;WA81;Andere unedle Metalle, Cermets usw.;135754;153392;-17638
01.09.23;WA82;Werkzeuge, Schneidwaren, Essbestecke;751002;473029;277973
01.09.23;WA83;Verschiedene Waren aus unedlen Metallen;674809;449206;225603
01.09.23;WA84;Maschinen, Apparate, mechanische Geräte;21553722;13764710;7789012
01.09.23;WA85;Elektrotechnische Erzeugnisse;14811037;17212687;-2401650
01.09.23;WA86;Schienenfahrzeuge;281530;292241;-10711
01.09.23;WA87;Kraftfahrzeuge, Landfahrzeuge;23191394;12416335;10775059
01.09.23;WA88;Luftfahrzeuge, Raumfahrzeuge;2406145;944614;1461531
01.09.23;WA89;Wasserfahrzeuge;106869;311908;-205039
01.09.23;WA90;Optische, photografische usw. Erzeugnisse;6662089;3852033;2810056
01.09.23;WA91;Uhrmacherwaren;151889;218991;-67102
01.09.23;WA92;Musikinstrumente;94817;68101;26716
01.09.23;WA93;Waffen und Munition;53167;28864;24303
01.09.23;WA94;Möbel, Beleuchtungskörper usw.;1475198;1767901;-292703
01.09.23;WA95;Spielzeug, Spiele usw., Sportgeräte;531446;817311;-285865
01.09.23;WA96;Verschiedene Waren;353051;289702;63349
01.09.23;WA97;Kunstgegenstände, Sammlungsstücke;123403;39956;83447
01.09.23;WA98;Vollständige Fabrikationsanlagen;68374;246;68128
01.09.23;WA99;Zusammenstellungen verschiedener Waren;1328963;941317;387646
01.09.24;WA01;Lebende Tiere;124782;141412;-16630
01.09.24;WA02;Fleisch;654170;663064;-8894
01.09.24;WA03;Fische, Krebs- und Weichtiere;119880;365743;-245863
01.09.24;WA04;Milch, Milcherzeugnisse, Eier, Honig;1047890;989274;58616
01.09.24;WA05;Andere Waren tierischen Ursprungs;72174;89827;-17653
01.09.24;WA06;Pflanzen, Waren des Blumenhandels;81903;192293;-110390
01.09.24;WA07;Gemüse, Pflanzen für Ernährung;154483;559712;-405229
01.09.24;WA08;Geniessbare Früchte und Nüsse;168215;1076241;-908026
01.09.24;WA09;Kaffee, Tee, Mate, Gewürze;347587;549232;-201645
01.09.24;WA10;Getreide;157874;312777;-154903
01.09.24;WA11;Müllereierzeugnisse, Malz usw.;183631;88345;95286
01.09.24;WA12;Ölsamen usw., Heilpflanzen usw.;113271;510514;-397243
01.09.24;WA13;Schellack, Gummen, Harz, Pflanzensaft;51860;60286;-8426
01.09.24;WA14;Flechtstoffe usw. pflanzlichen Ursprungs;1165;4260;-3095
01.09.24;WA15;Tierische und pflanzliche Fette, Öle, Wachs;288509;481232;-192723
01.09.24;WA16;Zubereitungen von Fleisch, Fisch usw.;302121;323341;-21220
01.09.24;WA17;Zucker und Zuckerwaren;327695;218090;109605
01.09.24;WA18;Kakao und Zubereitungen aus Kakao;1005013;894363;110650
01.09.24;WA19;Zubereitungen aus Getreide usw., Backwaren;876903;597284;279619
01.09.24;WA20;Zubereitungen von Gemüse, Früchten usw.;296075;606900;-310825
01.09.24;WA21;Verschiedene Lebensmittelzubereitungen;713522;469780;243742
01.09.24;WA22;Getränke, alkoholhaltige Flüssigkeiten, Essig;638835;750285;-111450
01.09.24;WA23;Rückstände der Lebensmittelindustrie, Futter;547275;454131;93144
01.09.24;WA24;Tabak;331195;510897;-179702
01.09.24;WA25;Salz, Schwefel, Steine, Erden usw.;213788;166864;46924
01.09.24;WA26;Erze, Schlacken, Aschen;60345;748783;-688438
01.09.24;WA27;Mineralische Brennstoffe usw.;2423703;8149911;-5726208
01.09.24;WA28;Anorganische chemische Erzeugnisse;968371;760891;207480
01.09.24;WA29;Organische chemische Erzeugnisse;2312763;3236870;-924107
01.09.24;WA30;Pharmazeutische Erzeugnisse;9195037;5984328;3210709
01.09.24;WA31;Düngemittel;236416;103247;133169
01.09.24;WA32;Gerb- und Farbstoffe, Farben, Lacke usw.;988528;497655;490873
01.09.24;WA33;Etherische Öle, Riech-, Schönheitsmittel;996344;757748;238596
01.09.24;WA34;Seifen, Waschmittel usw.;750635;492670;257965
01.09.24;WA35;Eiweissstoffe, Klebstoffe, Enzyme;381985;269482;112503
01.09.24;WA36;Sprengstoffe, pyrotechnische Artikel usw.;31530;55014;-23484
01.09.24;WA37;Photochemische Erzeugnisse;76019;56739;19280
01.09.24;WA38;Verschiedene Erzeugnisse der Chemischen Industrie;2601755;1624919;976836
01.09.24;WA39;Kunststoffe und Waren daraus;5576006;3961984;1614022
01.09.24;WA40;Kautschuk und Waren daraus;1370639;1454389;-83750
01.09.24;WA41;Häute, Felle, Leder;42509;35124;7385
01.09.24;WA42;Lederwaren, Sattlerwaren;253082;420118;-167036
01.09.24;WA43;Pelzfelle, künstliches Pelzwerk;7623;8760;-1137
01.09.24;WA44;Holz, Holzwaren, Holzkohle;774078;702874;71204
01.09.24;WA45;Kork, Korkwaren;1991;7155;-5164
01.09.24;WA46;Flechtwaren, Korbmacherwaren;4381;12204;-7823
01.09.24;WA47;Halbstoffe aus Holz usw., Papierabfall;118791;366100;-247309
01.09.24;WA48;Papier, Pappe und Waren daraus;1681004;1165686;515318
01.09.24;WA49;Bücher, Zeitungen, Bilddrucke usw.;301972;217539;84433
01.09.24;WA50;Seide;2158;5064;-2906
01.09.24;WA51;Wolle, feine und grobe Tierhaare;32326;32744;-418
01.09.24;WA52;Baumwolle;46197;47033;-836
01.09.24;WA53;Andere pflanzliche Spinnstoffe, Papiergarn;3537;6022;-2485
01.09.24;WA54;Synthetisches oder künstliches Filament;132244;112697;19547
01.09.24;WA55;Synthetische oder künstliche Spinnfaser;118681;116658;2023
01.09.24;WA56;Watte, Filz, Vliesstoff usw., Tauwerk;216144;147557;68587
01.09.24;WA57;Teppiche, Fussbodenbelag aus Spinnstoff;50516;91846;-41330
01.09.24;WA58;Spezialgewebe, Spitzen, Tapisserien;42143;20040;22103
01.09.24;WA59;Getränkte, bestrichene usw. Gewebe;221469;109950;111519
01.09.24;WA60;Gewirke und Gestricke;47516;31102;16414
01.09.24;WA61;Bekleidung usw. aus Gewirken, Gestricken;1178239;1975078;-796839
01.09.24;WA62;Andere Bekleidung, Bekleidungszubehör;1122773;1704565;-581792
01.09.24;WA63;Andere Konfektion, Spinnstoffwaren usw.;252328;409666;-157338
01.09.24;WA64;Schuhe, Gamaschen, ähnliche Waren;987723;1217864;-230141
01.09.24;WA65;Kopfbedeckungen und Teile davon;65145;97533;-32388
01.09.24;WA66;Schirme, Gehstöcke usw., Peitschen;8270;13828;-5558
01.09.24;WA67;Zugerichtete Federn, Daunen, künstliche Blumen;15824;28881;-13057
01.09.24;WA68;Waren aus Steinen, Gips, Zement usw.;458483;296779;161704
01.09.24;WA69;Keramische Waren;327794;256130;71664
01.09.24;WA70;Glas und Glaswaren;634607;497543;137064
01.09.24;WA71;Perlen, Edelsteine, Edelmetalle;1823454;1616792;206662
01.09.24;WA72;Eisen und Stahl;2325580;2304812;20768
01.09.24;WA73;Waren aus Eisen oder Stahl;2612352;2170522;441830
01.09.24;WA74;Kupfer und Waren daraus;1152132;1015122;137010
01.09.24;WA75;Nickel und Waren daraus;151763;191993;-40230
01.09.24;WA76;Aluminium und Waren daraus;1458597;1749527;-290930
01.09.24;WA78;Blei und Waren daraus;38794;47602;-8808
01.09.24;WA79;Zink und Waren daraus;76111;114362;-38251
01.09.24;WA80;Zinn und Waren daraus;11190;45163;-33973
01.09.24;WA81;Andere unedle Metalle, Cermets usw.;148500;182999;-34499
01.09.24;WA82;Werkzeuge, Schneidwaren, Essbestecke;743926;510129;233797
01.09.24;WA83;Verschiedene Waren aus unedlen Metallen;676431;493324;183107
01.09.24;WA84;Maschinen, Apparate, mechanische Geräte;21179686;13727704;7451982
01.09.24;WA85;Elektrotechnische Erzeugnisse;14056380;16778577;-2722197
01.09.24;WA86;Schienenfahrzeuge;360425;286119;74306
01.09.24;WA87;Kraftfahrzeuge, Landfahrzeuge;22680766;11182446;11498320
01.09.24;WA88;Luftfahrzeuge, Raumfahrzeuge;2648196;892066;1756130
01.09.24;WA89;Wasserfahrzeuge;1363862;791778;572084
01.09.24;WA90;Optische, photografische usw. Erzeugnisse;6648509;3959906;2688603
01.09.24;WA91;Uhrmacherwaren;164831;230601;-65770
01.09.24;WA92;Musikinstrumente;86878;72429;14449
01.09.24;WA93;Waffen und Munition;55381;31732;23649
01.09.24;WA94;Möbel, Beleuchtungskörper usw.;1436865;1880781;-443916
01.09.24;WA95;Spielzeug, Spiele usw., Sportgeräte;519438;814374;-294936
01.09.24;WA96;Verschiedene Waren;331387;304377;27010
01.09.24;WA97;Kunstgegenstände, Sammlungsstücke;123847;41972;81875
01.09.24;WA98;Vollständige Fabrikationsanlagen;80895;NULL;#WERT!
01.09.24;WA99;Zusammenstellungen verschiedener Waren;1607213;1063202;544011
01.09.25;WA01;Lebende Tiere;NULL;NULL;#WERT!
01.09.25;WA02;Fleisch;NULL;NULL;#WERT!
01.09.25;WA03;Fische, Krebs- und Weichtiere;NULL;NULL;#WERT!
01.09.25;WA04;Milch, Milcherzeugnisse, Eier, Honig;NULL;NULL;#WERT!
01.09.25;WA05;Andere Waren tierischen Ursprungs;NULL;NULL;#WERT!
01.09.25;WA06;Pflanzen, Waren des Blumenhandels;NULL;NULL;#WERT!
01.09.25;WA07;Gemüse, Pflanzen für Ernährung;NULL;NULL;#WERT!
01.09.25;WA08;Geniessbare Früchte und Nüsse;NULL;NULL;#WERT!
01.09.25;WA09;Kaffee, Tee, Mate, Gewürze;NULL;NULL;#WERT!
01.09.25;WA10;Getreide;NULL;NULL;#WERT!
01.09.25;WA11;Müllereierzeugnisse, Malz usw.;NULL;NULL;#WERT!
01.09.25;WA12;Ölsamen usw., Heilpflanzen usw.;NULL;NULL;#WERT!
01.09.25;WA13;Schellack, Gummen, Harz, Pflanzensaft;NULL;NULL;#WERT!
01.09.25;WA14;Flechtstoffe usw. pflanzlichen Ursprungs;NULL;NULL;#WERT!
01.09.25;WA15;Tierische und pflanzliche Fette, Öle, Wachs;NULL;NULL;#WERT!
01.09.25;WA16;Zubereitungen von Fleisch, Fisch usw.;NULL;NULL;#WERT!
01.09.25;WA17;Zucker und Zuckerwaren;NULL;NULL;#WERT!
01.09.25;WA18;Kakao und Zubereitungen aus Kakao;NULL;NULL;#WERT!
01.09.25;WA19;Zubereitungen aus Getreide usw., Backwaren;NULL;NULL;#WERT!
01.09.25;WA20;Zubereitungen von Gemüse, Früchten usw.;NULL;NULL;#WERT!
01.09.25;WA21;Verschiedene Lebensmittelzubereitungen;NULL;NULL;#WERT!
01.09.25;WA22;Getränke, alkoholhaltige Flüssigkeiten, Essig;NULL;NULL;#WERT!
01.09.25;WA23;Rückstände der Lebensmittelindustrie, Futter;NULL;NULL;#WERT!
01.09.25;WA24;Tabak;NULL;NULL;#WERT!
01.09.25;WA25;Salz, Schwefel, Steine, Erden usw.;NULL;NULL;#WERT!
01.09.25;WA26;Erze, Schlacken, Aschen;NULL;NULL;#WERT!
01.09.25;WA27;Mineralische Brennstoffe usw.;NULL;NULL;#WERT!
01.09.25;WA28;Anorganische chemische Erzeugnisse;NULL;NULL;#WERT!
01.09.25;WA29;Organische chemische Erzeugnisse;NULL;NULL;#WERT!
01.09.25;WA30;Pharmazeutische Erzeugnisse;NULL;NULL;#WERT!
01.09.25;WA31;Düngemittel;NULL;NULL;#WERT!
01.09.25;WA32;Gerb- und Farbstoffe, Farben, Lacke usw.;NULL;NULL;#WERT!
01.09.25;WA33;Etherische Öle, Riech-, Schönheitsmittel;NULL;NULL;#WERT!
01.09.25;WA34;Seifen, Waschmittel usw.;NULL;NULL;#WERT!
01.09.25;WA35;Eiweissstoffe, Klebstoffe, Enzyme;NULL;NULL;#WERT!
01.09.25;WA36;Sprengstoffe, pyrotechnische Artikel usw.;NULL;NULL;#WERT!
01.09.25;WA37;Photochemische Erzeugnisse;NULL;NULL;#WERT!
01.09.25;WA38;Verschiedene Erzeugnisse der Chemischen Industrie;NULL;NULL;#WERT!
01.09.25;WA39;Kunststoffe und Waren daraus;NULL;NULL;#WERT!
01.09.25;WA40;Kautschuk und Waren daraus;NULL;NULL;#WERT!
01.09.25;WA41;Häute, Felle, Leder;NULL;NULL;#WERT!
01.09.25;WA42;Lederwaren, Sattlerwaren;NULL;NULL;#WERT!
01.09.25;WA43;Pelzfelle, künstliches Pelzwerk;NULL;NULL;#WERT!
01.09.25;WA44;Holz, Holzwaren, Holzkohle;NULL;NULL;#WERT!
01.09.25;WA45;Kork, Korkwaren;NULL;NULL;#WERT!
01.09.25;WA46;Flechtwaren, Korbmacherwaren;NULL;NULL;#WERT!
01.09.25;WA47;Halbstoffe aus Holz usw., Papierabfall;NULL;NULL;#WERT!
01.09.25;WA48;Papier, Pappe und Waren daraus;NULL;NULL;#WERT!
01.09.25;WA49;Bücher, Zeitungen, Bilddrucke usw.;NULL;NULL;#WERT!
01.09.25;WA50;Seide;NULL;NULL;#WERT!
01.09.25;WA51;Wolle, feine und grobe Tierhaare;NULL;NULL;#WERT!
01.09.25;WA52;Baumwolle;NULL;NULL;#WERT!
01.09.25;WA53;Andere pflanzliche Spinnstoffe, Papiergarn;NULL;NULL;#WERT!
01.09.25;WA54;Synthetisches oder künstliches Filament;NULL;NULL;#WERT!
01.09.25;WA55;Synthetische oder künstliche Spinnfaser;NULL;NULL;#WERT!
01.09.25;WA56;Watte, Filz, Vliesstoff usw., Tauwerk;NULL;NULL;#WERT!
01.09.25;WA57;Teppiche, Fussbodenbelag aus Spinnstoff;NULL;NULL;#WERT!
01.09.25;WA58;Spezialgewebe, Spitzen, Tapisserien;NULL;NULL;#WERT!
01.09.25;WA59;Getränkte, bestrichene usw. Gewebe;NULL;NULL;#WERT!
01.09.25;WA60;Gewirke und Gestricke;NULL;NULL;#WERT!
01.09.25;WA61;Bekleidung usw. aus Gewirken, Gestricken;NULL;NULL;#WERT!
01.09.25;WA62;Andere Bekleidung, Bekleidungszubehör;NULL;NULL;#WERT!
01.09.25;WA63;Andere Konfektion, Spinnstoffwaren usw.;NULL;NULL;#WERT!
01.09.25;WA64;Schuhe, Gamaschen, ähnliche Waren;NULL;NULL;#WERT!
01.09.25;WA65;Kopfbedeckungen und Teile davon;NULL;NULL;#WERT!
01.09.25;WA66;Schirme, Gehstöcke usw., Peitschen;NULL;NULL;#WERT!
01.09.25;WA67;Zugerichtete Federn, Daunen, künstliche Blumen;NULL;NULL;#WERT!
01.09.25;WA68;Waren aus Steinen, Gips, Zement usw.;NULL;NULL;#WERT!
01.09.25;WA69;Keramische Waren;NULL;NULL;#WERT!
01.09.25;WA70;Glas und Glaswaren;NULL;NULL;#WERT!
01.09.25;WA71;Perlen, Edelsteine, Edelmetalle;NULL;NULL;#WERT!
01.09.25;WA72;Eisen und Stahl;NULL;NULL;#WERT!
01.09.25;WA73;Waren aus Eisen oder Stahl;NULL;NULL;#WERT!
01.09.25;WA74;Kupfer und Waren daraus;NULL;NULL;#WERT!
01.09.25;WA75;Nickel und Waren daraus;NULL;NULL;#WERT!
01.09.25;WA76;Aluminium und Waren daraus;NULL;NULL;#WERT!
01.09.25;WA78;Blei und Waren daraus;NULL;NULL;#WERT!
01.09.25;WA79;Zink und Waren daraus;NULL;NULL;#WERT!
01.09.25;WA80;Zinn und Waren daraus;NULL;NULL;#WERT!
01.09.25;WA81;Andere unedle Metalle, Cermets usw.;NULL;NULL;#WERT!
01.09.25;WA82;Werkzeuge, Schneidwaren, Essbestecke;NULL;NULL;#WERT!
01.09.25;WA83;Verschiedene Waren aus unedlen Metallen;NULL;NULL;#WERT!
01.09.25;WA84;Maschinen, Apparate, mechanische Geräte;NULL;NULL;#WERT!
01.09.25;WA85;Elektrotechnische Erzeugnisse;NULL;NULL;#WERT!
01.09.25;WA86;Schienenfahrzeuge;NULL;NULL;#WERT!
01.09.25;WA87;Kraftfahrzeuge, Landfahrzeuge;NULL;NULL;#WERT!
01.09.25;WA88;Luftfahrzeuge, Raumfahrzeuge;NULL;NULL;#WERT!
01.09.25;WA89;Wasserfahrzeuge;NULL;NULL;#WERT!
01.09.25;WA90;Optische, photografische usw. Erzeugnisse;NULL;NULL;#WERT!
01.09.25;WA91;Uhrmacherwaren;NULL;NULL;#WERT!
01.09.25;WA92;Musikinstrumente;NULL;NULL;#WERT!
01.09.25;WA93;Waffen und Munition;NULL;NULL;#WERT!
01.09.25;WA94;Möbel, Beleuchtungskörper usw.;NULL;NULL;#WERT!
01.09.25;WA95;Spielzeug, Spiele usw., Sportgeräte;NULL;NULL;#WERT!
01.09.25;WA96;Verschiedene Waren;NULL;NULL;#WERT!
01.09.25;WA97;Kunstgegenstände, Sammlungsstücke;NULL;NULL;#WERT!
01.09.25;WA98;Vollständige Fabrikationsanlagen;NULL;NULL;#WERT!
01.09.25;WA99;Zusammenstellungen verschiedener Waren;NULL;NULL;#WERT!
01.10.08;WA01;Lebende Tiere;78579;121165;-42586
01.10.08;WA02;Fleisch;615521;504144;111377
01.10.08;WA03;Fische, Krebs- und Weichtiere;85422;235809;-150387
01.10.08;WA04;Milch, Milcherzeugnisse, Eier, Honig;581394;462774;118620
01.10.08;WA05;Andere Waren tierischen Ursprungs;54509;55118;-609
01.10.08;WA06;Pflanzen, Waren des Blumenhandels;60099;181262;-121163
01.10.08;WA07;Gemüse, Pflanzen für Ernährung;80158;278205;-198047
01.10.08;WA08;Geniessbare Früchte und Nüsse;97001;513994;-416993
01.10.08;WA09;Kaffee, Tee, Mate, Gewürze;167949;261595;-93646
01.10.08;WA10;Getreide;345167;180311;164856
01.10.08;WA11;Müllereierzeugnisse, Malz usw.;93498;42566;50932
01.10.08;WA12;Ölsamen usw., Heilpflanzen usw.;78463;337992;-259529
01.10.08;WA13;Schellack, Gummen, Harz, Pflanzensaft;42132;26408;15724
01.10.08;WA14;Flechtstoffe usw. pflanzlichen Ursprungs;1096;2476;-1380
01.10.08;WA15;Tierische und pflanzliche Fette, Öle, Wachs;166390;304538;-138148
01.10.08;WA16;Zubereitungen von Fleisch, Fisch usw.;195512;198732;-3220
01.10.08;WA17;Zucker und Zuckerwaren;133688;136030;-2342
01.10.08;WA18;Kakao und Zubereitungen aus Kakao;335385;264243;71142
01.10.08;WA19;Zubereitungen aus Getreide usw., Backwaren;391949;197990;193959
01.10.08;WA20;Zubereitungen von Gemüse, Früchten usw.;174179;332458;-158279
01.10.08;WA21;Verschiedene Lebensmittelzubereitungen;319118;200330;118788
01.10.08;WA22;Getränke, alkoholhaltige Flüssigkeiten, Essig;371214;493230;-122016
01.10.08;WA23;Rückstände der Lebensmittelindustrie, Futter;276459;218470;57989
01.10.08;WA24;Tabak;276324;129274;147050
01.10.08;WA25;Salz, Schwefel, Steine, Erden usw.;225654;162347;63307
01.10.08;WA26;Erze, Schlacken, Aschen;23790;586098;-562308
01.10.08;WA27;Mineralische Brennstoffe usw.;2151133;10294082;-8142949
01.10.08;WA28;Anorganische chemische Erzeugnisse;718172;641877;76295
01.10.08;WA29;Organische chemische Erzeugnisse;1995812;1858312;137500
01.10.08;WA30;Pharmazeutische Erzeugnisse;3982547;2925774;1056773
01.10.08;WA31;Düngemittel;268290;159591;108699
01.10.08;WA32;Gerb- und Farbstoffe, Farben, Lacke usw.;727841;343752;384089
01.10.08;WA33;Etherische Öle, Riech-, Schönheitsmittel;611277;356638;254639
01.10.08;WA34;Seifen, Waschmittel usw.;453287;242191;211096
01.10.08;WA35;Eiweissstoffe, Klebstoffe, Enzyme;179743;136325;43418
01.10.08;WA36;Sprengstoffe, pyrotechnische Artikel usw.;19474;20698;-1224
01.10.08;WA37;Photochemische Erzeugnisse;108111;54800;53311
01.10.08;WA38;Verschiedene Erzeugnisse der Chemischen Industrie;1425191;777123;648068
01.10.08;WA39;Kunststoffe und Waren daraus;4051762;2402605;1649157
01.10.08;WA40;Kautschuk und Waren daraus;916189;916412;-223
01.10.08;WA41;Häute, Felle, Leder;94395;89401;4994
01.10.08;WA42;Lederwaren, Sattlerwaren;131248;212680;-81432
01.10.08;WA43;Pelzfelle, künstliches Pelzwerk;18869;13862;5007
01.10.08;WA44;Holz, Holzwaren, Holzkohle;671208;515830;155378
01.10.08;WA45;Kork, Korkwaren;3238;9394;-6156
01.10.08;WA46;Flechtwaren, Korbmacherwaren;4228;10629;-6401
01.10.08;WA47;Halbstoffe aus Holz usw., Papierabfall;95545;310118;-214573
01.10.08;WA48;Papier, Pappe und Waren daraus;1629673;1076924;552749
01.10.08;WA49;Bücher, Zeitungen, Bilddrucke usw.;489562;194735;294827
01.10.08;WA50;Seide;9635;8849;786
01.10.08;WA51;Wolle, feine und grobe Tierhaare;47570;63430;-15860
01.10.08;WA52;Baumwolle;98987;90986;8001
01.10.08;WA53;Andere pflanzliche Spinnstoffe, Papiergarn;6682;10320;-3638
01.10.08;WA54;Synthetisches oder künstliches Filament;198552;128642;69910
01.10.08;WA55;Synthetische oder künstliche Spinnfaser;157101;126104;30997
01.10.08;WA56;Watte, Filz, Vliesstoff usw., Tauwerk;167579;96714;70865
01.10.08;WA57;Teppiche, Fussbodenbelag aus Spinnstoff;51234;91682;-40448
01.10.08;WA58;Spezialgewebe, Spitzen, Tapisserien;47343;28158;19185
01.10.08;WA59;Getränkte, bestrichene usw. Gewebe;148408;106800;41608
01.10.08;WA60;Gewirke und Gestricke;68581;34847;33734
01.10.08;WA61;Bekleidung usw. aus Gewirken, Gestricken;512961;940327;-427366
01.10.08;WA62;Andere Bekleidung, Bekleidungszubehör;650840;937885;-287045
01.10.08;WA63;Andere Konfektion, Spinnstoffwaren usw.;149070;231747;-82677
01.10.08;WA64;Schuhe, Gamaschen, ähnliche Waren;212727;348335;-135608
01.10.08;WA65;Kopfbedeckungen und Teile davon;23714;29240;-5526
01.10.08;WA66;Schirme, Gehstöcke usw., Peitschen;9136;11717;-2581
01.10.08;WA67;Zugerichtete Federn, Daunen, künstliche Blumen;7433;12480;-5047
01.10.08;WA68;Waren aus Steinen, Gips, Zement usw.;311447;207171;104276
01.10.08;WA69;Keramische Waren;294643;198223;96420
01.10.08;WA70;Glas und Glaswaren;474115;337916;136199
01.10.08;WA71;Perlen, Edelsteine, Edelmetalle;605424;991988;-386564
01.10.08;WA72;Eisen und Stahl;2417415;2679640;-262225
01.10.08;WA73;Waren aus Eisen oder Stahl;2398586;1580372;818214
01.10.08;WA74;Kupfer und Waren daraus;749233;722330;26903
01.10.08;WA75;Nickel und Waren daraus;94593;142175;-47582
01.10.08;WA76;Aluminium und Waren daraus;1119821;1089399;30422
01.10.08;WA78;Blei und Waren daraus;42061;20600;21461
01.10.08;WA79;Zink und Waren daraus;43891;68476;-24585
01.10.08;WA80;Zinn und Waren daraus;9682;29786;-20104
01.10.08;WA81;Andere unedle Metalle, Cermets usw.;99106;133747;-34641
01.10.08;WA82;Werkzeuge, Schneidwaren, Essbestecke;570810;353119;217691
01.10.08;WA83;Verschiedene Waren aus unedlen Metallen;535899;325003;210896
01.10.08;WA84;Maschinen, Apparate, mechanische Geräte;16740846;9504850;7235996
01.10.08;WA85;Elektrotechnische Erzeugnisse;9039840;7986943;1052897
01.10.08;WA86;Schienenfahrzeuge;319553;132292;187261
01.10.08;WA87;Kraftfahrzeuge, Landfahrzeuge;14118086;5445067;8673019
01.10.08;WA88;Luftfahrzeuge, Raumfahrzeuge;2129551;1516403;613148
01.10.08;WA89;Wasserfahrzeuge;155776;94650;61126
01.10.08;WA90;Optische, photografische usw. Erzeugnisse;3443336;2013367;1429969
01.10.08;WA91;Uhrmacherwaren;88417;118081;-29664
01.10.08;WA92;Musikinstrumente;41612;33554;8058
01.10.08;WA93;Waffen und Munition;35446;14027;21419
01.10.08;WA94;Möbel, Beleuchtungskörper usw.;1164209;1067350;96859
01.10.08;WA95;Spielzeug, Spiele usw., Sportgeräte;932377;875081;57296
01.10.08;WA96;Verschiedene Waren;175142;113535;61607
01.10.08;WA97;Kunstgegenstände, Sammlungsstücke;53353;31104;22249
01.10.08;WA98;Vollständige Fabrikationsanlagen;525735;1350;524385
01.10.08;WA99;Zusammenstellungen verschiedener Waren;1387240;919266;467974
01.10.09;WA01;Lebende Tiere;86143;106409;-20266
01.10.09;WA02;Fleisch;522552;421047;101505
01.10.09;WA03;Fische, Krebs- und Weichtiere;93743;247981;-154238
01.10.09;WA04;Milch, Milcherzeugnisse, Eier, Honig;516020;437575;78445
01.10.09;WA05;Andere Waren tierischen Ursprungs;55532;57786;-2254
01.10.09;WA06;Pflanzen, Waren des Blumenhandels;57216;170638;-113422
01.10.09;WA07;Gemüse, Pflanzen für Ernährung;67467;245817;-178350
01.10.09;WA08;Geniessbare Früchte und Nüsse;97454;475522;-378068
01.10.09;WA09;Kaffee, Tee, Mate, Gewürze;142211;211484;-69273
01.10.09;WA10;Getreide;146523;112687;33836
01.10.09;WA11;Müllereierzeugnisse, Malz usw.;79981;36048;43933
01.10.09;WA12;Ölsamen usw., Heilpflanzen usw.;49234;226272;-177038
01.10.09;WA13;Schellack, Gummen, Harz, Pflanzensaft;33725;23581;10144
01.10.09;WA14;Flechtstoffe usw. pflanzlichen Ursprungs;752;1953;-1201
01.10.09;WA15;Tierische und pflanzliche Fette, Öle, Wachs;125692;224186;-98494
01.10.09;WA16;Zubereitungen von Fleisch, Fisch usw.;184872;180782;4090
01.10.09;WA17;Zucker und Zuckerwaren;134101;106408;27693
01.10.09;WA18;Kakao und Zubereitungen aus Kakao;308345;269634;38711
01.10.09;WA19;Zubereitungen aus Getreide usw., Backwaren;373536;207886;165650
01.10.09;WA20;Zubereitungen von Gemüse, Früchten usw.;170218;289476;-119258
01.10.09;WA21;Verschiedene Lebensmittelzubereitungen;283050;216630;66420
01.10.09;WA22;Getränke, alkoholhaltige Flüssigkeiten, Essig;331224;455124;-123900
01.10.09;WA23;Rückstände der Lebensmittelindustrie, Futter;216927;207415;9512
01.10.09;WA24;Tabak;274025;148266;125759
01.10.09;WA25;Salz, Schwefel, Steine, Erden usw.;160626;131370;29256
01.10.09;WA26;Erze, Schlacken, Aschen;25762;472594;-446832
01.10.09;WA27;Mineralische Brennstoffe usw.;1366040;6537758;-5171718
01.10.09;WA28;Anorganische chemische Erzeugnisse;597843;542417;55426
01.10.09;WA29;Organische chemische Erzeugnisse;1577418;1670317;-92899
01.10.09;WA30;Pharmazeutische Erzeugnisse;3931532;2907426;1024106
01.10.09;WA31;Düngemittel;136195;51862;84333
01.10.09;WA32;Gerb- und Farbstoffe, Farben, Lacke usw.;679886;320654;359232
01.10.09;WA33;Etherische Öle, Riech-, Schönheitsmittel;591828;348655;243173
01.10.09;WA34;Seifen, Waschmittel usw.;425481;227556;197925
01.10.09;WA35;Eiweissstoffe, Klebstoffe, Enzyme;173869;114722;59147
01.10.09;WA36;Sprengstoffe, pyrotechnische Artikel usw.;20892;24651;-3759
01.10.09;WA37;Photochemische Erzeugnisse;94764;64728;30036
01.10.09;WA38;Verschiedene Erzeugnisse der Chemischen Industrie;1128711;653438;475273
01.10.09;WA39;Kunststoffe und Waren daraus;3473401;2007539;1465862
01.10.09;WA40;Kautschuk und Waren daraus;891374;821111;70263
01.10.09;WA41;Häute, Felle, Leder;58232;62126;-3894
01.10.09;WA42;Lederwaren, Sattlerwaren;100859;169564;-68705
01.10.09;WA43;Pelzfelle, künstliches Pelzwerk;12626;12379;247
01.10.09;WA44;Holz, Holzwaren, Holzkohle;551742;442811;108931
01.10.09;WA45;Kork, Korkwaren;2974;8192;-5218
01.10.09;WA46;Flechtwaren, Korbmacherwaren;4924;9690;-4766
01.10.09;WA47;Halbstoffe aus Holz usw., Papierabfall;67436;238025;-170589
01.10.09;WA48;Papier, Pappe und Waren daraus;1450572;870271;580301
01.10.09;WA49;Bücher, Zeitungen, Bilddrucke usw.;394656;194570;200086
01.10.09;WA50;Seide;6352;5946;406
01.10.09;WA51;Wolle, feine und grobe Tierhaare;42881;47408;-4527
01.10.09;WA52;Baumwolle;86532;73991;12541
01.10.09;WA53;Andere pflanzliche Spinnstoffe, Papiergarn;4696;6687;-1991
01.10.09;WA54;Synthetisches oder künstliches Filament;166387;105501;60886
01.10.09;WA55;Synthetische oder künstliche Spinnfaser;139201;101971;37230
01.10.09;WA56;Watte, Filz, Vliesstoff usw., Tauwerk;161942;84144;77798
01.10.09;WA57;Teppiche, Fussbodenbelag aus Spinnstoff;41801;83668;-41867
01.10.09;WA58;Spezialgewebe, Spitzen, Tapisserien;40373;24215;16158
01.10.09;WA59;Getränkte, bestrichene usw. Gewebe;130401;90494;39907
01.10.09;WA60;Gewirke und Gestricke;61784;35585;26199
01.10.09;WA61;Bekleidung usw. aus Gewirken, Gestricken;452764;884878;-432114
01.10.09;WA62;Andere Bekleidung, Bekleidungszubehör;490048;813827;-323779
01.10.09;WA63;Andere Konfektion, Spinnstoffwaren usw.;141904;211980;-70076
01.10.09;WA64;Schuhe, Gamaschen, ähnliche Waren;175675;311335;-135660
01.10.09;WA65;Kopfbedeckungen und Teile davon;22081;31713;-9632
01.10.09;WA66;Schirme, Gehstöcke usw., Peitschen;16621;8135;8486
01.10.09;WA67;Zugerichtete Federn, Daunen, künstliche Blumen;6767;10661;-3894
01.10.09;WA68;Waren aus Steinen, Gips, Zement usw.;259415;162455;96960
01.10.09;WA69;Keramische Waren;221610;159346;62264
01.10.09;WA70;Glas und Glaswaren;406260;307692;98568
01.10.09;WA71;Perlen, Edelsteine, Edelmetalle;649435;622431;27004
01.10.09;WA72;Eisen und Stahl;1616845;1387191;229654
01.10.09;WA73;Waren aus Eisen oder Stahl;1740939;1063745;677194
01.10.09;WA74;Kupfer und Waren daraus;563771;667100;-103329
01.10.09;WA75;Nickel und Waren daraus;49739;75859;-26120
01.10.09;WA76;Aluminium und Waren daraus;862904;838488;24416
01.10.09;WA78;Blei und Waren daraus;49618;24257;25361
01.10.09;WA79;Zink und Waren daraus;49394;68174;-18780
01.10.09;WA80;Zinn und Waren daraus;6384;20655;-14271
01.10.09;WA81;Andere unedle Metalle, Cermets usw.;61678;69362;-7684
01.10.09;WA82;Werkzeuge, Schneidwaren, Essbestecke;430701;233498;197203
01.10.09;WA83;Verschiedene Waren aus unedlen Metallen;481698;272687;209011
01.10.09;WA84;Maschinen, Apparate, mechanische Geräte;12793495;7411301;5382194
01.10.09;WA85;Elektrotechnische Erzeugnisse;7820801;7786054;34747
01.10.09;WA86;Schienenfahrzeuge;167796;115961;51835
01.10.09;WA87;Kraftfahrzeuge, Landfahrzeuge;11171963;4944095;6227868
01.10.09;WA88;Luftfahrzeuge, Raumfahrzeuge;1812601;1849424;-36823
01.10.09;WA89;Wasserfahrzeuge;223863;299730;-75867
01.10.09;WA90;Optische, photografische usw. Erzeugnisse;3145707;1674642;1471065
01.10.09;WA91;Uhrmacherwaren;97752;113185;-15433
01.10.09;WA92;Musikinstrumente;41999;30162;11837
01.10.09;WA93;Waffen und Munition;32381;12350;20031
01.10.09;WA94;Möbel, Beleuchtungskörper usw.;995184;1007715;-12531
01.10.09;WA95;Spielzeug, Spiele usw., Sportgeräte;672889;730343;-57454
01.10.09;WA96;Verschiedene Waren;156590;90548;66042
01.10.09;WA97;Kunstgegenstände, Sammlungsstücke;38825;16926;21899
01.10.09;WA98;Vollständige Fabrikationsanlagen;256039;5020;251019
01.10.09;WA99;Zusammenstellungen verschiedener Waren;1123590;1016590;107000
01.10.10;WA01;Lebende Tiere;94752;132210;-37458
01.10.10;WA02;Fleisch;648170;446320;201850
01.10.10;WA03;Fische, Krebs- und Weichtiere;102887;276022;-173135
01.10.10;WA04;Milch, Milcherzeugnisse, Eier, Honig;615991;515002;100989
01.10.10;WA05;Andere Waren tierischen Ursprungs;54454;60534;-6080
01.10.10;WA06;Pflanzen, Waren des Blumenhandels;60531;194071;-133540
01.10.10;WA07;Gemüse, Pflanzen für Ernährung;77164;291167;-214003
01.10.10;WA08;Geniessbare Früchte und Nüsse;100703;509149;-408446
01.10.10;WA09;Kaffee, Tee, Mate, Gewürze;170994;304461;-133467
01.10.10;WA10;Getreide;238021;215885;22136
01.10.10;WA11;Müllereierzeugnisse, Malz usw.;82591;37523;45068
01.10.10;WA12;Ölsamen usw., Heilpflanzen usw.;50072;305846;-255774
01.10.10;WA13;Schellack, Gummen, Harz, Pflanzensaft;37256;30900;6356
01.10.10;WA14;Flechtstoffe usw. pflanzlichen Ursprungs;859;2655;-1796
01.10.10;WA15;Tierische und pflanzliche Fette, Öle, Wachs;183519;296434;-112915
01.10.10;WA16;Zubereitungen von Fleisch, Fisch usw.;198543;176984;21559
01.10.10;WA17;Zucker und Zuckerwaren;124817;109543;15274
01.10.10;WA18;Kakao und Zubereitungen aus Kakao;356359;301760;54599
01.10.10;WA19;Zubereitungen aus Getreide usw., Backwaren;393023;217941;175082
01.10.10;WA20;Zubereitungen von Gemüse, Früchten usw.;163633;330407;-166774
01.10.10;WA21;Verschiedene Lebensmittelzubereitungen;304716;166010;138706
01.10.10;WA22;Getränke, alkoholhaltige Flüssigkeiten, Essig;391956;502713;-110757
01.10.10;WA23;Rückstände der Lebensmittelindustrie, Futter;252688;253021;-333
01.10.10;WA24;Tabak;291051;127869;163182
01.10.10;WA25;Salz, Schwefel, Steine, Erden usw.;186681;159193;27488
01.10.10;WA26;Erze, Schlacken, Aschen;35482;664825;-629343
01.10.10;WA27;Mineralische Brennstoffe usw.;1809685;8272997;-6463312
01.10.10;WA28;Anorganische chemische Erzeugnisse;647628;721011;-73383
01.10.10;WA29;Organische chemische Erzeugnisse;1777403;1845526;-68123
01.10.10;WA30;Pharmazeutische Erzeugnisse;4047762;2856566;1191196
01.10.10;WA31;Düngemittel;172669;117395;55274
01.10.10;WA32;Gerb- und Farbstoffe, Farben, Lacke usw.;750974;416711;334263
01.10.10;WA33;Etherische Öle, Riech-, Schönheitsmittel;650792;379744;271048
01.10.10;WA34;Seifen, Waschmittel usw.;447263;245370;201893
01.10.10;WA35;Eiweissstoffe, Klebstoffe, Enzyme;197297;137451;59846
01.10.10;WA36;Sprengstoffe, pyrotechnische Artikel usw.;16429;25631;-9202
01.10.10;WA37;Photochemische Erzeugnisse;88318;62362;25956
01.10.10;WA38;Verschiedene Erzeugnisse der Chemischen Industrie;1308828;796925;511903
01.10.10;WA39;Kunststoffe und Waren daraus;4057118;2464794;1592324
01.10.10;WA40;Kautschuk und Waren daraus;1111280;1030974;80306
01.10.10;WA41;Häute, Felle, Leder;84229;79497;4732
01.10.10;WA42;Lederwaren, Sattlerwaren;123407;213523;-90116
01.10.10;WA43;Pelzfelle, künstliches Pelzwerk;13703;12899;804
01.10.10;WA44;Holz, Holzwaren, Holzkohle;601316;522474;78842
01.10.10;WA45;Kork, Korkwaren;2925;8895;-5970
01.10.10;WA46;Flechtwaren, Korbmacherwaren;3385;10259;-6874
01.10.10;WA47;Halbstoffe aus Holz usw., Papierabfall;98454;320650;-222196
01.10.10;WA48;Papier, Pappe und Waren daraus;1604458;1006919;597539
01.10.10;WA49;Bücher, Zeitungen, Bilddrucke usw.;398819;196137;202682
01.10.10;WA50;Seide;6310;6037;273
01.10.10;WA51;Wolle, feine und grobe Tierhaare;55109;66711;-11602
01.10.10;WA52;Baumwolle;98495;93131;5364
01.10.10;WA53;Andere pflanzliche Spinnstoffe, Papiergarn;4711;7963;-3252
01.10.10;WA54;Synthetisches oder künstliches Filament;172353;126495;45858
01.10.10;WA55;Synthetische oder künstliche Spinnfaser;164182;126253;37929
01.10.10;WA56;Watte, Filz, Vliesstoff usw., Tauwerk;167521;85997;81524
01.10.10;WA57;Teppiche, Fussbodenbelag aus Spinnstoff;43588;98651;-55063
01.10.10;WA58;Spezialgewebe, Spitzen, Tapisserien;46061;31597;14464
01.10.10;WA59;Getränkte, bestrichene usw. Gewebe;156380;89366;67014
01.10.10;WA60;Gewirke und Gestricke;72123;38345;33778
01.10.10;WA61;Bekleidung usw. aus Gewirken, Gestricken;553097;1137020;-583923
01.10.10;WA62;Andere Bekleidung, Bekleidungszubehör;589897;1043977;-454080
01.10.10;WA63;Andere Konfektion, Spinnstoffwaren usw.;160022;255868;-95846
01.10.10;WA64;Schuhe, Gamaschen, ähnliche Waren;251020;470712;-219692
01.10.10;WA65;Kopfbedeckungen und Teile davon;28653;43648;-14995
01.10.10;WA66;Schirme, Gehstöcke usw., Peitschen;6609;10526;-3917
01.10.10;WA67;Zugerichtete Federn, Daunen, künstliche Blumen;8303;13963;-5660
01.10.10;WA68;Waren aus Steinen, Gips, Zement usw.;302343;212651;89692
01.10.10;WA69;Keramische Waren;234796;191542;43254
01.10.10;WA70;Glas und Glaswaren;444016;352519;91497
01.10.10;WA71;Perlen, Edelsteine, Edelmetalle;1074525;934246;140279
01.10.10;WA72;Eisen und Stahl;1976186;2179618;-203432
01.10.10;WA73;Waren aus Eisen oder Stahl;1946056;1355366;590690
01.10.10;WA74;Kupfer und Waren daraus;930547;890938;39609
01.10.10;WA75;Nickel und Waren daraus;68689;225905;-157216
01.10.10;WA76;Aluminium und Waren daraus;945862;1097020;-151158
01.10.10;WA78;Blei und Waren daraus;48307;25740;22567
01.10.10;WA79;Zink und Waren daraus;52890;90270;-37380
01.10.10;WA80;Zinn und Waren daraus;10678;30461;-19783
01.10.10;WA81;Andere unedle Metalle, Cermets usw.;88560;118999;-30439
01.10.10;WA82;Werkzeuge, Schneidwaren, Essbestecke;539944;312051;227893
01.10.10;WA83;Verschiedene Waren aus unedlen Metallen;521093;303309;217784
01.10.10;WA84;Maschinen, Apparate, mechanische Geräte;15126048;9448583;5677465
01.10.10;WA85;Elektrotechnische Erzeugnisse;9633402;8898667;734735
01.10.10;WA86;Schienenfahrzeuge;354537;177891;176646
01.10.10;WA87;Kraftfahrzeuge, Landfahrzeuge;14353630;5778535;8575095
01.10.10;WA88;Luftfahrzeuge, Raumfahrzeuge;1635738;1215508;420230
01.10.10;WA89;Wasserfahrzeuge;579175;386647;192528
01.10.10;WA90;Optische, photografische usw. Erzeugnisse;3756416;2038917;1717499
01.10.10;WA91;Uhrmacherwaren;123901;140789;-16888
01.10.10;WA92;Musikinstrumente;44844;42096;2748
01.10.10;WA93;Waffen und Munition;38856;12677;26179
01.10.10;WA94;Möbel, Beleuchtungskörper usw.;1088622;1152169;-63547
01.10.10;WA95;Spielzeug, Spiele usw., Sportgeräte;666670;646564;20106
01.10.10;WA96;Verschiedene Waren;170800;114739;56061
01.10.10;WA97;Kunstgegenstände, Sammlungsstücke;49132;48327;805
01.10.10;WA98;Vollständige Fabrikationsanlagen;274920;2689;272231
01.10.10;WA99;Zusammenstellungen verschiedener Waren;1104776;938818;165958
01.10.11;WA01;Lebende Tiere;103649;120650;-17001
01.10.11;WA02;Fleisch;676181;548558;127623
01.10.11;WA03;Fische, Krebs- und Weichtiere;108070;261551;-153481
01.10.11;WA04;Milch, Milcherzeugnisse, Eier, Honig;636587;535119;101468
01.10.11;WA05;Andere Waren tierischen Ursprungs;60769;66231;-5462
01.10.11;WA06;Pflanzen, Waren des Blumenhandels;67694;181843;-114149
01.10.11;WA07;Gemüse, Pflanzen für Ernährung;55679;279763;-224084
01.10.11;WA08;Geniessbare Früchte und Nüsse;100113;536063;-435950
01.10.11;WA09;Kaffee, Tee, Mate, Gewürze;196896;386858;-189962
01.10.11;WA10;Getreide;161859;210264;-48405
01.10.11;WA11;Müllereierzeugnisse, Malz usw.;89541;42423;47118
01.10.11;WA12;Ölsamen usw., Heilpflanzen usw.;45616;386718;-341102
01.10.11;WA13;Schellack, Gummen, Harz, Pflanzensaft;31674;32649;-975
01.10.11;WA14;Flechtstoffe usw. pflanzlichen Ursprungs;1052;2739;-1687
01.10.11;WA15;Tierische und pflanzliche Fette, Öle, Wachs;222153;334388;-112235
01.10.11;WA16;Zubereitungen von Fleisch, Fisch usw.;202746;192198;10548
01.10.11;WA17;Zucker und Zuckerwaren;192140;116161;75979
01.10.11;WA18;Kakao und Zubereitungen aus Kakao;377864;322295;55569
01.10.11;WA19;Zubereitungen aus Getreide usw., Backwaren;398208;227237;170971
01.10.11;WA20;Zubereitungen von Gemüse, Früchten usw.;174741;354270;-179529
01.10.11;WA21;Verschiedene Lebensmittelzubereitungen;325022;179494;145528
01.10.11;WA22;Getränke, alkoholhaltige Flüssigkeiten, Essig;404815;544069;-139254
01.10.11;WA23;Rückstände der Lebensmittelindustrie, Futter;239389;281704;-42315
01.10.11;WA24;Tabak;338634;142177;196457
01.10.11;WA25;Salz, Schwefel, Steine, Erden usw.;198243;183664;14579
01.10.11;WA26;Erze, Schlacken, Aschen;25592;651290;-625698
01.10.11;WA27;Mineralische Brennstoffe usw.;2360540;10619189;-8258649
01.10.11;WA28;Anorganische chemische Erzeugnisse;660633;532868;127765
01.10.11;WA29;Organische chemische Erzeugnisse;1890298;2296862;-406564
01.10.11;WA30;Pharmazeutische Erzeugnisse;4033908;2909693;1124215
01.10.11;WA31;Düngemittel;214297;119844;94453
01.10.11;WA32;Gerb- und Farbstoffe, Farben, Lacke usw.;787800;429072;358728
01.10.11;WA33;Etherische Öle, Riech-, Schönheitsmittel;655464;377696;277768
01.10.11;WA34;Seifen, Waschmittel usw.;478802;255504;223298
01.10.11;WA35;Eiweissstoffe, Klebstoffe, Enzyme;202975;159760;43215
01.10.11;WA36;Sprengstoffe, pyrotechnische Artikel usw.;20196;27392;-7196
01.10.11;WA37;Photochemische Erzeugnisse;79287;62758;16529
01.10.11;WA38;Verschiedene Erzeugnisse der Chemischen Industrie;1422948;905033;517915
01.10.11;WA39;Kunststoffe und Waren daraus;3943156;2493654;1449502
01.10.11;WA40;Kautschuk und Waren daraus;1234593;1318489;-83896
01.10.11;WA41;Häute, Felle, Leder;89625;82353;7272
01.10.11;WA42;Lederwaren, Sattlerwaren;129375;230415;-101040
01.10.11;WA43;Pelzfelle, künstliches Pelzwerk;18417;16551;1866
01.10.11;WA44;Holz, Holzwaren, Holzkohle;553044;531895;21149
01.10.11;WA45;Kork, Korkwaren;2827;11136;-8309
01.10.11;WA46;Flechtwaren, Korbmacherwaren;3364;9553;-6189
01.10.11;WA47;Halbstoffe aus Holz usw., Papierabfall;102513;307855;-205342
01.10.11;WA48;Papier, Pappe und Waren daraus;1610376;1009271;601105
01.10.11;WA49;Bücher, Zeitungen, Bilddrucke usw.;370483;189599;180884
01.10.11;WA50;Seide;5771;6041;-270
01.10.11;WA51;Wolle, feine und grobe Tierhaare;58900;71066;-12166
01.10.11;WA52;Baumwolle;101653;100026;1627
01.10.11;WA53;Andere pflanzliche Spinnstoffe, Papiergarn;4808;8553;-3745
01.10.11;WA54;Synthetisches oder künstliches Filament;164029;125779;38250
01.10.11;WA55;Synthetische oder künstliche Spinnfaser;161560;137096;24464
01.10.11;WA56;Watte, Filz, Vliesstoff usw., Tauwerk;175137;105860;69277
01.10.11;WA57;Teppiche, Fussbodenbelag aus Spinnstoff;46341;101758;-55417
01.10.11;WA58;Spezialgewebe, Spitzen, Tapisserien;43144;28556;14588
01.10.11;WA59;Getränkte, bestrichene usw. Gewebe;165105;95138;69967
01.10.11;WA60;Gewirke und Gestricke;69675;39685;29990
01.10.11;WA61;Bekleidung usw. aus Gewirken, Gestricken;529158;1074146;-544988
01.10.11;WA62;Andere Bekleidung, Bekleidungszubehör;577439;1014440;-437001
01.10.11;WA63;Andere Konfektion, Spinnstoffwaren usw.;169722;271891;-102169
01.10.11;WA64;Schuhe, Gamaschen, ähnliche Waren;282732;506661;-223929
01.10.11;WA65;Kopfbedeckungen und Teile davon;32768;46975;-14207
01.10.11;WA66;Schirme, Gehstöcke usw., Peitschen;6106;11103;-4997
01.10.11;WA67;Zugerichtete Federn, Daunen, künstliche Blumen;8059;13402;-5343
01.10.11;WA68;Waren aus Steinen, Gips, Zement usw.;293593;238178;55415
01.10.11;WA69;Keramische Waren;233142;184864;48278
01.10.11;WA70;Glas und Glaswaren;422944;338524;84420
01.10.11;WA71;Perlen, Edelsteine, Edelmetalle;1399344;1675193;-275849
01.10.11;WA72;Eisen und Stahl;2098081;2215779;-117698
01.10.11;WA73;Waren aus Eisen oder Stahl;2051432;1487983;563449
01.10.11;WA74;Kupfer und Waren daraus;923422;902449;20973
01.10.11;WA75;Nickel und Waren daraus;79873;131887;-52014
01.10.11;WA76;Aluminium und Waren daraus;1007487;1114689;-107202
01.10.11;WA78;Blei und Waren daraus;53399;26757;26642
01.10.11;WA79;Zink und Waren daraus;48166;91693;-43527
01.10.11;WA80;Zinn und Waren daraus;9893;32667;-22774
01.10.11;WA81;Andere unedle Metalle, Cermets usw.;105687;140043;-34356
01.10.11;WA82;Werkzeuge, Schneidwaren, Essbestecke;556424;344056;212368
01.10.11;WA83;Verschiedene Waren aus unedlen Metallen;517471;317445;200026
01.10.11;WA84;Maschinen, Apparate, mechanische Geräte;15534274;9687375;5846899
01.10.11;WA85;Elektrotechnische Erzeugnisse;8859024;8887583;-28559
01.10.11;WA86;Schienenfahrzeuge;260951;115666;145285
01.10.11;WA87;Kraftfahrzeuge, Landfahrzeuge;15441705;6127496;9314209
01.10.11;WA88;Luftfahrzeuge, Raumfahrzeuge;2432310;2001418;430892
01.10.11;WA89;Wasserfahrzeuge;99787;655035;-555248
01.10.11;WA90;Optische, photografische usw. Erzeugnisse;3884560;2249613;1634947
01.10.11;WA91;Uhrmacherwaren;128328;176366;-48038
01.10.11;WA92;Musikinstrumente;48056;47309;747
01.10.11;WA93;Waffen und Munition;28454;14938;13516
01.10.11;WA94;Möbel, Beleuchtungskörper usw.;1173654;1167859;5795
01.10.11;WA95;Spielzeug, Spiele usw., Sportgeräte;572105;650706;-78601
01.10.11;WA96;Verschiedene Waren;159590;126441;33149
01.10.11;WA97;Kunstgegenstände, Sammlungsstücke;76992;32731;44261
01.10.11;WA98;Vollständige Fabrikationsanlagen;314979;87015;227964
01.10.11;WA99;Zusammenstellungen verschiedener Waren;1337875;1010078;327797
01.10.12;WA01;Lebende Tiere;140648;168664;-28016
01.10.12;WA02;Fleisch;810508;647491;163017
01.10.12;WA03;Fische, Krebs- und Weichtiere;111347;288035;-176688
01.10.12;WA04;Milch, Milcherzeugnisse, Eier, Honig;695247;552966;142281
01.10.12;WA05;Andere Waren tierischen Ursprungs;67265;85499;-18234
01.10.12;WA06;Pflanzen, Waren des Blumenhandels;68574;195606;-127032
01.10.12;WA07;Gemüse, Pflanzen für Ernährung;107387;337036;-229649
01.10.12;WA08;Geniessbare Früchte und Nüsse;114883;593967;-479084
01.10.12;WA09;Kaffee, Tee, Mate, Gewürze;213985;384093;-170108
01.10.12;WA10;Getreide;365264;215884;149380
01.10.12;WA11;Müllereierzeugnisse, Malz usw.;107917;46324;61593
01.10.12;WA12;Ölsamen usw., Heilpflanzen usw.;62063;458724;-396661
01.10.12;WA13;Schellack, Gummen, Harz, Pflanzensaft;37203;33441;3762
01.10.12;WA14;Flechtstoffe usw. pflanzlichen Ursprungs;1084;2428;-1344
01.10.12;WA15;Tierische und pflanzliche Fette, Öle, Wachs;279285;333102;-53817
01.10.12;WA16;Zubereitungen von Fleisch, Fisch usw.;241240;236429;4811
01.10.12;WA17;Zucker und Zuckerwaren;201393;137572;63821
01.10.12;WA18;Kakao und Zubereitungen aus Kakao;438145;312866;125279
01.10.12;WA19;Zubereitungen aus Getreide usw., Backwaren;462535;253130;209405
01.10.12;WA20;Zubereitungen von Gemüse, Früchten usw.;190093;401859;-211766
01.10.12;WA21;Verschiedene Lebensmittelzubereitungen;393900;219007;174893
01.10.12;WA22;Getränke, alkoholhaltige Flüssigkeiten, Essig;434795;635541;-200746
01.10.12;WA23;Rückstände der Lebensmittelindustrie, Futter;335745;373339;-37594
01.10.12;WA24;Tabak;337033;169065;167968
01.10.12;WA25;Salz, Schwefel, Steine, Erden usw.;194859;150184;44675
01.10.12;WA26;Erze, Schlacken, Aschen;36817;745020;-708203
01.10.12;WA27;Mineralische Brennstoffe usw.;2506099;12438305;-9932206
01.10.12;WA28;Anorganische chemische Erzeugnisse;794934;535705;259229
01.10.12;WA29;Organische chemische Erzeugnisse;2159178;2020060;139118
01.10.12;WA30;Pharmazeutische Erzeugnisse;4893168;3112623;1780545
01.10.12;WA31;Düngemittel;190979;137537;53442
01.10.12;WA32;Gerb- und Farbstoffe, Farben, Lacke usw.;938338;481036;457302
01.10.12;WA33;Etherische Öle, Riech-, Schönheitsmittel;762874;469885;292989
01.10.12;WA34;Seifen, Waschmittel usw.;567033;310386;256647
01.10.12;WA35;Eiweissstoffe, Klebstoffe, Enzyme;232981;156700;76281
01.10.12;WA36;Sprengstoffe, pyrotechnische Artikel usw.;19388;36859;-17471
01.10.12;WA37;Photochemische Erzeugnisse;97179;64289;32890
01.10.12;WA38;Verschiedene Erzeugnisse der Chemischen Industrie;1524678;946538;578140
01.10.12;WA39;Kunststoffe und Waren daraus;4468531;2764996;1703535
01.10.12;WA40;Kautschuk und Waren daraus;1292570;1256267;36303
01.10.12;WA41;Häute, Felle, Leder;101416;85056;16360
01.10.12;WA42;Lederwaren, Sattlerwaren;138984;260302;-121318
01.10.12;WA43;Pelzfelle, künstliches Pelzwerk;20380;14884;5496
01.10.12;WA44;Holz, Holzwaren, Holzkohle;600963;574004;26959
01.10.12;WA45;Kork, Korkwaren;3057;9094;-6037
01.10.12;WA46;Flechtwaren, Korbmacherwaren;4213;11726;-7513
01.10.12;WA47;Halbstoffe aus Holz usw., Papierabfall;89417;309895;-220478
01.10.12;WA48;Papier, Pappe und Waren daraus;1546863;1049367;497496
01.10.12;WA49;Bücher, Zeitungen, Bilddrucke usw.;400224;190244;209980
01.10.12;WA50;Seide;7488;9292;-1804
01.10.12;WA51;Wolle, feine und grobe Tierhaare;49899;70299;-20400
01.10.12;WA52;Baumwolle;102120;102800;-680
01.10.12;WA53;Andere pflanzliche Spinnstoffe, Papiergarn;4730;8454;-3724
01.10.12;WA54;Synthetisches oder künstliches Filament;171345;131273;40072
01.10.12;WA55;Synthetische oder künstliche Spinnfaser;164013;139787;24226
01.10.12;WA56;Watte, Filz, Vliesstoff usw., Tauwerk;186147;102082;84065
01.10.12;WA57;Teppiche, Fussbodenbelag aus Spinnstoff;47186;89160;-41974
01.10.12;WA58;Spezialgewebe, Spitzen, Tapisserien;43805;29147;14658
01.10.12;WA59;Getränkte, bestrichene usw. Gewebe;173441;99180;74261
01.10.12;WA60;Gewirke und Gestricke;70831;43925;26906
01.10.12;WA61;Bekleidung usw. aus Gewirken, Gestricken;570760;1180053;-609293
01.10.12;WA62;Andere Bekleidung, Bekleidungszubehör;632711;1108094;-475383
01.10.12;WA63;Andere Konfektion, Spinnstoffwaren usw.;199626;284634;-85008
01.10.12;WA64;Schuhe, Gamaschen, ähnliche Waren;262273;546719;-284446
01.10.12;WA65;Kopfbedeckungen und Teile davon;32311;41518;-9207
01.10.12;WA66;Schirme, Gehstöcke usw., Peitschen;6730;9603;-2873
01.10.12;WA67;Zugerichtete Federn, Daunen, künstliche Blumen;8506;12952;-4446
01.10.12;WA68;Waren aus Steinen, Gips, Zement usw.;339122;234528;104594
01.10.12;WA69;Keramische Waren;279974;212871;67103
01.10.12;WA70;Glas und Glaswaren;456795;371521;85274
01.10.12;WA71;Perlen, Edelsteine, Edelmetalle;1365811;1434970;-69159
01.10.12;WA72;Eisen und Stahl;2124820;2063208;61612
01.10.12;WA73;Waren aus Eisen oder Stahl;2381530;1565562;815968
01.10.12;WA74;Kupfer und Waren daraus;1026778;1076185;-49407
01.10.12;WA75;Nickel und Waren daraus;87510;256665;-169155
01.10.12;WA76;Aluminium und Waren daraus;1127041;1190611;-63570
01.10.12;WA78;Blei und Waren daraus;48204;26833;21371
01.10.12;WA79;Zink und Waren daraus;54925;105335;-50410
01.10.12;WA80;Zinn und Waren daraus;9504;37157;-27653
01.10.12;WA81;Andere unedle Metalle, Cermets usw.;103861;141091;-37230
01.10.12;WA82;Werkzeuge, Schneidwaren, Essbestecke;610529;376863;233666
01.10.12;WA83;Verschiedene Waren aus unedlen Metallen;569306;341695;227611
01.10.12;WA84;Maschinen, Apparate, mechanische Geräte;16509688;9783149;6726539
01.10.12;WA85;Elektrotechnische Erzeugnisse;9498349;8975284;523065
01.10.12;WA86;Schienenfahrzeuge;296857;158720;138137
01.10.12;WA87;Kraftfahrzeuge, Landfahrzeuge;16577654;6634089;9943565
01.10.12;WA88;Luftfahrzeuge, Raumfahrzeuge;3361205;1407197;1954008
01.10.12;WA89;Wasserfahrzeuge;70080;324756;-254676
01.10.12;WA90;Optische, photografische usw. Erzeugnisse;4451537;2496992;1954545
01.10.12;WA91;Uhrmacherwaren;154530;216176;-61646
01.10.12;WA92;Musikinstrumente;52916;50279;2637
01.10.12;WA93;Waffen und Munition;47667;20162;27505
01.10.12;WA94;Möbel, Beleuchtungskörper usw.;1273653;1302194;-28541
01.10.12;WA95;Spielzeug, Spiele usw., Sportgeräte;402052;590427;-188375
01.10.12;WA96;Verschiedene Waren;298233;213902;84331
01.10.12;WA97;Kunstgegenstände, Sammlungsstücke;77223;44289;32934
01.10.12;WA98;Vollständige Fabrikationsanlagen;283645;11512;272133
01.10.12;WA99;Zusammenstellungen verschiedener Waren;1605423;914186;691237
01.10.13;WA01;Lebende Tiere;137045;180976;-43931
01.10.13;WA02;Fleisch;716165;559567;156598
01.10.13;WA03;Fische, Krebs- und Weichtiere;116313;306434;-190121
01.10.13;WA04;Milch, Milcherzeugnisse, Eier, Honig;800336;658164;142172
01.10.13;WA05;Andere Waren tierischen Ursprungs;70028;75074;-5046
01.10.13;WA06;Pflanzen, Waren des Blumenhandels;73633;174856;-101223
01.10.13;WA07;Gemüse, Pflanzen für Ernährung;70578;329453;-258875
01.10.13;WA08;Geniessbare Früchte und Nüsse;115350;722674;-607324
01.10.13;WA09;Kaffee, Tee, Mate, Gewürze;217972;297836;-79864
01.10.13;WA10;Getreide;307333;229263;78070
01.10.13;WA11;Müllereierzeugnisse, Malz usw.;112009;45288;66721
01.10.13;WA12;Ölsamen usw., Heilpflanzen usw.;63047;455284;-392237
01.10.13;WA13;Schellack, Gummen, Harz, Pflanzensaft;39916;33564;6352
01.10.13;WA14;Flechtstoffe usw. pflanzlichen Ursprungs;675;2785;-2110
01.10.13;WA15;Tierische und pflanzliche Fette, Öle, Wachs;266658;318526;-51868
01.10.13;WA16;Zubereitungen von Fleisch, Fisch usw.;242500;202445;40055
01.10.13;WA17;Zucker und Zuckerwaren;174078;140899;33179
01.10.13;WA18;Kakao und Zubereitungen aus Kakao;480973;328665;152308
01.10.13;WA19;Zubereitungen aus Getreide usw., Backwaren;486513;276762;209751
01.10.13;WA20;Zubereitungen von Gemüse, Früchten usw.;208092;378228;-170136
01.10.13;WA21;Verschiedene Lebensmittelzubereitungen;389261;214157;175104
01.10.13;WA22;Getränke, alkoholhaltige Flüssigkeiten, Essig;450065;609415;-159350
01.10.13;WA23;Rückstände der Lebensmittelindustrie, Futter;319585;320088;-503
01.10.13;WA24;Tabak;279259;163550;115709
01.10.13;WA25;Salz, Schwefel, Steine, Erden usw.;192498;159569;32929
01.10.13;WA26;Erze, Schlacken, Aschen;32221;697015;-664794
01.10.13;WA27;Mineralische Brennstoffe usw.;2357547;10747908;-8390361
01.10.13;WA28;Anorganische chemische Erzeugnisse;723796;507799;215997
01.10.13;WA29;Organische chemische Erzeugnisse;2162428;2051118;111310
01.10.13;WA30;Pharmazeutische Erzeugnisse;5387785;3065383;2322402
01.10.13;WA31;Düngemittel;186622;100715;85907
01.10.13;WA32;Gerb- und Farbstoffe, Farben, Lacke usw.;926514;515304;411210
01.10.13;WA33;Etherische Öle, Riech-, Schönheitsmittel;748789;505240;243549
01.10.13;WA34;Seifen, Waschmittel usw.;579689;307323;272366
01.10.13;WA35;Eiweissstoffe, Klebstoffe, Enzyme;256447;167564;88883
01.10.13;WA36;Sprengstoffe, pyrotechnische Artikel usw.;17278;29070;-11792
01.10.13;WA37;Photochemische Erzeugnisse;97793;62225;35568
01.10.13;WA38;Verschiedene Erzeugnisse der Chemischen Industrie;1595962;914871;681091
01.10.13;WA39;Kunststoffe und Waren daraus;4657565;2810534;1847031
01.10.13;WA40;Kautschuk und Waren daraus;1350315;1268634;81681
01.10.13;WA41;Häute, Felle, Leder;99371;88191;11180
01.10.13;WA42;Lederwaren, Sattlerwaren;140911;269494;-128583
01.10.13;WA43;Pelzfelle, künstliches Pelzwerk;15044;11933;3111
01.10.13;WA44;Holz, Holzwaren, Holzkohle;616491;597542;18949
01.10.13;WA45;Kork, Korkwaren;2405;8357;-5952
01.10.13;WA46;Flechtwaren, Korbmacherwaren;3782;9088;-5306
01.10.13;WA47;Halbstoffe aus Holz usw., Papierabfall;93819;279497;-185678
01.10.13;WA48;Papier, Pappe und Waren daraus;1538679;993742;544937
01.10.13;WA49;Bücher, Zeitungen, Bilddrucke usw.;393325;171573;221752
01.10.13;WA50;Seide;6623;6436;187
01.10.13;WA51;Wolle, feine und grobe Tierhaare;47968;55476;-7508
01.10.13;WA52;Baumwolle;98007;100789;-2782
01.10.13;WA53;Andere pflanzliche Spinnstoffe, Papiergarn;3831;6356;-2525
01.10.13;WA54;Synthetisches oder künstliches Filament;176813;130911;45902
01.10.13;WA55;Synthetische oder künstliche Spinnfaser;170965;139829;31136
01.10.13;WA56;Watte, Filz, Vliesstoff usw., Tauwerk;206209;96885;109324
01.10.13;WA57;Teppiche, Fussbodenbelag aus Spinnstoff;45660;89208;-43548
01.10.13;WA58;Spezialgewebe, Spitzen, Tapisserien;43361;25134;18227
01.10.13;WA59;Getränkte, bestrichene usw. Gewebe;182482;96712;85770
01.10.13;WA60;Gewirke und Gestricke;71318;39260;32058
01.10.13;WA61;Bekleidung usw. aus Gewirken, Gestricken;584153;1218294;-634141
01.10.13;WA62;Andere Bekleidung, Bekleidungszubehör;622216;1134068;-511852
01.10.13;WA63;Andere Konfektion, Spinnstoffwaren usw.;208126;276811;-68685
01.10.13;WA64;Schuhe, Gamaschen, ähnliche Waren;300183;545860;-245677
01.10.13;WA65;Kopfbedeckungen und Teile davon;32737;41517;-8780
01.10.13;WA66;Schirme, Gehstöcke usw., Peitschen;6244;8422;-2178
01.10.13;WA67;Zugerichtete Federn, Daunen, künstliche Blumen;9502;11504;-2002
01.10.13;WA68;Waren aus Steinen, Gips, Zement usw.;354582;221883;132699
01.10.13;WA69;Keramische Waren;267002;207188;59814
01.10.13;WA70;Glas und Glaswaren;491654;365996;125658
01.10.13;WA71;Perlen, Edelsteine, Edelmetalle;1112721;1496499;-383778
01.10.13;WA72;Eisen und Stahl;1928577;2017331;-88754
01.10.13;WA73;Waren aus Eisen oder Stahl;2306590;1585268;721322
01.10.13;WA74;Kupfer und Waren daraus;940169;941674;-1505
01.10.13;WA75;Nickel und Waren daraus;79922;102111;-22189
01.10.13;WA76;Aluminium und Waren daraus;1056995;1122603;-65608
01.10.13;WA78;Blei und Waren daraus;41931;36779;5152
01.10.13;WA79;Zink und Waren daraus;51368;95778;-44410
01.10.13;WA80;Zinn und Waren daraus;9934;31788;-21854
01.10.13;WA81;Andere unedle Metalle, Cermets usw.;111894;125109;-13215
01.10.13;WA82;Werkzeuge, Schneidwaren, Essbestecke;644593;351221;293372
01.10.13;WA83;Verschiedene Waren aus unedlen Metallen;603002;343816;259186
01.10.13;WA84;Maschinen, Apparate, mechanische Geräte;16474347;9714889;6759458
01.10.13;WA85;Elektrotechnische Erzeugnisse;9835356;9074622;760734
01.10.13;WA86;Schienenfahrzeuge;304016;232898;71118
01.10.13;WA87;Kraftfahrzeuge, Landfahrzeuge;16941052;7029778;9911274
01.10.13;WA88;Luftfahrzeuge, Raumfahrzeuge;3253683;2098982;1154701
01.10.13;WA89;Wasserfahrzeuge;157289;366554;-209265
01.10.13;WA90;Optische, photografische usw. Erzeugnisse;4467042;2428075;2038967
01.10.13;WA91;Uhrmacherwaren;164381;221513;-57132
01.10.13;WA92;Musikinstrumente;52560;45126;7434
01.10.13;WA93;Waffen und Munition;34781;14929;19852
01.10.13;WA94;Möbel, Beleuchtungskörper usw.;1223583;1351258;-127675
01.10.13;WA95;Spielzeug, Spiele usw., Sportgeräte;390736;513318;-122582
01.10.13;WA96;Verschiedene Waren;303169;199381;103788
01.10.13;WA97;Kunstgegenstände, Sammlungsstücke;47775;24999;22776
01.10.13;WA98;Vollständige Fabrikationsanlagen;191118;2391;188727
01.10.13;WA99;Zusammenstellungen verschiedener Waren;1553699;821075;732624
01.10.14;WA01;Lebende Tiere;140235;161539;-21304
01.10.14;WA02;Fleisch;686440;522723;163717
01.10.14;WA03;Fische, Krebs- und Weichtiere;138145;353455;-215310
01.10.14;WA04;Milch, Milcherzeugnisse, Eier, Honig;760826;614750;146076
01.10.14;WA05;Andere Waren tierischen Ursprungs;57839;69038;-11199
01.10.14;WA06;Pflanzen, Waren des Blumenhandels;71881;175489;-103608
01.10.14;WA07;Gemüse, Pflanzen für Ernährung;80106;355987;-275881
01.10.14;WA08;Geniessbare Früchte und Nüsse;132139;680237;-548098
01.10.14;WA09;Kaffee, Tee, Mate, Gewürze;222591;375132;-152541
01.10.14;WA10;Getreide;247559;204292;43267
01.10.14;WA11;Müllereierzeugnisse, Malz usw.;131009;40926;90083
01.10.14;WA12;Ölsamen usw., Heilpflanzen usw.;71281;414922;-343641
01.10.14;WA13;Schellack, Gummen, Harz, Pflanzensaft;40411;41350;-939
01.10.14;WA14;Flechtstoffe usw. pflanzlichen Ursprungs;927;3158;-2231
01.10.14;WA15;Tierische und pflanzliche Fette, Öle, Wachs;229262;322631;-93369
01.10.14;WA16;Zubereitungen von Fleisch, Fisch usw.;242884;201138;41746
01.10.14;WA17;Zucker und Zuckerwaren;198682;130624;68058
01.10.14;WA18;Kakao und Zubereitungen aus Kakao;504873;388086;116787
01.10.14;WA19;Zubereitungen aus Getreide usw., Backwaren;481576;291266;190310
01.10.14;WA20;Zubereitungen von Gemüse, Früchten usw.;203368;378048;-174680
01.10.14;WA21;Verschiedene Lebensmittelzubereitungen;423315;231928;191387
01.10.14;WA22;Getränke, alkoholhaltige Flüssigkeiten, Essig;432143;567419;-135276
01.10.14;WA23;Rückstände der Lebensmittelindustrie, Futter;335391;333797;1594
01.10.14;WA24;Tabak;331858;179130;152728
01.10.14;WA25;Salz, Schwefel, Steine, Erden usw.;186519;152642;33877
01.10.14;WA26;Erze, Schlacken, Aschen;26168;647729;-621561
01.10.14;WA27;Mineralische Brennstoffe usw.;2405381;9490999;-7085618
01.10.14;WA28;Anorganische chemische Erzeugnisse;704605;541788;162817
01.10.14;WA29;Organische chemische Erzeugnisse;2108850;2419716;-310866
01.10.14;WA30;Pharmazeutische Erzeugnisse;5095449;3436402;1659047
01.10.14;WA31;Düngemittel;208347;122615;85732
01.10.14;WA32;Gerb- und Farbstoffe, Farben, Lacke usw.;936066;492928;443138
01.10.14;WA33;Etherische Öle, Riech-, Schönheitsmittel;804256;492573;311683
01.10.14;WA34;Seifen, Waschmittel usw.;599741;318379;281362
01.10.14;WA35;Eiweissstoffe, Klebstoffe, Enzyme;289882;190997;98885
01.10.14;WA36;Sprengstoffe, pyrotechnische Artikel usw.;19083;29833;-10750
01.10.14;WA37;Photochemische Erzeugnisse;94800;63728;31072
01.10.14;WA38;Verschiedene Erzeugnisse der Chemischen Industrie;1672577;970869;701708
01.10.14;WA39;Kunststoffe und Waren daraus;4778606;2933759;1844847
01.10.14;WA40;Kautschuk und Waren daraus;1274651;1146981;127670
01.10.14;WA41;Häute, Felle, Leder;108323;95330;12993
01.10.14;WA42;Lederwaren, Sattlerwaren;160909;296059;-135150
01.10.14;WA43;Pelzfelle, künstliches Pelzwerk;15666;14892;774
01.10.14;WA44;Holz, Holzwaren, Holzkohle;637821;612824;24997
01.10.14;WA45;Kork, Korkwaren;2464;9660;-7196
01.10.14;WA46;Flechtwaren, Korbmacherwaren;3600;8809;-5209
01.10.14;WA47;Halbstoffe aus Holz usw., Papierabfall;96151;294031;-197880
01.10.14;WA48;Papier, Pappe und Waren daraus;1542133;1053878;488255
01.10.14;WA49;Bücher, Zeitungen, Bilddrucke usw.;408769;182780;225989
01.10.14;WA50;Seide;6914;7107;-193
01.10.14;WA51;Wolle, feine und grobe Tierhaare;48827;56350;-7523
01.10.14;WA52;Baumwolle;90476;87474;3002
01.10.14;WA53;Andere pflanzliche Spinnstoffe, Papiergarn;5071;7056;-1985
01.10.14;WA54;Synthetisches oder künstliches Filament;171100;136393;34707
01.10.14;WA55;Synthetische oder künstliche Spinnfaser;172165;134867;37298
01.10.14;WA56;Watte, Filz, Vliesstoff usw., Tauwerk;206089;104693;101396
01.10.14;WA57;Teppiche, Fussbodenbelag aus Spinnstoff;53036;100976;-47940
01.10.14;WA58;Spezialgewebe, Spitzen, Tapisserien;44088;23695;20393
01.10.14;WA59;Getränkte, bestrichene usw. Gewebe;181595;93277;88318
01.10.14;WA60;Gewirke und Gestricke;72837;40248;32589
01.10.14;WA61;Bekleidung usw. aus Gewirken, Gestricken;620218;1286077;-665859
01.10.14;WA62;Andere Bekleidung, Bekleidungszubehör;644720;1135852;-491132
01.10.14;WA63;Andere Konfektion, Spinnstoffwaren usw.;223977;306817;-82840
01.10.14;WA64;Schuhe, Gamaschen, ähnliche Waren;338097;639660;-301563
01.10.14;WA65;Kopfbedeckungen und Teile davon;37573;46617;-9044
01.10.14;WA66;Schirme, Gehstöcke usw., Peitschen;7491;11496;-4005
01.10.14;WA67;Zugerichtete Federn, Daunen, künstliche Blumen;9495;13229;-3734
01.10.14;WA68;Waren aus Steinen, Gips, Zement usw.;370397;241534;128863
01.10.14;WA69;Keramische Waren;269924;221464;48460
01.10.14;WA70;Glas und Glaswaren;519358;405337;114021
01.10.14;WA71;Perlen, Edelsteine, Edelmetalle;932225;996659;-64434
01.10.14;WA72;Eisen und Stahl;1904918;1981781;-76863
01.10.14;WA73;Waren aus Eisen oder Stahl;2318995;1610171;708824
01.10.14;WA74;Kupfer und Waren daraus;923304;873809;49495
01.10.14;WA75;Nickel und Waren daraus;95040;129282;-34242
01.10.14;WA76;Aluminium und Waren daraus;1193055;1348443;-155388
01.10.14;WA78;Blei und Waren daraus;39999;37432;2567
01.10.14;WA79;Zink und Waren daraus;61960;113442;-51482
01.10.14;WA80;Zinn und Waren daraus;10660;32195;-21535
01.10.14;WA81;Andere unedle Metalle, Cermets usw.;119113;141277;-22164
01.10.14;WA82;Werkzeuge, Schneidwaren, Essbestecke;677305;395271;282034
01.10.14;WA83;Verschiedene Waren aus unedlen Metallen;568821;365722;203099
01.10.14;WA84;Maschinen, Apparate, mechanische Geräte;17475020;10389837;7085183
01.10.14;WA85;Elektrotechnische Erzeugnisse;10369863;9747736;622127
01.10.14;WA86;Schienenfahrzeuge;323874;205690;118184
01.10.14;WA87;Kraftfahrzeuge, Landfahrzeuge;18418173;7289057;11129116
01.10.14;WA88;Luftfahrzeuge, Raumfahrzeuge;3080573;1332660;1747913
01.10.14;WA89;Wasserfahrzeuge;896975;107838;789137
01.10.14;WA90;Optische, photografische usw. Erzeugnisse;4618146;2607121;2011025
01.10.14;WA91;Uhrmacherwaren;193735;212536;-18801
01.10.14;WA92;Musikinstrumente;53188;52532;656
01.10.14;WA93;Waffen und Munition;38811;13704;25107
01.10.14;WA94;Möbel, Beleuchtungskörper usw.;1285932;1482054;-196122
01.10.14;WA95;Spielzeug, Spiele usw., Sportgeräte;432764;593733;-160969
01.10.14;WA96;Verschiedene Waren;314382;208112;106270
01.10.14;WA97;Kunstgegenstände, Sammlungsstücke;39159;23938;15221
01.10.14;WA98;Vollständige Fabrikationsanlagen;185875;2809;183066
01.10.14;WA99;Zusammenstellungen verschiedener Waren;1852107;914577;937530
01.10.15;WA01;Lebende Tiere;151901;159869;-7968
01.10.15;WA02;Fleisch;650544;547308;103236
01.10.15;WA03;Fische, Krebs- und Weichtiere;151661;340993;-189332
01.10.15;WA04;Milch, Milcherzeugnisse, Eier, Honig;669014;567907;101107
01.10.15;WA05;Andere Waren tierischen Ursprungs;69566;72932;-3366
01.10.15;WA06;Pflanzen, Waren des Blumenhandels;74103;175116;-101013
01.10.15;WA07;Gemüse, Pflanzen für Ernährung;89021;393000;-303979
01.10.15;WA08;Geniessbare Früchte und Nüsse;151424;791536;-640112
01.10.15;WA09;Kaffee, Tee, Mate, Gewürze;222480;349427;-126947
01.10.15;WA10;Getreide;166873;213955;-47082
01.10.15;WA11;Müllereierzeugnisse, Malz usw.;123357;49373;73984
01.10.15;WA12;Ölsamen usw., Heilpflanzen usw.;67775;437187;-369412
01.10.15;WA13;Schellack, Gummen, Harz, Pflanzensaft;42359;39912;2447
01.10.15;WA14;Flechtstoffe usw. pflanzlichen Ursprungs;760;2788;-2028
01.10.15;WA15;Tierische und pflanzliche Fette, Öle, Wachs;250465;280244;-29779
01.10.15;WA16;Zubereitungen von Fleisch, Fisch usw.;247793;213438;34355
01.10.15;WA17;Zucker und Zuckerwaren;159942;138430;21512
01.10.15;WA18;Kakao und Zubereitungen aus Kakao;546619;441194;105425
01.10.15;WA19;Zubereitungen aus Getreide usw., Backwaren;519378;334796;184582
01.10.15;WA20;Zubereitungen von Gemüse, Früchten usw.;211582;402292;-190710
01.10.15;WA21;Verschiedene Lebensmittelzubereitungen;410159;247535;162624
01.10.15;WA22;Getränke, alkoholhaltige Flüssigkeiten, Essig;471294;577387;-106093
01.10.15;WA23;Rückstände der Lebensmittelindustrie, Futter;344070;354897;-10827
01.10.15;WA24;Tabak;357184;183878;173306
01.10.15;WA25;Salz, Schwefel, Steine, Erden usw.;184113;141636;42477
01.10.15;WA26;Erze, Schlacken, Aschen;23413;449397;-425984
01.10.15;WA27;Mineralische Brennstoffe usw.;2240411;7144403;-4903992
01.10.15;WA28;Anorganische chemische Erzeugnisse;705264;461854;243410
01.10.15;WA29;Organische chemische Erzeugnisse;2003930;2497443;-493513
01.10.15;WA30;Pharmazeutische Erzeugnisse;5815775;3646057;2169718
01.10.15;WA31;Düngemittel;182126;84520;97606
01.10.15;WA32;Gerb- und Farbstoffe, Farben, Lacke usw.;940075;516340;423735
01.10.15;WA33;Etherische Öle, Riech-, Schönheitsmittel;775673;575141;200532
01.10.15;WA34;Seifen, Waschmittel usw.;591960;350870;241090
01.10.15;WA35;Eiweissstoffe, Klebstoffe, Enzyme;264382;173962;90420
01.10.15;WA36;Sprengstoffe, pyrotechnische Artikel usw.;18059;26850;-8791
01.10.15;WA37;Photochemische Erzeugnisse;107809;68575;39234
01.10.15;WA38;Verschiedene Erzeugnisse der Chemischen Industrie;1752953;1031040;721913
01.10.15;WA39;Kunststoffe und Waren daraus;4849619;3058656;1790963
01.10.15;WA40;Kautschuk und Waren daraus;1293847;1214480;79367
01.10.15;WA41;Häute, Felle, Leder;99984;72037;27947
01.10.15;WA42;Lederwaren, Sattlerwaren;160945;319811;-158866
01.10.15;WA43;Pelzfelle, künstliches Pelzwerk;10067;11438;-1371
01.10.15;WA44;Holz, Holzwaren, Holzkohle;644488;637704;6784
01.10.15;WA45;Kork, Korkwaren;2549;8149;-5600
01.10.15;WA46;Flechtwaren, Korbmacherwaren;4407;9625;-5218
01.10.15;WA47;Halbstoffe aus Holz usw., Papierabfall;98735;328183;-229448
01.10.15;WA48;Papier, Pappe und Waren daraus;1566007;1050510;515497
01.10.15;WA49;Bücher, Zeitungen, Bilddrucke usw.;381160;210643;170517
01.10.15;WA50;Seide;5761;5235;526
01.10.15;WA51;Wolle, feine und grobe Tierhaare;48418;54506;-6088
01.10.15;WA52;Baumwolle;83238;85040;-1802
01.10.15;WA53;Andere pflanzliche Spinnstoffe, Papiergarn;4486;7729;-3243
01.10.15;WA54;Synthetisches oder künstliches Filament;174887;136946;37941
01.10.15;WA55;Synthetische oder künstliche Spinnfaser;161523;133404;28119
01.10.15;WA56;Watte, Filz, Vliesstoff usw., Tauwerk;206293;111952;94341
01.10.15;WA57;Teppiche, Fussbodenbelag aus Spinnstoff;47580;94393;-46813
01.10.15;WA58;Spezialgewebe, Spitzen, Tapisserien;46345;22742;23603
01.10.15;WA59;Getränkte, bestrichene usw. Gewebe;196996;94538;102458
01.10.15;WA60;Gewirke und Gestricke;71434;39732;31702
01.10.15;WA61;Bekleidung usw. aus Gewirken, Gestricken;627656;1402153;-774497
01.10.15;WA62;Andere Bekleidung, Bekleidungszubehör;639655;1228098;-588443
01.10.15;WA63;Andere Konfektion, Spinnstoffwaren usw.;225056;316144;-91088
01.10.15;WA64;Schuhe, Gamaschen, ähnliche Waren;320579;687882;-367303
01.10.15;WA65;Kopfbedeckungen und Teile davon;34587;49565;-14978
01.10.15;WA66;Schirme, Gehstöcke usw., Peitschen;9458;14061;-4603
01.10.15;WA67;Zugerichtete Federn, Daunen, künstliche Blumen;10205;15641;-5436
01.10.15;WA68;Waren aus Steinen, Gips, Zement usw.;359089;260493;98596
01.10.15;WA69;Keramische Waren;275252;231443;43809
01.10.15;WA70;Glas und Glaswaren;518657;439884;78773
01.10.15;WA71;Perlen, Edelsteine, Edelmetalle;967313;1067486;-100173
01.10.15;WA72;Eisen und Stahl;1666599;1876382;-209783
01.10.15;WA73;Waren aus Eisen oder Stahl;2288838;1669069;619769
01.10.15;WA74;Kupfer und Waren daraus;841534;683880;157654
01.10.15;WA75;Nickel und Waren daraus;81585;103862;-22277
01.10.15;WA76;Aluminium und Waren daraus;1217844;1384333;-166489
01.10.15;WA78;Blei und Waren daraus;27818;19426;8392
01.10.15;WA79;Zink und Waren daraus;50532;100066;-49534
01.10.15;WA80;Zinn und Waren daraus;7651;25267;-17616
01.10.15;WA81;Andere unedle Metalle, Cermets usw.;116595;173496;-56901
01.10.15;WA82;Werkzeuge, Schneidwaren, Essbestecke;666314;407709;258605
01.10.15;WA83;Verschiedene Waren aus unedlen Metallen;615321;386269;229052
01.10.15;WA84;Maschinen, Apparate, mechanische Geräte;17767894;10879934;6887960
01.10.15;WA85;Elektrotechnische Erzeugnisse;10567407;10486976;80431
01.10.15;WA86;Schienenfahrzeuge;252994;199136;53858
01.10.15;WA87;Kraftfahrzeuge, Landfahrzeuge;20111707;8434225;11677482
01.10.15;WA88;Luftfahrzeuge, Raumfahrzeuge;3614266;2277614;1336652
01.10.15;WA89;Wasserfahrzeuge;536321;268383;267938
01.10.15;WA90;Optische, photografische usw. Erzeugnisse;4846614;2858319;1988295
01.10.15;WA91;Uhrmacherwaren;223149;239428;-16279
01.10.15;WA92;Musikinstrumente;48277;50484;-2207
01.10.15;WA93;Waffen und Munition;44391;17112;27279
01.10.15;WA94;Möbel, Beleuchtungskörper usw.;1378524;1604557;-226033
01.10.15;WA95;Spielzeug, Spiele usw., Sportgeräte;509384;738098;-228714
01.10.15;WA96;Verschiedene Waren;327334;226388;100946
01.10.15;WA97;Kunstgegenstände, Sammlungsstücke;68403;40650;27753
01.10.15;WA98;Vollständige Fabrikationsanlagen;184974;1138;183836
01.10.15;WA99;Zusammenstellungen verschiedener Waren;1863934;1036733;827201
01.10.16;WA01;Lebende Tiere;132836;177880;-45044
01.10.16;WA02;Fleisch;673473;559799;113674
01.10.16;WA03;Fische, Krebs- und Weichtiere;141859;360995;-219136
01.10.16;WA04;Milch, Milcherzeugnisse, Eier, Honig;669866;602486;67380
01.10.16;WA05;Andere Waren tierischen Ursprungs;64733;65923;-1190
01.10.16;WA06;Pflanzen, Waren des Blumenhandels;79878;185679;-105801
01.10.16;WA07;Gemüse, Pflanzen für Ernährung;79130;394016;-314886
01.10.16;WA08;Geniessbare Früchte und Nüsse;146948;743732;-596784
01.10.16;WA09;Kaffee, Tee, Mate, Gewürze;230158;389925;-159767
01.10.16;WA10;Getreide;152098;195706;-43608
01.10.16;WA11;Müllereierzeugnisse, Malz usw.;123630;48860;74770
01.10.16;WA12;Ölsamen usw., Heilpflanzen usw.;72901;439893;-366992
01.10.16;WA13;Schellack, Gummen, Harz, Pflanzensaft;47520;37349;10171
01.10.16;WA14;Flechtstoffe usw. pflanzlichen Ursprungs;612;3487;-2875
01.10.16;WA15;Tierische und pflanzliche Fette, Öle, Wachs;202472;350801;-148329
01.10.16;WA16;Zubereitungen von Fleisch, Fisch usw.;210942;209453;1489
01.10.16;WA17;Zucker und Zuckerwaren;177558;141982;35576
01.10.16;WA18;Kakao und Zubereitungen aus Kakao;538084;424148;113936
01.10.16;WA19;Zubereitungen aus Getreide usw., Backwaren;520576;327100;193476
01.10.16;WA20;Zubereitungen von Gemüse, Früchten usw.;215260;391536;-176276
01.10.16;WA21;Verschiedene Lebensmittelzubereitungen;415679;249964;165715
01.10.16;WA22;Getränke, alkoholhaltige Flüssigkeiten, Essig;462099;552922;-90823
01.10.16;WA23;Rückstände der Lebensmittelindustrie, Futter;371446;271801;99645
01.10.16;WA24;Tabak;339903;169102;170801
01.10.16;WA25;Salz, Schwefel, Steine, Erden usw.;172781;152701;20080
01.10.16;WA26;Erze, Schlacken, Aschen;33119;592405;-559286
01.10.16;WA27;Mineralische Brennstoffe usw.;1874276;6568435;-4694159
01.10.16;WA28;Anorganische chemische Erzeugnisse;616031;452622;163409
01.10.16;WA29;Organische chemische Erzeugnisse;1751366;2148564;-397198
01.10.16;WA30;Pharmazeutische Erzeugnisse;5628476;3800835;1827641
01.10.16;WA31;Düngemittel;135462;72461;63001
01.10.16;WA32;Gerb- und Farbstoffe, Farben, Lacke usw.;910898;484632;426266
01.10.16;WA33;Etherische Öle, Riech-, Schönheitsmittel;771212;587252;183960
01.10.16;WA34;Seifen, Waschmittel usw.;587626;343322;244304
01.10.16;WA35;Eiweissstoffe, Klebstoffe, Enzyme;252467;166041;86426
01.10.16;WA36;Sprengstoffe, pyrotechnische Artikel usw.;20648;23854;-3206
01.10.16;WA37;Photochemische Erzeugnisse;104193;72175;32018
01.10.16;WA38;Verschiedene Erzeugnisse der Chemischen Industrie;1724626;978064;746562
01.10.16;WA39;Kunststoffe und Waren daraus;4575543;2949850;1625693
01.10.16;WA40;Kautschuk und Waren daraus;1242338;1150110;92228
01.10.16;WA41;Häute, Felle, Leder;84489;69210;15279
01.10.16;WA42;Lederwaren, Sattlerwaren;162813;314227;-151414
01.10.16;WA43;Pelzfelle, künstliches Pelzwerk;8884;10964;-2080
01.10.16;WA44;Holz, Holzwaren, Holzkohle;605980;654490;-48510
01.10.16;WA45;Kork, Korkwaren;2349;8485;-6136
01.10.16;WA46;Flechtwaren, Korbmacherwaren;3196;9161;-5965
01.10.16;WA47;Halbstoffe aus Holz usw., Papierabfall;94919;275203;-180284
01.10.16;WA48;Papier, Pappe und Waren daraus;1446679;988124;458555
01.10.16;WA49;Bücher, Zeitungen, Bilddrucke usw.;371164;234195;136969
01.10.16;WA50;Seide;3545;4107;-562
01.10.16;WA51;Wolle, feine und grobe Tierhaare;45660;60510;-14850
01.10.16;WA52;Baumwolle;72667;80404;-7737
01.10.16;WA53;Andere pflanzliche Spinnstoffe, Papiergarn;4079;6362;-2283
01.10.16;WA54;Synthetisches oder künstliches Filament;156352;121743;34609
01.10.16;WA55;Synthetische oder künstliche Spinnfaser;147739;128227;19512
01.10.16;WA56;Watte, Filz, Vliesstoff usw., Tauwerk;194487;107072;87415
01.10.16;WA57;Teppiche, Fussbodenbelag aus Spinnstoff;45603;93917;-48314
01.10.16;WA58;Spezialgewebe, Spitzen, Tapisserien;43259;24347;18912
01.10.16;WA59;Getränkte, bestrichene usw. Gewebe;190565;92411;98154
01.10.16;WA60;Gewirke und Gestricke;67862;39318;28544
01.10.16;WA61;Bekleidung usw. aus Gewirken, Gestricken;689071;1477366;-788295
01.10.16;WA62;Andere Bekleidung, Bekleidungszubehör;673616;1292567;-618951
01.10.16;WA63;Andere Konfektion, Spinnstoffwaren usw.;206295;302370;-96075
01.10.16;WA64;Schuhe, Gamaschen, ähnliche Waren;434941;688587;-253646
01.10.16;WA65;Kopfbedeckungen und Teile davon;38748;51455;-12707
01.10.16;WA66;Schirme, Gehstöcke usw., Peitschen;7002;11128;-4126
01.10.16;WA67;Zugerichtete Federn, Daunen, künstliche Blumen;10957;14066;-3109
01.10.16;WA68;Waren aus Steinen, Gips, Zement usw.;361489;251328;110161
01.10.16;WA69;Keramische Waren;269212;230860;38352
01.10.16;WA70;Glas und Glaswaren;497362;431380;65982
01.10.16;WA71;Perlen, Edelsteine, Edelmetalle;993600;1223856;-230256
01.10.16;WA72;Eisen und Stahl;1609717;1781124;-171407
01.10.16;WA73;Waren aus Eisen oder Stahl;2086849;1602074;484775
01.10.16;WA74;Kupfer und Waren daraus;769649;663193;106456
01.10.16;WA75;Nickel und Waren daraus;76802;97793;-20991
01.10.16;WA76;Aluminium und Waren daraus;1152627;1232024;-79397
01.10.16;WA78;Blei und Waren daraus;33564;28491;5073
01.10.16;WA79;Zink und Waren daraus;55109;128027;-72918
01.10.16;WA80;Zinn und Waren daraus;8243;35618;-27375
01.10.16;WA81;Andere unedle Metalle, Cermets usw.;112307;123114;-10807
01.10.16;WA82;Werkzeuge, Schneidwaren, Essbestecke;649141;384806;264335
01.10.16;WA83;Verschiedene Waren aus unedlen Metallen;605415;374378;231037
01.10.16;WA84;Maschinen, Apparate, mechanische Geräte;16287329;10424747;5862582
01.10.16;WA85;Elektrotechnische Erzeugnisse;11074609;11075732;-1123
01.10.16;WA86;Schienenfahrzeuge;315367;210402;104965
01.10.16;WA87;Kraftfahrzeuge, Landfahrzeuge;18376627;8532961;9843666
01.10.16;WA88;Luftfahrzeuge, Raumfahrzeuge;3189737;1782974;1406763
01.10.16;WA89;Wasserfahrzeuge;843787;45629;798158
01.10.16;WA90;Optische, photografische usw. Erzeugnisse;4901484;2857216;2044268
01.10.16;WA91;Uhrmacherwaren;161840;179425;-17585
01.10.16;WA92;Musikinstrumente;46941;53858;-6917
01.10.16;WA93;Waffen und Munition;44922;16989;27933
01.10.16;WA94;Möbel, Beleuchtungskörper usw.;1271125;1587823;-316698
01.10.16;WA95;Spielzeug, Spiele usw., Sportgeräte;433399;687885;-254486
01.10.16;WA96;Verschiedene Waren;329915;228816;101099
01.10.16;WA97;Kunstgegenstände, Sammlungsstücke;64772;22040;42732
01.10.16;WA98;Vollständige Fabrikationsanlagen;156230;182;156048
01.10.16;WA99;Zusammenstellungen verschiedener Waren;1988017;934563;1053454
01.10.17;WA01;Lebende Tiere;134619;140296;-5677
01.10.17;WA02;Fleisch;671703;607655;64048
01.10.17;WA03;Fische, Krebs- und Weichtiere;140485;369733;-229248
01.10.17;WA04;Milch, Milcherzeugnisse, Eier, Honig;742175;727708;14467
01.10.17;WA05;Andere Waren tierischen Ursprungs;76607;85979;-9372
01.10.17;WA06;Pflanzen, Waren des Blumenhandels;75548;183147;-107599
01.10.17;WA07;Gemüse, Pflanzen für Ernährung;88829;418161;-329332
01.10.17;WA08;Geniessbare Früchte und Nüsse;164662;901261;-736599
01.10.17;WA09;Kaffee, Tee, Mate, Gewürze;252005;348404;-96399
01.10.17;WA10;Getreide;112112;189638;-77526
01.10.17;WA11;Müllereierzeugnisse, Malz usw.;136601;52017;84584
01.10.17;WA12;Ölsamen usw., Heilpflanzen usw.;78137;546622;-468485
01.10.17;WA13;Schellack, Gummen, Harz, Pflanzensaft;46243;40594;5649
01.10.17;WA14;Flechtstoffe usw. pflanzlichen Ursprungs;620;3413;-2793
01.10.17;WA15;Tierische und pflanzliche Fette, Öle, Wachs;218550;302300;-83750
01.10.17;WA16;Zubereitungen von Fleisch, Fisch usw.;265602;250435;15167
01.10.17;WA17;Zucker und Zuckerwaren;237632;131355;106277
01.10.17;WA18;Kakao und Zubereitungen aus Kakao;570495;383027;187468
01.10.17;WA19;Zubereitungen aus Getreide usw., Backwaren;589606;354505;235101
01.10.17;WA20;Zubereitungen von Gemüse, Früchten usw.;240683;424763;-184080
01.10.17;WA21;Verschiedene Lebensmittelzubereitungen;442926;241672;201254
01.10.17;WA22;Getränke, alkoholhaltige Flüssigkeiten, Essig;485524;633090;-147566
01.10.17;WA23;Rückstände der Lebensmittelindustrie, Futter;340084;316425;23659
01.10.17;WA24;Tabak;302918;198054;104864
01.10.17;WA25;Salz, Schwefel, Steine, Erden usw.;184458;161112;23346
01.10.17;WA26;Erze, Schlacken, Aschen;39353;608753;-569400
01.10.17;WA27;Mineralische Brennstoffe usw.;2046806;6831089;-4784283
01.10.17;WA28;Anorganische chemische Erzeugnisse;740847;505731;235116
01.10.17;WA29;Organische chemische Erzeugnisse;1892567;2253348;-360781
01.10.17;WA30;Pharmazeutische Erzeugnisse;5779152;3924468;1854684
01.10.17;WA31;Düngemittel;166349;90796;75553
01.10.17;WA32;Gerb- und Farbstoffe, Farben, Lacke usw.;957417;535983;421434
01.10.17;WA33;Etherische Öle, Riech-, Schönheitsmittel;793580;613782;179798
01.10.17;WA34;Seifen, Waschmittel usw.;626590;368255;258335
01.10.17;WA35;Eiweissstoffe, Klebstoffe, Enzyme;293783;176014;117769
01.10.17;WA36;Sprengstoffe, pyrotechnische Artikel usw.;25807;19087;6720
01.10.17;WA37;Photochemische Erzeugnisse;104472;72683;31789
01.10.17;WA38;Verschiedene Erzeugnisse der Chemischen Industrie;1769944;1090984;678960
01.10.17;WA39;Kunststoffe und Waren daraus;5050706;3347050;1703656
01.10.17;WA40;Kautschuk und Waren daraus;1329910;1274616;55294
01.10.17;WA41;Häute, Felle, Leder;80420;67490;12930
01.10.17;WA42;Lederwaren, Sattlerwaren;181114;330867;-149753
01.10.17;WA43;Pelzfelle, künstliches Pelzwerk;11301;12885;-1584
01.10.17;WA44;Holz, Holzwaren, Holzkohle;724011;675875;48136
01.10.17;WA45;Kork, Korkwaren;2536;6979;-4443
01.10.17;WA46;Flechtwaren, Korbmacherwaren;3615;8547;-4932
01.10.17;WA47;Halbstoffe aus Holz usw., Papierabfall;95620;335263;-239643
01.10.17;WA48;Papier, Pappe und Waren daraus;1562060;1047684;514376
01.10.17;WA49;Bücher, Zeitungen, Bilddrucke usw.;366727;221201;145526
01.10.17;WA50;Seide;4225;3925;300
01.10.17;WA51;Wolle, feine und grobe Tierhaare;41721;56606;-14885
01.10.17;WA52;Baumwolle;76641;81030;-4389
01.10.17;WA53;Andere pflanzliche Spinnstoffe, Papiergarn;3911;6035;-2124
01.10.17;WA54;Synthetisches oder künstliches Filament;160565;128970;31595
01.10.17;WA55;Synthetische oder künstliche Spinnfaser;146107;129145;16962
01.10.17;WA56;Watte, Filz, Vliesstoff usw., Tauwerk;207503;119185;88318
01.10.17;WA57;Teppiche, Fussbodenbelag aus Spinnstoff;50479;98229;-47750
01.10.17;WA58;Spezialgewebe, Spitzen, Tapisserien;47914;23532;24382
01.10.17;WA59;Getränkte, bestrichene usw. Gewebe;211182;91587;119595
01.10.17;WA60;Gewirke und Gestricke;61284;40437;20847
01.10.17;WA61;Bekleidung usw. aus Gewirken, Gestricken;819638;1443413;-623775
01.10.17;WA62;Andere Bekleidung, Bekleidungszubehör;885356;1271514;-386158
01.10.17;WA63;Andere Konfektion, Spinnstoffwaren usw.;217575;321755;-104180
01.10.17;WA64;Schuhe, Gamaschen, ähnliche Waren;475173;805291;-330118
01.10.17;WA65;Kopfbedeckungen und Teile davon;41509;52103;-10594
01.10.17;WA66;Schirme, Gehstöcke usw., Peitschen;7024;10716;-3692
01.10.17;WA67;Zugerichtete Federn, Daunen, künstliche Blumen;10775;16471;-5696
01.10.17;WA68;Waren aus Steinen, Gips, Zement usw.;402433;273252;129181
01.10.17;WA69;Keramische Waren;293999;228401;65598
01.10.17;WA70;Glas und Glaswaren;552512;445346;107166
01.10.17;WA71;Perlen, Edelsteine, Edelmetalle;1131059;1388292;-257233
01.10.17;WA72;Eisen und Stahl;2068221;2208084;-139863
01.10.17;WA73;Waren aus Eisen oder Stahl;2295228;1785813;509415
01.10.17;WA74;Kupfer und Waren daraus;944888;833113;111775
01.10.17;WA75;Nickel und Waren daraus;84434;117820;-33386
01.10.17;WA76;Aluminium und Waren daraus;1268602;1387489;-118887
01.10.17;WA78;Blei und Waren daraus;38302;40022;-1720
01.10.17;WA79;Zink und Waren daraus;68180;142335;-74155
01.10.17;WA80;Zinn und Waren daraus;10540;42785;-32245
01.10.17;WA81;Andere unedle Metalle, Cermets usw.;122772;158131;-35359
01.10.17;WA82;Werkzeuge, Schneidwaren, Essbestecke;702818;416980;285838
01.10.17;WA83;Verschiedene Waren aus unedlen Metallen;628194;406868;221326
01.10.17;WA84;Maschinen, Apparate, mechanische Geräte;18315725;11475796;6839929
01.10.17;WA85;Elektrotechnische Erzeugnisse;11321787;11510771;-188984
01.10.17;WA86;Schienenfahrzeuge;385893;223190;162703
01.10.17;WA87;Kraftfahrzeuge, Landfahrzeuge;19545769;9427142;10118627
01.10.17;WA88;Luftfahrzeuge, Raumfahrzeuge;2933324;1882357;1050967
01.10.17;WA89;Wasserfahrzeuge;405907;392615;13292
01.10.17;WA90;Optische, photografische usw. Erzeugnisse;5355051;3046278;2308773
01.10.17;WA91;Uhrmacherwaren;157427;175511;-18084
01.10.17;WA92;Musikinstrumente;51502;56816;-5314
01.10.17;WA93;Waffen und Munition;37653;19222;18431
01.10.17;WA94;Möbel, Beleuchtungskörper usw.;1362187;1594624;-232437
01.10.17;WA95;Spielzeug, Spiele usw., Sportgeräte;612349;827328;-214979
01.10.17;WA96;Verschiedene Waren;328000;232461;95539
01.10.17;WA97;Kunstgegenstände, Sammlungsstücke;84372;46229;38143
01.10.17;WA98;Vollständige Fabrikationsanlagen;115462;2;115460
01.10.17;WA99;Zusammenstellungen verschiedener Waren;1641151;951227;689924
01.10.18;WA01;Lebende Tiere;127070;108829;18241
01.10.18;WA02;Fleisch;649264;630017;19247
01.10.18;WA03;Fische, Krebs- und Weichtiere;142713;361646;-218933
01.10.18;WA04;Milch, Milcherzeugnisse, Eier, Honig;750575;708372;42203
01.10.18;WA05;Andere Waren tierischen Ursprungs;77776;88851;-11075
01.10.18;WA06;Pflanzen, Waren des Blumenhandels;81760;189534;-107774
01.10.18;WA07;Gemüse, Pflanzen für Ernährung;90250;435345;-345095
01.10.18;WA08;Geniessbare Früchte und Nüsse;152692;771547;-618855
01.10.18;WA09;Kaffee, Tee, Mate, Gewürze;236965;313150;-76185
01.10.18;WA10;Getreide;103898;265524;-161626
01.10.18;WA11;Müllereierzeugnisse, Malz usw.;140042;59613;80429
01.10.18;WA12;Ölsamen usw., Heilpflanzen usw.;111512;533819;-422307
01.10.18;WA13;Schellack, Gummen, Harz, Pflanzensaft;54901;43498;11403
01.10.18;WA14;Flechtstoffe usw. pflanzlichen Ursprungs;770;3408;-2638
01.10.18;WA15;Tierische und pflanzliche Fette, Öle, Wachs;214017;294916;-80899
01.10.18;WA16;Zubereitungen von Fleisch, Fisch usw.;265323;262225;3098
01.10.18;WA17;Zucker und Zuckerwaren;213768;134687;79081
01.10.18;WA18;Kakao und Zubereitungen aus Kakao;596065;433401;162664
01.10.18;WA19;Zubereitungen aus Getreide usw., Backwaren;590624;372514;218110
01.10.18;WA20;Zubereitungen von Gemüse, Früchten usw.;255761;443678;-187917
01.10.18;WA21;Verschiedene Lebensmittelzubereitungen;487571;295619;191952
01.10.18;WA22;Getränke, alkoholhaltige Flüssigkeiten, Essig;505763;666595;-160832
01.10.18;WA23;Rückstände der Lebensmittelindustrie, Futter;394407;337719;56688
01.10.18;WA24;Tabak;284762;230992;53770
01.10.18;WA25;Salz, Schwefel, Steine, Erden usw.;181895;169300;12595
01.10.18;WA26;Erze, Schlacken, Aschen;55612;682795;-627183
01.10.18;WA27;Mineralische Brennstoffe usw.;2508547;9060090;-6551543
01.10.18;WA28;Anorganische chemische Erzeugnisse;807231;627534;179697
01.10.18;WA29;Organische chemische Erzeugnisse;2071780;2736903;-665123
01.10.18;WA30;Pharmazeutische Erzeugnisse;6593373;4370581;2222792
01.10.18;WA31;Düngemittel;230115;75443;154672
01.10.18;WA32;Gerb- und Farbstoffe, Farben, Lacke usw.;1023041;544300;478741
01.10.18;WA33;Etherische Öle, Riech-, Schönheitsmittel;917213;687880;229333
01.10.18;WA34;Seifen, Waschmittel usw.;673242;412101;261141
01.10.18;WA35;Eiweissstoffe, Klebstoffe, Enzyme;309484;174253;135231
01.10.18;WA36;Sprengstoffe, pyrotechnische Artikel usw.;26912;23218;3694
01.10.18;WA37;Photochemische Erzeugnisse;116946;79892;37054
01.10.18;WA38;Verschiedene Erzeugnisse der Chemischen Industrie;2027733;1221830;805903
01.10.18;WA39;Kunststoffe und Waren daraus;5484782;3601645;1883137
01.10.18;WA40;Kautschuk und Waren daraus;1389105;1314263;74842
01.10.18;WA41;Häute, Felle, Leder;82877;65952;16925
01.10.18;WA42;Lederwaren, Sattlerwaren;210774;370412;-159638
01.10.18;WA43;Pelzfelle, künstliches Pelzwerk;10641;14292;-3651
01.10.18;WA44;Holz, Holzwaren, Holzkohle;764320;738694;25626
01.10.18;WA45;Kork, Korkwaren;2417;8752;-6335
01.10.18;WA46;Flechtwaren, Korbmacherwaren;3728;7982;-4254
01.10.18;WA47;Halbstoffe aus Holz usw., Papierabfall;108346;377467;-269121
01.10.18;WA48;Papier, Pappe und Waren daraus;1670563;1129924;540639
01.10.18;WA49;Bücher, Zeitungen, Bilddrucke usw.;435330;265187;170143
01.10.18;WA50;Seide;3744;3218;526
01.10.18;WA51;Wolle, feine und grobe Tierhaare;36626;52691;-16065
01.10.18;WA52;Baumwolle;74040;81821;-7781
01.10.18;WA53;Andere pflanzliche Spinnstoffe, Papiergarn;4237;6629;-2392
01.10.18;WA54;Synthetisches oder künstliches Filament;165256;138315;26941
01.10.18;WA55;Synthetische oder künstliche Spinnfaser;153093;130381;22712
01.10.18;WA56;Watte, Filz, Vliesstoff usw., Tauwerk;214914;131976;82938
01.10.18;WA57;Teppiche, Fussbodenbelag aus Spinnstoff;46955;94046;-47091
01.10.18;WA58;Spezialgewebe, Spitzen, Tapisserien;49157;24166;24991
01.10.18;WA59;Getränkte, bestrichene usw. Gewebe;225549;101676;123873
01.10.18;WA60;Gewirke und Gestricke;64664;39451;25213
01.10.18;WA61;Bekleidung usw. aus Gewirken, Gestricken;889422;1663419;-773997
01.10.18;WA62;Andere Bekleidung, Bekleidungszubehör;977240;1505434;-528194
01.10.18;WA63;Andere Konfektion, Spinnstoffwaren usw.;241174;345099;-103925
01.10.18;WA64;Schuhe, Gamaschen, ähnliche Waren;592483;953893;-361410
01.10.18;WA65;Kopfbedeckungen und Teile davon;42879;63864;-20985
01.10.18;WA66;Schirme, Gehstöcke usw., Peitschen;5466;12452;-6986
01.10.18;WA67;Zugerichtete Federn, Daunen, künstliche Blumen;14553;18420;-3867
01.10.18;WA68;Waren aus Steinen, Gips, Zement usw.;446360;303026;143334
01.10.18;WA69;Keramische Waren;336335;269724;66611
01.10.18;WA70;Glas und Glaswaren;617308;458800;158508
01.10.18;WA71;Perlen, Edelsteine, Edelmetalle;1266843;1685437;-418594
01.10.18;WA72;Eisen und Stahl;2229778;2432187;-202409
01.10.18;WA73;Waren aus Eisen oder Stahl;2526932;1934666;592266
01.10.18;WA74;Kupfer und Waren daraus;1007775;836753;171022
01.10.18;WA75;Nickel und Waren daraus;109473;150045;-40572
01.10.18;WA76;Aluminium und Waren daraus;1348950;1487842;-138892
01.10.18;WA78;Blei und Waren daraus;36886;43676;-6790
01.10.18;WA79;Zink und Waren daraus;70310;128371;-58061
01.10.18;WA80;Zinn und Waren daraus;9464;44110;-34646
01.10.18;WA81;Andere unedle Metalle, Cermets usw.;137423;167722;-30299
01.10.18;WA82;Werkzeuge, Schneidwaren, Essbestecke;809951;472534;337417
01.10.18;WA83;Verschiedene Waren aus unedlen Metallen;674825;425295;249530
01.10.18;WA84;Maschinen, Apparate, mechanische Geräte;20798157;12959824;7838333
01.10.18;WA85;Elektrotechnische Erzeugnisse;12942663;12974331;-31668
01.10.18;WA86;Schienenfahrzeuge;374546;246832;127714
01.10.18;WA87;Kraftfahrzeuge, Landfahrzeuge;19507180;10409845;9097335
01.10.18;WA88;Luftfahrzeuge, Raumfahrzeuge;2427751;1048807;1378944
01.10.18;WA89;Wasserfahrzeuge;1135973;125142;1010831
01.10.18;WA90;Optische, photografische usw. Erzeugnisse;6084478;3481653;2602825
01.10.18;WA91;Uhrmacherwaren;159993;180549;-20556
01.10.18;WA92;Musikinstrumente;63570;63217;353
01.10.18;WA93;Waffen und Munition;44291;19767;24524
01.10.18;WA94;Möbel, Beleuchtungskörper usw.;1457556;1680413;-222857
01.10.18;WA95;Spielzeug, Spiele usw., Sportgeräte;659767;961327;-301560
01.10.18;WA96;Verschiedene Waren;340333;253623;86710
01.10.18;WA97;Kunstgegenstände, Sammlungsstücke;67885;48331;19554
01.10.18;WA98;Vollständige Fabrikationsanlagen;91933;313;91620
01.10.18;WA99;Zusammenstellungen verschiedener Waren;1438469;1137366;301103
01.10.19;WA01;Lebende Tiere;118492;165257;-46765
01.10.19;WA02;Fleisch;789365;587362;202003
01.10.19;WA03;Fische, Krebs- und Weichtiere;118754;373524;-254770
01.10.19;WA04;Milch, Milcherzeugnisse, Eier, Honig;834767;716709;118058
01.10.19;WA05;Andere Waren tierischen Ursprungs;82259;81152;1107
01.10.19;WA06;Pflanzen, Waren des Blumenhandels;84503;191913;-107410
01.10.19;WA07;Gemüse, Pflanzen für Ernährung;90784;392348;-301564
01.10.19;WA08;Geniessbare Früchte und Nüsse;172547;835470;-662923
01.10.19;WA09;Kaffee, Tee, Mate, Gewürze;255289;316077;-60788
01.10.19;WA10;Getreide;115664;226244;-110580
01.10.19;WA11;Müllereierzeugnisse, Malz usw.;147409;60753;86656
01.10.19;WA12;Ölsamen usw., Heilpflanzen usw.;96740;554570;-457830
01.10.19;WA13;Schellack, Gummen, Harz, Pflanzensaft;52869;46379;6490
01.10.19;WA14;Flechtstoffe usw. pflanzlichen Ursprungs;815;3553;-2738
01.10.19;WA15;Tierische und pflanzliche Fette, Öle, Wachs;227744;313582;-85838
01.10.19;WA16;Zubereitungen von Fleisch, Fisch usw.;275658;256662;18996
01.10.19;WA17;Zucker und Zuckerwaren;226120;138741;87379
01.10.19;WA18;Kakao und Zubereitungen aus Kakao;628762;478180;150582
01.10.19;WA19;Zubereitungen aus Getreide usw., Backwaren;633321;365307;268014
01.10.19;WA20;Zubereitungen von Gemüse, Früchten usw.;262246;443559;-181313
01.10.19;WA21;Verschiedene Lebensmittelzubereitungen;510004;291165;218839
01.10.19;WA22;Getränke, alkoholhaltige Flüssigkeiten, Essig;535620;687047;-151427
01.10.19;WA23;Rückstände der Lebensmittelindustrie, Futter;390331;309426;80905
01.10.19;WA24;Tabak;271342;249712;21630
01.10.19;WA25;Salz, Schwefel, Steine, Erden usw.;187721;147546;40175
01.10.19;WA26;Erze, Schlacken, Aschen;45900;741084;-695184
01.10.19;WA27;Mineralische Brennstoffe usw.;2503569;7686805;-5183236
01.10.19;WA28;Anorganische chemische Erzeugnisse;889809;554881;334928
01.10.19;WA29;Organische chemische Erzeugnisse;2105664;3092549;-986885
01.10.19;WA30;Pharmazeutische Erzeugnisse;7388276;4845570;2542706
01.10.19;WA31;Düngemittel;156818;70376;86442
01.10.19;WA32;Gerb- und Farbstoffe, Farben, Lacke usw.;1031030;506517;524513
01.10.19;WA33;Etherische Öle, Riech-, Schönheitsmittel;970031;662649;307382
01.10.19;WA34;Seifen, Waschmittel usw.;693396;401476;291920
01.10.19;WA35;Eiweissstoffe, Klebstoffe, Enzyme;311098;191732;119366
01.10.19;WA36;Sprengstoffe, pyrotechnische Artikel usw.;24137;32456;-8319
01.10.19;WA37;Photochemische Erzeugnisse;101917;82409;19508
01.10.19;WA38;Verschiedene Erzeugnisse der Chemischen Industrie;1983602;1189544;794058
01.10.19;WA39;Kunststoffe und Waren daraus;5401973;3420496;1981477
01.10.19;WA40;Kautschuk und Waren daraus;1329578;1276350;53228
01.10.19;WA41;Häute, Felle, Leder;64696;59316;5380
01.10.19;WA42;Lederwaren, Sattlerwaren;221021;379373;-158352
01.10.19;WA43;Pelzfelle, künstliches Pelzwerk;13002;16186;-3184
01.10.19;WA44;Holz, Holzwaren, Holzkohle;795955;686343;109612
01.10.19;WA45;Kork, Korkwaren;2760;10241;-7481
01.10.19;WA46;Flechtwaren, Korbmacherwaren;3410;8396;-4986
01.10.19;WA47;Halbstoffe aus Holz usw., Papierabfall;91691;284360;-192669
01.10.19;WA48;Papier, Pappe und Waren daraus;1645337;1087316;558021
01.10.19;WA49;Bücher, Zeitungen, Bilddrucke usw.;383363;243273;140090
01.10.19;WA50;Seide;2946;2946;0
01.10.19;WA51;Wolle, feine und grobe Tierhaare;36445;43352;-6907
01.10.19;WA52;Baumwolle;69658;75169;-5511
01.10.19;WA53;Andere pflanzliche Spinnstoffe, Papiergarn;4405;7340;-2935
01.10.19;WA54;Synthetisches oder künstliches Filament;156564;122046;34518
01.10.19;WA55;Synthetische oder künstliche Spinnfaser;147645;119145;28500
01.10.19;WA56;Watte, Filz, Vliesstoff usw., Tauwerk;222061;127586;94475
01.10.19;WA57;Teppiche, Fussbodenbelag aus Spinnstoff;50615;97712;-47097
01.10.19;WA58;Spezialgewebe, Spitzen, Tapisserien;48566;23108;25458
01.10.19;WA59;Getränkte, bestrichene usw. Gewebe;210986;98018;112968
01.10.19;WA60;Gewirke und Gestricke;65120;38394;26726
01.10.19;WA61;Bekleidung usw. aus Gewirken, Gestricken;975583;1656128;-680545
01.10.19;WA62;Andere Bekleidung, Bekleidungszubehör;1038865;1485451;-446586
01.10.19;WA63;Andere Konfektion, Spinnstoffwaren usw.;258016;367780;-109764
01.10.19;WA64;Schuhe, Gamaschen, ähnliche Waren;656042;996881;-340839
01.10.19;WA65;Kopfbedeckungen und Teile davon;51164;65494;-14330
01.10.19;WA66;Schirme, Gehstöcke usw., Peitschen;8014;13471;-5457
01.10.19;WA67;Zugerichtete Federn, Daunen, künstliche Blumen;15125;24418;-9293
01.10.19;WA68;Waren aus Steinen, Gips, Zement usw.;436381;299896;136485
01.10.19;WA69;Keramische Waren;333517;256060;77457
01.10.19;WA70;Glas und Glaswaren;600675;461873;138802
01.10.19;WA71;Perlen, Edelsteine, Edelmetalle;1426143;1850974;-424831
01.10.19;WA72;Eisen und Stahl;1896958;2031213;-134255
01.10.19;WA73;Waren aus Eisen oder Stahl;2487117;1847646;639471
01.10.19;WA74;Kupfer und Waren daraus;900141;916077;-15936
01.10.19;WA75;Nickel und Waren daraus;123537;150163;-26626
01.10.19;WA76;Aluminium und Waren daraus;1296502;1363750;-67248
01.10.19;WA78;Blei und Waren daraus;39737;40963;-1226
01.10.19;WA79;Zink und Waren daraus;67820;119569;-51749
01.10.19;WA80;Zinn und Waren daraus;7524;29172;-21648
01.10.19;WA81;Andere unedle Metalle, Cermets usw.;121086;149022;-27936
01.10.19;WA82;Werkzeuge, Schneidwaren, Essbestecke;722318;450794;271524
01.10.19;WA83;Verschiedene Waren aus unedlen Metallen;688054;439176;248878
01.10.19;WA84;Maschinen, Apparate, mechanische Geräte;20610488;12773538;7836950
01.10.19;WA85;Elektrotechnische Erzeugnisse;12867041;12674007;193034
01.10.19;WA86;Schienenfahrzeuge;387381;293390;93991
01.10.19;WA87;Kraftfahrzeuge, Landfahrzeuge;19638859;11208069;8430790
01.10.19;WA88;Luftfahrzeuge, Raumfahrzeuge;4079220;1893217;2186003
01.10.19;WA89;Wasserfahrzeuge;1036052;146318;889734
01.10.19;WA90;Optische, photografische usw. Erzeugnisse;6300295;3536904;2763391
01.10.19;WA91;Uhrmacherwaren;154523;217274;-62751
01.10.19;WA92;Musikinstrumente;67194;74205;-7011
01.10.19;WA93;Waffen und Munition;38564;23878;14686
01.10.19;WA94;Möbel, Beleuchtungskörper usw.;1465152;1737013;-271861
01.10.19;WA95;Spielzeug, Spiele usw., Sportgeräte;636545;867239;-230694
01.10.19;WA96;Verschiedene Waren;363899;258350;105549
01.10.19;WA97;Kunstgegenstände, Sammlungsstücke;89552;46314;43238
01.10.19;WA98;Vollständige Fabrikationsanlagen;87124;98;87026
01.10.19;WA99;Zusammenstellungen verschiedener Waren;1508280;1159454;348826
01.10.20;WA01;Lebende Tiere;102724;95613;7111
01.10.20;WA02;Fleisch;563947;516159;47788
01.10.20;WA03;Fische, Krebs- und Weichtiere;121181;334128;-212947
01.10.20;WA04;Milch, Milcherzeugnisse, Eier, Honig;764146;720493;43653
01.10.20;WA05;Andere Waren tierischen Ursprungs;72706;71448;1258
01.10.20;WA06;Pflanzen, Waren des Blumenhandels;79332;212650;-133318
01.10.20;WA07;Gemüse, Pflanzen für Ernährung;99135;465430;-366295
01.10.20;WA08;Geniessbare Früchte und Nüsse;166197;864579;-698382
01.10.20;WA09;Kaffee, Tee, Mate, Gewürze;250822;333289;-82467
01.10.20;WA10;Getreide;172093;250142;-78049
01.10.20;WA11;Müllereierzeugnisse, Malz usw.;137943;57776;80167
01.10.20;WA12;Ölsamen usw., Heilpflanzen usw.;98036;528667;-430631
01.10.20;WA13;Schellack, Gummen, Harz, Pflanzensaft;52777;45202;7575
01.10.20;WA14;Flechtstoffe usw. pflanzlichen Ursprungs;814;4996;-4182
01.10.20;WA15;Tierische und pflanzliche Fette, Öle, Wachs;245049;296313;-51264
01.10.20;WA16;Zubereitungen von Fleisch, Fisch usw.;261579;276160;-14581
01.10.20;WA17;Zucker und Zuckerwaren;225516;137409;88107
01.10.20;WA18;Kakao und Zubereitungen aus Kakao;574749;456539;118210
01.10.20;WA19;Zubereitungen aus Getreide usw., Backwaren;623420;366782;256638
01.10.20;WA20;Zubereitungen von Gemüse, Früchten usw.;237873;457872;-219999
01.10.20;WA21;Verschiedene Lebensmittelzubereitungen;502434;327398;175036
01.10.20;WA22;Getränke, alkoholhaltige Flüssigkeiten, Essig;484301;690985;-206684
01.10.20;WA23;Rückstände der Lebensmittelindustrie, Futter;442549;346686;95863
01.10.20;WA24;Tabak;212081;255985;-43904
01.10.20;WA25;Salz, Schwefel, Steine, Erden usw.;176691;139942;36749
01.10.20;WA26;Erze, Schlacken, Aschen;39194;970789;-931595
01.10.20;WA27;Mineralische Brennstoffe usw.;1951425;5574929;-3623504
01.10.20;WA28;Anorganische chemische Erzeugnisse;934535;463288;471247
01.10.20;WA29;Organische chemische Erzeugnisse;1813897;2569293;-755396
01.10.20;WA30;Pharmazeutische Erzeugnisse;7239418;5105087;2134331
01.10.20;WA31;Düngemittel;156591;77553;79038
01.10.20;WA32;Gerb- und Farbstoffe, Farben, Lacke usw.;977592;508234;469358
01.10.20;WA33;Etherische Öle, Riech-, Schönheitsmittel;846658;595981;250677
01.10.20;WA34;Seifen, Waschmittel usw.;686127;383760;302367
01.10.20;WA35;Eiweissstoffe, Klebstoffe, Enzyme;325665;181772;143893
01.10.20;WA36;Sprengstoffe, pyrotechnische Artikel usw.;25352;14455;10897
01.10.20;WA37;Photochemische Erzeugnisse;95356;65538;29818
01.10.20;WA38;Verschiedene Erzeugnisse der Chemischen Industrie;2105456;1308608;796848
01.10.20;WA39;Kunststoffe und Waren daraus;5092474;3129991;1962483
01.10.20;WA40;Kautschuk und Waren daraus;1302298;1212572;89726
01.10.20;WA41;Häute, Felle, Leder;46556;35558;10998
01.10.20;WA42;Lederwaren, Sattlerwaren;189606;314861;-125255
01.10.20;WA43;Pelzfelle, künstliches Pelzwerk;7096;10343;-3247
01.10.20;WA44;Holz, Holzwaren, Holzkohle;836128;675049;161079
01.10.20;WA45;Kork, Korkwaren;1903;8556;-6653
01.10.20;WA46;Flechtwaren, Korbmacherwaren;4332;9742;-5410
01.10.20;WA47;Halbstoffe aus Holz usw., Papierabfall;76768;245074;-168306
01.10.20;WA48;Papier, Pappe und Waren daraus;1461531;944356;517175
01.10.20;WA49;Bücher, Zeitungen, Bilddrucke usw.;340052;242227;97825
01.10.20;WA50;Seide;1726;1873;-147
01.10.20;WA51;Wolle, feine und grobe Tierhaare;26258;35588;-9330
01.10.20;WA52;Baumwolle;57341;60121;-2780
01.10.20;WA53;Andere pflanzliche Spinnstoffe, Papiergarn;3306;6645;-3339
01.10.20;WA54;Synthetisches oder künstliches Filament;124228;108392;15836
01.10.20;WA55;Synthetische oder künstliche Spinnfaser;134645;108536;26109
01.10.20;WA56;Watte, Filz, Vliesstoff usw., Tauwerk;216606;126022;90584
01.10.20;WA57;Teppiche, Fussbodenbelag aus Spinnstoff;52927;107720;-54793
01.10.20;WA58;Spezialgewebe, Spitzen, Tapisserien;45630;21622;24008
01.10.20;WA59;Getränkte, bestrichene usw. Gewebe;204058;89809;114249
01.10.20;WA60;Gewirke und Gestricke;55671;37747;17924
01.10.20;WA61;Bekleidung usw. aus Gewirken, Gestricken;982145;1697642;-715497
01.10.20;WA62;Andere Bekleidung, Bekleidungszubehör;995686;1431004;-435318
01.10.20;WA63;Andere Konfektion, Spinnstoffwaren usw.;323198;555616;-232418
01.10.20;WA64;Schuhe, Gamaschen, ähnliche Waren;654611;928202;-273591
01.10.20;WA65;Kopfbedeckungen und Teile davon;52461;66320;-13859
01.10.20;WA66;Schirme, Gehstöcke usw., Peitschen;7020;11483;-4463
01.10.20;WA67;Zugerichtete Federn, Daunen, künstliche Blumen;17209;19160;-1951
01.10.20;WA68;Waren aus Steinen, Gips, Zement usw.;424390;292672;131718
01.10.20;WA69;Keramische Waren;312020;240967;71053
01.10.20;WA70;Glas und Glaswaren;588701;432281;156420
01.10.20;WA71;Perlen, Edelsteine, Edelmetalle;1808374;2336522;-528148
01.10.20;WA72;Eisen und Stahl;1766985;1685936;81049
01.10.20;WA73;Waren aus Eisen oder Stahl;2217297;1725781;491516
01.10.20;WA74;Kupfer und Waren daraus;932100;850239;81861
01.10.20;WA75;Nickel und Waren daraus;104708;122023;-17315
01.10.20;WA76;Aluminium und Waren daraus;1177522;1201715;-24193
01.10.20;WA78;Blei und Waren daraus;31752;35497;-3745
01.10.20;WA79;Zink und Waren daraus;60718;99307;-38589
01.10.20;WA80;Zinn und Waren daraus;8509;26500;-17991
01.10.20;WA81;Andere unedle Metalle, Cermets usw.;88625;113276;-24651
01.10.20;WA82;Werkzeuge, Schneidwaren, Essbestecke;677826;432897;244929
01.10.20;WA83;Verschiedene Waren aus unedlen Metallen;684185;440570;243615
01.10.20;WA84;Maschinen, Apparate, mechanische Geräte;18676584;11898097;6778487
01.10.20;WA85;Elektrotechnische Erzeugnisse;12393429;12497401;-103972
01.10.20;WA86;Schienenfahrzeuge;428689;227588;201101
01.10.20;WA87;Kraftfahrzeuge, Landfahrzeuge;20361442;11236075;9125367
01.10.20;WA88;Luftfahrzeuge, Raumfahrzeuge;2320473;678916;1641557
01.10.20;WA89;Wasserfahrzeuge;152578;32482;120096
01.10.20;WA90;Optische, photografische usw. Erzeugnisse;5789452;3361583;2427869
01.10.20;WA91;Uhrmacherwaren;151781;211406;-59625
01.10.20;WA92;Musikinstrumente;62539;69512;-6973
01.10.20;WA93;Waffen und Munition;46312;19978;26334
01.10.20;WA94;Möbel, Beleuchtungskörper usw.;1415580;1780345;-364765
01.10.20;WA95;Spielzeug, Spiele usw., Sportgeräte;627460;886734;-259274
01.10.20;WA96;Verschiedene Waren;339473;258938;80535
01.10.20;WA97;Kunstgegenstände, Sammlungsstücke;50475;39346;11129
01.10.20;WA98;Vollständige Fabrikationsanlagen;76377;838;75539
01.10.20;WA99;Zusammenstellungen verschiedener Waren;1238201;994212;243989
01.10.21;WA01;Lebende Tiere;117410;88824;28586
01.10.21;WA02;Fleisch;539870;605464;-65594
01.10.21;WA03;Fische, Krebs- und Weichtiere;137459;353255;-215796
01.10.21;WA04;Milch, Milcherzeugnisse, Eier, Honig;835387;784283;51104
01.10.21;WA05;Andere Waren tierischen Ursprungs;75353;94406;-19053
01.10.21;WA06;Pflanzen, Waren des Blumenhandels;93026;234879;-141853
01.10.21;WA07;Gemüse, Pflanzen für Ernährung;118823;496515;-377692
01.10.21;WA08;Geniessbare Früchte und Nüsse;158791;921921;-763130
01.10.21;WA09;Kaffee, Tee, Mate, Gewürze;288199;409541;-121342
01.10.21;WA10;Getreide;230782;273376;-42594
01.10.21;WA11;Müllereierzeugnisse, Malz usw.;154217;68111;86106
01.10.21;WA12;Ölsamen usw., Heilpflanzen usw.;112218;579551;-467333
01.10.21;WA13;Schellack, Gummen, Harz, Pflanzensaft;57160;48561;8599
01.10.21;WA14;Flechtstoffe usw. pflanzlichen Ursprungs;1164;4978;-3814
01.10.21;WA15;Tierische und pflanzliche Fette, Öle, Wachs;330132;427765;-97633
01.10.21;WA16;Zubereitungen von Fleisch, Fisch usw.;270106;264683;5423
01.10.21;WA17;Zucker und Zuckerwaren;249181;145079;104102
01.10.21;WA18;Kakao und Zubereitungen aus Kakao;621771;399723;222048
01.10.21;WA19;Zubereitungen aus Getreide usw., Backwaren;638140;423388;214752
01.10.21;WA20;Zubereitungen von Gemüse, Früchten usw.;259906;466310;-206404
01.10.21;WA21;Verschiedene Lebensmittelzubereitungen;529550;340090;189460
01.10.21;WA22;Getränke, alkoholhaltige Flüssigkeiten, Essig;561703;734809;-173106
01.10.21;WA23;Rückstände der Lebensmittelindustrie, Futter;492959;402088;90871
01.10.21;WA24;Tabak;216117;239298;-23181
01.10.21;WA25;Salz, Schwefel, Steine, Erden usw.;192257;151034;41223
01.10.21;WA26;Erze, Schlacken, Aschen;88728;1106594;-1017866
01.10.21;WA27;Mineralische Brennstoffe usw.;3133073;10911689;-7778616
01.10.21;WA28;Anorganische chemische Erzeugnisse;991471;565060;426411
01.10.21;WA29;Organische chemische Erzeugnisse;2413062;2477092;-64030
01.10.21;WA30;Pharmazeutische Erzeugnisse;8260068;6698473;1561595
01.10.21;WA31;Düngemittel;274177;109919;164258
01.10.21;WA32;Gerb- und Farbstoffe, Farben, Lacke usw.;996464;471841;524623
01.10.21;WA33;Etherische Öle, Riech-, Schönheitsmittel;939906;648796;291110
01.10.21;WA34;Seifen, Waschmittel usw.;712270;423806;288464
01.10.21;WA35;Eiweissstoffe, Klebstoffe, Enzyme;359604;211900;147704
01.10.21;WA36;Sprengstoffe, pyrotechnische Artikel usw.;23026;19338;3688
01.10.21;WA37;Photochemische Erzeugnisse;95938;50175;45763
01.10.21;WA38;Verschiedene Erzeugnisse der Chemischen Industrie;2325632;1422251;903381
01.10.21;WA39;Kunststoffe und Waren daraus;5974987;4225645;1749342
01.10.21;WA40;Kautschuk und Waren daraus;1341105;1369564;-28459
01.10.21;WA41;Häute, Felle, Leder;53959;46687;7272
01.10.21;WA42;Lederwaren, Sattlerwaren;215909;346903;-130994
01.10.21;WA43;Pelzfelle, künstliches Pelzwerk;7597;10223;-2626
01.10.21;WA44;Holz, Holzwaren, Holzkohle;1046955;919036;127919
01.10.21;WA45;Kork, Korkwaren;2480;10442;-7962
01.10.21;WA46;Flechtwaren, Korbmacherwaren;5042;13408;-8366
01.10.21;WA47;Halbstoffe aus Holz usw., Papierabfall;113870;390769;-276899
01.10.21;WA48;Papier, Pappe und Waren daraus;1745417;1132242;613175
01.10.21;WA49;Bücher, Zeitungen, Bilddrucke usw.;367267;261802;105465
01.10.21;WA50;Seide;1111;2217;-1106
01.10.21;WA51;Wolle, feine und grobe Tierhaare;35027;44229;-9202
01.10.21;WA52;Baumwolle;60185;63748;-3563
01.10.21;WA53;Andere pflanzliche Spinnstoffe, Papiergarn;3947;6878;-2931
01.10.21;WA54;Synthetisches oder künstliches Filament;131602;119633;11969
01.10.21;WA55;Synthetische oder künstliche Spinnfaser;135497;115621;19876
01.10.21;WA56;Watte, Filz, Vliesstoff usw., Tauwerk;220060;148023;72037
01.10.21;WA57;Teppiche, Fussbodenbelag aus Spinnstoff;46325;106899;-60574
01.10.21;WA58;Spezialgewebe, Spitzen, Tapisserien;43515;23383;20132
01.10.21;WA59;Getränkte, bestrichene usw. Gewebe;204073;101982;102091
01.10.21;WA60;Gewirke und Gestricke;57596;38769;18827
01.10.21;WA61;Bekleidung usw. aus Gewirken, Gestricken;1147461;1950075;-802614
01.10.21;WA62;Andere Bekleidung, Bekleidungszubehör;1030937;1556980;-526043
01.10.21;WA63;Andere Konfektion, Spinnstoffwaren usw.;284742;468987;-184245
01.10.21;WA64;Schuhe, Gamaschen, ähnliche Waren;701871;988344;-286473
01.10.21;WA65;Kopfbedeckungen und Teile davon;54171;82073;-27902
01.10.21;WA66;Schirme, Gehstöcke usw., Peitschen;6935;16955;-10020
01.10.21;WA67;Zugerichtete Federn, Daunen, künstliche Blumen;17090;29523;-12433
01.10.21;WA68;Waren aus Steinen, Gips, Zement usw.;436880;316188;120692
01.10.21;WA69;Keramische Waren;327717;292607;35110
01.10.21;WA70;Glas und Glaswaren;599550;460203;139347
01.10.21;WA71;Perlen, Edelsteine, Edelmetalle;1760696;2318258;-557562
01.10.21;WA72;Eisen und Stahl;2591949;3076656;-484707
01.10.21;WA73;Waren aus Eisen oder Stahl;2511110;2268429;242681
01.10.21;WA74;Kupfer und Waren daraus;1245119;1127171;117948
01.10.21;WA75;Nickel und Waren daraus;114165;153374;-39209
01.10.21;WA76;Aluminium und Waren daraus;1467790;1720232;-252442
01.10.21;WA78;Blei und Waren daraus;35559;49106;-13547
01.10.21;WA79;Zink und Waren daraus;69416;119069;-49653
01.10.21;WA80;Zinn und Waren daraus;13599;54222;-40623
01.10.21;WA81;Andere unedle Metalle, Cermets usw.;115577;148514;-32937
01.10.21;WA82;Werkzeuge, Schneidwaren, Essbestecke;780187;499170;281017
01.10.21;WA83;Verschiedene Waren aus unedlen Metallen;666141;460213;205928
01.10.21;WA84;Maschinen, Apparate, mechanische Geräte;19232124;12949136;6282988
01.10.21;WA85;Elektrotechnische Erzeugnisse;12964271;13724819;-760548
01.10.21;WA86;Schienenfahrzeuge;338395;210433;127962
01.10.21;WA87;Kraftfahrzeuge, Landfahrzeuge;18855828;9660229;9195599
01.10.21;WA88;Luftfahrzeuge, Raumfahrzeuge;2026515;1155627;870888
01.10.21;WA89;Wasserfahrzeuge;1163698;275057;888641
01.10.21;WA90;Optische, photografische usw. Erzeugnisse;5991023;3476831;2514192
01.10.21;WA91;Uhrmacherwaren;173129;221541;-48412
01.10.21;WA92;Musikinstrumente;69647;75931;-6284
01.10.21;WA93;Waffen und Munition;59941;26924;33017
01.10.21;WA94;Möbel, Beleuchtungskörper usw.;1461813;1969600;-507787
01.10.21;WA95;Spielzeug, Spiele usw., Sportgeräte;653478;1104049;-450571
01.10.21;WA96;Verschiedene Waren;358215;292791;65424
01.10.21;WA97;Kunstgegenstände, Sammlungsstücke;59203;49532;9671
01.10.21;WA98;Vollständige Fabrikationsanlagen;44155;NULL;#WERT!
01.10.21;WA99;Zusammenstellungen verschiedener Waren;1410926;996508;414418
01.10.22;WA01;Lebende Tiere;121464;111527;9937
01.10.22;WA02;Fleisch;638614;710842;-72228
01.10.22;WA03;Fische, Krebs- und Weichtiere;158709;463117;-304408
01.10.22;WA04;Milch, Milcherzeugnisse, Eier, Honig;1066540;970507;96033
01.10.22;WA05;Andere Waren tierischen Ursprungs;85197;115263;-30066
01.10.22;WA06;Pflanzen, Waren des Blumenhandels;85372;214010;-128638
01.10.22;WA07;Gemüse, Pflanzen für Ernährung;116701;556237;-439536
01.10.22;WA08;Geniessbare Früchte und Nüsse;169169;875802;-706633
01.10.22;WA09;Kaffee, Tee, Mate, Gewürze;335604;569685;-234081
01.10.22;WA10;Getreide;294428;370899;-76471
01.10.22;WA11;Müllereierzeugnisse, Malz usw.;195608;82884;112724
01.10.22;WA12;Ölsamen usw., Heilpflanzen usw.;108860;800020;-691160
01.10.22;WA13;Schellack, Gummen, Harz, Pflanzensaft;61326;62196;-870
01.10.22;WA14;Flechtstoffe usw. pflanzlichen Ursprungs;1034;4780;-3746
01.10.22;WA15;Tierische und pflanzliche Fette, Öle, Wachs;426295;537244;-110949
01.10.22;WA16;Zubereitungen von Fleisch, Fisch usw.;300162;338613;-38451
01.10.22;WA17;Zucker und Zuckerwaren;327471;173069;154402
01.10.22;WA18;Kakao und Zubereitungen aus Kakao;658415;444652;213763
01.10.22;WA19;Zubereitungen aus Getreide usw., Backwaren;744602;503570;241032
01.10.22;WA20;Zubereitungen von Gemüse, Früchten usw.;271843;518689;-246846
01.10.22;WA21;Verschiedene Lebensmittelzubereitungen;635281;400196;235085
01.10.22;WA22;Getränke, alkoholhaltige Flüssigkeiten, Essig;577978;835223;-257245
01.10.22;WA23;Rückstände der Lebensmittelindustrie, Futter;594473;471782;122691
01.10.22;WA24;Tabak;241129;264910;-23781
01.10.22;WA25;Salz, Schwefel, Steine, Erden usw.;201143;179501;21642
01.10.22;WA26;Erze, Schlacken, Aschen;81220;1024761;-943541
01.10.22;WA27;Mineralische Brennstoffe usw.;4394232;15347361;-10953129
01.10.22;WA28;Anorganische chemische Erzeugnisse;1539310;1010887;528423
01.10.22;WA29;Organische chemische Erzeugnisse;2370529;3132664;-762135
01.10.22;WA30;Pharmazeutische Erzeugnisse;10240226;6984629;3255597
01.10.22;WA31;Düngemittel;424636;279598;145038
01.10.22;WA32;Gerb- und Farbstoffe, Farben, Lacke usw.;979505;505214;474291
01.10.22;WA33;Etherische Öle, Riech-, Schönheitsmittel;1010723;712259;298464
01.10.22;WA34;Seifen, Waschmittel usw.;784981;530826;254155
01.10.22;WA35;Eiweissstoffe, Klebstoffe, Enzyme;403606;262952;140654
01.10.22;WA36;Sprengstoffe, pyrotechnische Artikel usw.;28326;22049;6277
01.10.22;WA37;Photochemische Erzeugnisse;91079;56058;35021
01.10.22;WA38;Verschiedene Erzeugnisse der Chemischen Industrie;2761095;1933959;827136
01.10.22;WA39;Kunststoffe und Waren daraus;6100362;4401989;1698373
01.10.22;WA40;Kautschuk und Waren daraus;1474721;1546398;-71677
01.10.22;WA41;Häute, Felle, Leder;54194;41918;12276
01.10.22;WA42;Lederwaren, Sattlerwaren;256023;461077;-205054
01.10.22;WA43;Pelzfelle, künstliches Pelzwerk;9449;13401;-3952
01.10.22;WA44;Holz, Holzwaren, Holzkohle;990815;877780;113035
01.10.22;WA45;Kork, Korkwaren;2011;7711;-5700
01.10.22;WA46;Flechtwaren, Korbmacherwaren;5327;14402;-9075
01.10.22;WA47;Halbstoffe aus Holz usw., Papierabfall;130243;442802;-312559
01.10.22;WA48;Papier, Pappe und Waren daraus;2050909;1390568;660341
01.10.22;WA49;Bücher, Zeitungen, Bilddrucke usw.;351033;282016;69017
01.10.22;WA50;Seide;1665;2754;-1089
01.10.22;WA51;Wolle, feine und grobe Tierhaare;42568;49066;-6498
01.10.22;WA52;Baumwolle;63215;75663;-12448
01.10.22;WA53;Andere pflanzliche Spinnstoffe, Papiergarn;4131;9518;-5387
01.10.22;WA54;Synthetisches oder künstliches Filament;146240;140016;6224
01.10.22;WA55;Synthetische oder künstliche Spinnfaser;134092;140357;-6265
01.10.22;WA56;Watte, Filz, Vliesstoff usw., Tauwerk;223332;155588;67744
01.10.22;WA57;Teppiche, Fussbodenbelag aus Spinnstoff;50309;98985;-48676
01.10.22;WA58;Spezialgewebe, Spitzen, Tapisserien;46461;24497;21964
01.10.22;WA59;Getränkte, bestrichene usw. Gewebe;218650;117425;101225
01.10.22;WA60;Gewirke und Gestricke;61545;41510;20035
01.10.22;WA61;Bekleidung usw. aus Gewirken, Gestricken;1203252;2332403;-1129151
01.10.22;WA62;Andere Bekleidung, Bekleidungszubehör;1098785;1928970;-830185
01.10.22;WA63;Andere Konfektion, Spinnstoffwaren usw.;287720;486993;-199273
01.10.22;WA64;Schuhe, Gamaschen, ähnliche Waren;879935;1365426;-485491
01.10.22;WA65;Kopfbedeckungen und Teile davon;68008;102264;-34256
01.10.22;WA66;Schirme, Gehstöcke usw., Peitschen;11985;20233;-8248
01.10.22;WA67;Zugerichtete Federn, Daunen, künstliche Blumen;17702;32310;-14608
01.10.22;WA68;Waren aus Steinen, Gips, Zement usw.;472992;324414;148578
01.10.22;WA69;Keramische Waren;366276;305253;61023
01.10.22;WA70;Glas und Glaswaren;697227;510402;186825
01.10.22;WA71;Perlen, Edelsteine, Edelmetalle;1986154;3068443;-1082289
01.10.22;WA72;Eisen und Stahl;2707305;2996909;-289604
01.10.22;WA73;Waren aus Eisen oder Stahl;2684140;2643786;40354
01.10.22;WA74;Kupfer und Waren daraus;1174198;1038814;135384
01.10.22;WA75;Nickel und Waren daraus;159857;184810;-24953
01.10.22;WA76;Aluminium und Waren daraus;1629215;2080505;-451290
01.10.22;WA78;Blei und Waren daraus;29913;45733;-15820
01.10.22;WA79;Zink und Waren daraus;74265;156463;-82198
01.10.22;WA80;Zinn und Waren daraus;11119;45538;-34419
01.10.22;WA81;Andere unedle Metalle, Cermets usw.;151576;192916;-41340
01.10.22;WA82;Werkzeuge, Schneidwaren, Essbestecke;759749;551730;208019
01.10.22;WA83;Verschiedene Waren aus unedlen Metallen;674245;501526;172719
01.10.22;WA84;Maschinen, Apparate, mechanische Geräte;20090756;14701711;5389045
01.10.22;WA85;Elektrotechnische Erzeugnisse;14762850;18732197;-3969347
01.10.22;WA86;Schienenfahrzeuge;205124;259560;-54436
01.10.22;WA87;Kraftfahrzeuge, Landfahrzeuge;22612026;11931261;10680765
01.10.22;WA88;Luftfahrzeuge, Raumfahrzeuge;2833188;1034773;1798415
01.10.22;WA89;Wasserfahrzeuge;576524;111850;464674
01.10.22;WA90;Optische, photografische usw. Erzeugnisse;6194951;3950864;2244087
01.10.22;WA91;Uhrmacherwaren;175679;285122;-109443
01.10.22;WA92;Musikinstrumente;88609;75429;13180
01.10.22;WA93;Waffen und Munition;54347;42886;11461
01.10.22;WA94;Möbel, Beleuchtungskörper usw.;1521339;1918162;-396823
01.10.22;WA95;Spielzeug, Spiele usw., Sportgeräte;752152;1163277;-411125
01.10.22;WA96;Verschiedene Waren;375934;321806;54128
01.10.22;WA97;Kunstgegenstände, Sammlungsstücke;251696;51047;200649
01.10.22;WA98;Vollständige Fabrikationsanlagen;48591;NULL;#WERT!
01.10.22;WA99;Zusammenstellungen verschiedener Waren;2036197;970132;1066065
01.10.23;WA01;Lebende Tiere;148998;147427;1571
01.10.23;WA02;Fleisch;640503;688434;-47931
01.10.23;WA03;Fische, Krebs- und Weichtiere;123786;373146;-249360
01.10.23;WA04;Milch, Milcherzeugnisse, Eier, Honig;994871;897256;97615
01.10.23;WA05;Andere Waren tierischen Ursprungs;71201;88077;-16876
01.10.23;WA06;Pflanzen, Waren des Blumenhandels;79062;194578;-115516
01.10.23;WA07;Gemüse, Pflanzen für Ernährung;133653;571634;-437981
01.10.23;WA08;Geniessbare Früchte und Nüsse;183361;965623;-782262
01.10.23;WA09;Kaffee, Tee, Mate, Gewürze;330766;383073;-52307
01.10.23;WA10;Getreide;236793;315076;-78283
01.10.23;WA11;Müllereierzeugnisse, Malz usw.;211099;89134;121965
01.10.23;WA12;Ölsamen usw., Heilpflanzen usw.;110960;599243;-488283
01.10.23;WA13;Schellack, Gummen, Harz, Pflanzensaft;44709;44098;611
01.10.23;WA14;Flechtstoffe usw. pflanzlichen Ursprungs;912;3043;-2131
01.10.23;WA15;Tierische und pflanzliche Fette, Öle, Wachs;338596;438260;-99664
01.10.23;WA16;Zubereitungen von Fleisch, Fisch usw.;316634;328672;-12038
01.10.23;WA17;Zucker und Zuckerwaren;348501;212414;136087
01.10.23;WA18;Kakao und Zubereitungen aus Kakao;772693;564908;207785
01.10.23;WA19;Zubereitungen aus Getreide usw., Backwaren;834642;584745;249897
01.10.23;WA20;Zubereitungen von Gemüse, Früchten usw.;292991;569161;-276170
01.10.23;WA21;Verschiedene Lebensmittelzubereitungen;687386;423755;263631
01.10.23;WA22;Getränke, alkoholhaltige Flüssigkeiten, Essig;634406;772304;-137898
01.10.23;WA23;Rückstände der Lebensmittelindustrie, Futter;591474;458176;133298
01.10.23;WA24;Tabak;250844;521110;-270266
01.10.23;WA25;Salz, Schwefel, Steine, Erden usw.;206024;152166;53858
01.10.23;WA26;Erze, Schlacken, Aschen;52519;911155;-858636
01.10.23;WA27;Mineralische Brennstoffe usw.;2731167;10232801;-7501634
01.10.23;WA28;Anorganische chemische Erzeugnisse;983459;618717;364742
01.10.23;WA29;Organische chemische Erzeugnisse;2057175;3304845;-1247670
01.10.23;WA30;Pharmazeutische Erzeugnisse;8989131;5667812;3321319
01.10.23;WA31;Düngemittel;249763;94264;155499
01.10.23;WA32;Gerb- und Farbstoffe, Farben, Lacke usw.;974966;468943;506023
01.10.23;WA33;Etherische Öle, Riech-, Schönheitsmittel;1104902;750631;354271
01.10.23;WA34;Seifen, Waschmittel usw.;743886;473318;270568
01.10.23;WA35;Eiweissstoffe, Klebstoffe, Enzyme;364023;229751;134272
01.10.23;WA36;Sprengstoffe, pyrotechnische Artikel usw.;32258;27521;4737
01.10.23;WA37;Photochemische Erzeugnisse;85619;57414;28205
01.10.23;WA38;Verschiedene Erzeugnisse der Chemischen Industrie;2797150;1623799;1173351
01.10.23;WA39;Kunststoffe und Waren daraus;5622418;3694959;1927459
01.10.23;WA40;Kautschuk und Waren daraus;1488853;1416913;71940
01.10.23;WA41;Häute, Felle, Leder;48590;41075;7515
01.10.23;WA42;Lederwaren, Sattlerwaren;260256;384606;-124350
01.10.23;WA43;Pelzfelle, künstliches Pelzwerk;6111;7604;-1493
01.10.23;WA44;Holz, Holzwaren, Holzkohle;818452;677720;140732
01.10.23;WA45;Kork, Korkwaren;2065;6402;-4337
01.10.23;WA46;Flechtwaren, Korbmacherwaren;4134;9909;-5775
01.10.23;WA47;Halbstoffe aus Holz usw., Papierabfall;97038;281149;-184111
01.10.23;WA48;Papier, Pappe und Waren daraus;1690643;1109712;580931
01.10.23;WA49;Bücher, Zeitungen, Bilddrucke usw.;342817;244770;98047
01.10.23;WA50;Seide;2385;3669;-1284
01.10.23;WA51;Wolle, feine und grobe Tierhaare;32392;42692;-10300
01.10.23;WA52;Baumwolle;54588;60350;-5762
01.10.23;WA53;Andere pflanzliche Spinnstoffe, Papiergarn;4228;7513;-3285
01.10.23;WA54;Synthetisches oder künstliches Filament;143334;111898;31436
01.10.23;WA55;Synthetische oder künstliche Spinnfaser;126529;123068;3461
01.10.23;WA56;Watte, Filz, Vliesstoff usw., Tauwerk;224188;132002;92186
01.10.23;WA57;Teppiche, Fussbodenbelag aus Spinnstoff;52963;93430;-40467
01.10.23;WA58;Spezialgewebe, Spitzen, Tapisserien;48161;22767;25394
01.10.23;WA59;Getränkte, bestrichene usw. Gewebe;213039;108550;104489
01.10.23;WA60;Gewirke und Gestricke;56675;36179;20496
01.10.23;WA61;Bekleidung usw. aus Gewirken, Gestricken;1132321;1763554;-631233
01.10.23;WA62;Andere Bekleidung, Bekleidungszubehör;1072155;1488384;-416229
01.10.23;WA63;Andere Konfektion, Spinnstoffwaren usw.;266576;377058;-110482
01.10.23;WA64;Schuhe, Gamaschen, ähnliche Waren;804380;967076;-162696
01.10.23;WA65;Kopfbedeckungen und Teile davon;66201;80429;-14228
01.10.23;WA66;Schirme, Gehstöcke usw., Peitschen;7486;14920;-7434
01.10.23;WA67;Zugerichtete Federn, Daunen, künstliche Blumen;14438;21864;-7426
01.10.23;WA68;Waren aus Steinen, Gips, Zement usw.;479965;316778;163187
01.10.23;WA69;Keramische Waren;335805;248166;87639
01.10.23;WA70;Glas und Glaswaren;658940;491929;167011
01.10.23;WA71;Perlen, Edelsteine, Edelmetalle;1536586;1649342;-112756
01.10.23;WA72;Eisen und Stahl;2437493;2364398;73095
01.10.23;WA73;Waren aus Eisen oder Stahl;2965418;2220473;744945
01.10.23;WA74;Kupfer und Waren daraus;1119204;876780;242424
01.10.23;WA75;Nickel und Waren daraus;171772;184283;-12511
01.10.23;WA76;Aluminium und Waren daraus;1450370;1675390;-225020
01.10.23;WA78;Blei und Waren daraus;39959;47165;-7206
01.10.23;WA79;Zink und Waren daraus;59570;134709;-75139
01.10.23;WA80;Zinn und Waren daraus;9638;34437;-24799
01.10.23;WA81;Andere unedle Metalle, Cermets usw.;128304;164814;-36510
01.10.23;WA82;Werkzeuge, Schneidwaren, Essbestecke;779945;479403;300542
01.10.23;WA83;Verschiedene Waren aus unedlen Metallen;704803;456600;248203
01.10.23;WA84;Maschinen, Apparate, mechanische Geräte;21111984;14116441;6995543
01.10.23;WA85;Elektrotechnische Erzeugnisse;15076636;17680459;-2603823
01.10.23;WA86;Schienenfahrzeuge;204564;289717;-85153
01.10.23;WA87;Kraftfahrzeuge, Landfahrzeuge;23875666;12625031;11250635
01.10.23;WA88;Luftfahrzeuge, Raumfahrzeuge;3247598;927600;2319998
01.10.23;WA89;Wasserfahrzeuge;1226938;82492;1144446
01.10.23;WA90;Optische, photografische usw. Erzeugnisse;6645522;3851100;2794422
01.10.23;WA91;Uhrmacherwaren;165844;226526;-60682
01.10.23;WA92;Musikinstrumente;90229;68115;22114
01.10.23;WA93;Waffen und Munition;49197;30512;18685
01.10.23;WA94;Möbel, Beleuchtungskörper usw.;1514883;1846690;-331807
01.10.23;WA95;Spielzeug, Spiele usw., Sportgeräte;541190;852278;-311088
01.10.23;WA96;Verschiedene Waren;352471;309629;42842
01.10.23;WA97;Kunstgegenstände, Sammlungsstücke;137394;46229;91165
01.10.23;WA98;Vollständige Fabrikationsanlagen;74261;NULL;#WERT!
01.10.23;WA99;Zusammenstellungen verschiedener Waren;1324485;1033485;291000
01.10.24;WA01;Lebende Tiere;134233;135060;-827
01.10.24;WA02;Fleisch;662364;729786;-67422
01.10.24;WA03;Fische, Krebs- und Weichtiere;120257;371472;-251215
01.10.24;WA04;Milch, Milcherzeugnisse, Eier, Honig;1104840;1036253;68587
01.10.24;WA05;Andere Waren tierischen Ursprungs;76415;96520;-20105
01.10.24;WA06;Pflanzen, Waren des Blumenhandels;79055;203872;-124817
01.10.24;WA07;Gemüse, Pflanzen für Ernährung;155787;609946;-454159
01.10.24;WA08;Geniessbare Früchte und Nüsse;182853;1087870;-905017
01.10.24;WA09;Kaffee, Tee, Mate, Gewürze;396963;707402;-310439
01.10.24;WA10;Getreide;173781;324468;-150687
01.10.24;WA11;Müllereierzeugnisse, Malz usw.;210552;85733;124819
01.10.24;WA12;Ölsamen usw., Heilpflanzen usw.;109554;669742;-560188
01.10.24;WA13;Schellack, Gummen, Harz, Pflanzensaft;56592;57951;-1359
01.10.24;WA14;Flechtstoffe usw. pflanzlichen Ursprungs;945;4213;-3268
01.10.24;WA15;Tierische und pflanzliche Fette, Öle, Wachs;316237;412066;-95829
01.10.24;WA16;Zubereitungen von Fleisch, Fisch usw.;317687;350617;-32930
01.10.24;WA17;Zucker und Zuckerwaren;369941;220503;149438
01.10.24;WA18;Kakao und Zubereitungen aus Kakao;1104946;964796;140150
01.10.24;WA19;Zubereitungen aus Getreide usw., Backwaren;900732;635750;264982
01.10.24;WA20;Zubereitungen von Gemüse, Früchten usw.;326365;641730;-315365
01.10.24;WA21;Verschiedene Lebensmittelzubereitungen;749556;486340;263216
01.10.24;WA22;Getränke, alkoholhaltige Flüssigkeiten, Essig;641357;764546;-123189
01.10.24;WA23;Rückstände der Lebensmittelindustrie, Futter;634446;515690;118756
01.10.24;WA24;Tabak;292281;497710;-205429
01.10.24;WA25;Salz, Schwefel, Steine, Erden usw.;230291;173353;56938
01.10.24;WA26;Erze, Schlacken, Aschen;54954;858628;-803674
01.10.24;WA27;Mineralische Brennstoffe usw.;2353670;9049887;-6696217
01.10.24;WA28;Anorganische chemische Erzeugnisse;1098969;644688;454281
01.10.24;WA29;Organische chemische Erzeugnisse;2153620;3801123;-1647503
01.10.24;WA30;Pharmazeutische Erzeugnisse;8807383;6525415;2281968
01.10.24;WA31;Düngemittel;219663;108111;111552
01.10.24;WA32;Gerb- und Farbstoffe, Farben, Lacke usw.;989526;556737;432789
01.10.24;WA33;Etherische Öle, Riech-, Schönheitsmittel;1046150;831666;214484
01.10.24;WA34;Seifen, Waschmittel usw.;808882;544244;264638
01.10.24;WA35;Eiweissstoffe, Klebstoffe, Enzyme;411007;287582;123425
01.10.24;WA36;Sprengstoffe, pyrotechnische Artikel usw.;42277;70303;-28026
01.10.24;WA37;Photochemische Erzeugnisse;81857;56418;25439
01.10.24;WA38;Verschiedene Erzeugnisse der Chemischen Industrie;2738971;1552431;1186540
01.10.24;WA39;Kunststoffe und Waren daraus;5792484;3899467;1893017
01.10.24;WA40;Kautschuk und Waren daraus;1478463;1561258;-82795
01.10.24;WA41;Häute, Felle, Leder;52998;46908;6090
01.10.24;WA42;Lederwaren, Sattlerwaren;260132;407862;-147730
01.10.24;WA43;Pelzfelle, künstliches Pelzwerk;5748;8128;-2380
01.10.24;WA44;Holz, Holzwaren, Holzkohle;824363;738879;85484
01.10.24;WA45;Kork, Korkwaren;2140;7867;-5727
01.10.24;WA46;Flechtwaren, Korbmacherwaren;4359;10661;-6302
01.10.24;WA47;Halbstoffe aus Holz usw., Papierabfall;118893;378708;-259815
01.10.24;WA48;Papier, Pappe und Waren daraus;1802794;1167366;635428
01.10.24;WA49;Bücher, Zeitungen, Bilddrucke usw.;309196;228105;81091
01.10.24;WA50;Seide;2183;4582;-2399
01.10.24;WA51;Wolle, feine und grobe Tierhaare;34823;32641;2182
01.10.24;WA52;Baumwolle;47692;57246;-9554
01.10.24;WA53;Andere pflanzliche Spinnstoffe, Papiergarn;4383;7738;-3355
01.10.24;WA54;Synthetisches oder künstliches Filament;131743;117397;14346
01.10.24;WA55;Synthetische oder künstliche Spinnfaser;125121;124862;259
01.10.24;WA56;Watte, Filz, Vliesstoff usw., Tauwerk;227425;152353;75072
01.10.24;WA57;Teppiche, Fussbodenbelag aus Spinnstoff;53862;96999;-43137
01.10.24;WA58;Spezialgewebe, Spitzen, Tapisserien;44332;23583;20749
01.10.24;WA59;Getränkte, bestrichene usw. Gewebe;235761;116925;118836
01.10.24;WA60;Gewirke und Gestricke;53176;35278;17898
01.10.24;WA61;Bekleidung usw. aus Gewirken, Gestricken;1255135;2108072;-852937
01.10.24;WA62;Andere Bekleidung, Bekleidungszubehör;1157816;1674786;-516970
01.10.24;WA63;Andere Konfektion, Spinnstoffwaren usw.;280696;438016;-157320
01.10.24;WA64;Schuhe, Gamaschen, ähnliche Waren;936922;1173467;-236545
01.10.24;WA65;Kopfbedeckungen und Teile davon;67544;89154;-21610
01.10.24;WA66;Schirme, Gehstöcke usw., Peitschen;8390;13914;-5524
01.10.24;WA67;Zugerichtete Federn, Daunen, künstliche Blumen;16556;29373;-12817
01.10.24;WA68;Waren aus Steinen, Gips, Zement usw.;492093;301619;190474
01.10.24;WA69;Keramische Waren;338423;265620;72803
01.10.24;WA70;Glas und Glaswaren;643830;495092;148738
01.10.24;WA71;Perlen, Edelsteine, Edelmetalle;2335514;2217422;118092
01.10.24;WA72;Eisen und Stahl;2366685;2306839;59846
01.10.24;WA73;Waren aus Eisen oder Stahl;2841411;2257978;583433
01.10.24;WA74;Kupfer und Waren daraus;1234137;1161411;72726
01.10.24;WA75;Nickel und Waren daraus;167545;180685;-13140
01.10.24;WA76;Aluminium und Waren daraus;1570990;1756897;-185907
01.10.24;WA78;Blei und Waren daraus;49629;50919;-1290
01.10.24;WA79;Zink und Waren daraus;80503;119596;-39093
01.10.24;WA80;Zinn und Waren daraus;12062;45118;-33056
01.10.24;WA81;Andere unedle Metalle, Cermets usw.;149091;183826;-34735
01.10.24;WA82;Werkzeuge, Schneidwaren, Essbestecke;817809;521230;296579
01.10.24;WA83;Verschiedene Waren aus unedlen Metallen;706976;495565;211411
01.10.24;WA84;Maschinen, Apparate, mechanische Geräte;21330095;14310492;7019603
01.10.24;WA85;Elektrotechnische Erzeugnisse;14269401;17312038;-3042637
01.10.24;WA86;Schienenfahrzeuge;238341;273186;-34845
01.10.24;WA87;Kraftfahrzeuge, Landfahrzeuge;23294253;12292279;11001974
01.10.24;WA88;Luftfahrzeuge, Raumfahrzeuge;3010831;1255176;1755655
01.10.24;WA89;Wasserfahrzeuge;129089;299173;-170084
01.10.24;WA90;Optische, photografische usw. Erzeugnisse;6972406;4053154;2919252
01.10.24;WA91;Uhrmacherwaren;173282;243998;-70716
01.10.24;WA92;Musikinstrumente;90644;80528;10116
01.10.24;WA93;Waffen und Munition;63298;27842;35456
01.10.24;WA94;Möbel, Beleuchtungskörper usw.;1508571;2030938;-522367
01.10.24;WA95;Spielzeug, Spiele usw., Sportgeräte;588173;945151;-356978
01.10.24;WA96;Verschiedene Waren;365721;326616;39105
01.10.24;WA97;Kunstgegenstände, Sammlungsstücke;56768;45630;11138
01.10.24;WA98;Vollständige Fabrikationsanlagen;60530;NULL;#WERT!
01.10.24;WA99;Zusammenstellungen verschiedener Waren;1457852;1239402;218450
01.10.25;WA01;Lebende Tiere;NULL;NULL;#WERT!
01.10.25;WA02;Fleisch;NULL;NULL;#WERT!
01.10.25;WA03;Fische, Krebs- und Weichtiere;NULL;NULL;#WERT!
01.10.25;WA04;Milch, Milcherzeugnisse, Eier, Honig;NULL;NULL;#WERT!
01.10.25;WA05;Andere Waren tierischen Ursprungs;NULL;NULL;#WERT!
01.10.25;WA06;Pflanzen, Waren des Blumenhandels;NULL;NULL;#WERT!
01.10.25;WA07;Gemüse, Pflanzen für Ernährung;NULL;NULL;#WERT!
01.10.25;WA08;Geniessbare Früchte und Nüsse;NULL;NULL;#WERT!
01.10.25;WA09;Kaffee, Tee, Mate, Gewürze;NULL;NULL;#WERT!
01.10.25;WA10;Getreide;NULL;NULL;#WERT!
01.10.25;WA11;Müllereierzeugnisse, Malz usw.;NULL;NULL;#WERT!
01.10.25;WA12;Ölsamen usw., Heilpflanzen usw.;NULL;NULL;#WERT!
01.10.25;WA13;Schellack, Gummen, Harz, Pflanzensaft;NULL;NULL;#WERT!
01.10.25;WA14;Flechtstoffe usw. pflanzlichen Ursprungs;NULL;NULL;#WERT!
01.10.25;WA15;Tierische und pflanzliche Fette, Öle, Wachs;NULL;NULL;#WERT!
01.10.25;WA16;Zubereitungen von Fleisch, Fisch usw.;NULL;NULL;#WERT!
01.10.25;WA17;Zucker und Zuckerwaren;NULL;NULL;#WERT!
01.10.25;WA18;Kakao und Zubereitungen aus Kakao;NULL;NULL;#WERT!
01.10.25;WA19;Zubereitungen aus Getreide usw., Backwaren;NULL;NULL;#WERT!
01.10.25;WA20;Zubereitungen von Gemüse, Früchten usw.;NULL;NULL;#WERT!
01.10.25;WA21;Verschiedene Lebensmittelzubereitungen;NULL;NULL;#WERT!
01.10.25;WA22;Getränke, alkoholhaltige Flüssigkeiten, Essig;NULL;NULL;#WERT!
01.10.25;WA23;Rückstände der Lebensmittelindustrie, Futter;NULL;NULL;#WERT!
01.10.25;WA24;Tabak;NULL;NULL;#WERT!
01.10.25;WA25;Salz, Schwefel, Steine, Erden usw.;NULL;NULL;#WERT!
01.10.25;WA26;Erze, Schlacken, Aschen;NULL;NULL;#WERT!
01.10.25;WA27;Mineralische Brennstoffe usw.;NULL;NULL;#WERT!
01.10.25;WA28;Anorganische chemische Erzeugnisse;NULL;NULL;#WERT!
01.10.25;WA29;Organische chemische Erzeugnisse;NULL;NULL;#WERT!
01.10.25;WA30;Pharmazeutische Erzeugnisse;NULL;NULL;#WERT!
01.10.25;WA31;Düngemittel;NULL;NULL;#WERT!
01.10.25;WA32;Gerb- und Farbstoffe, Farben, Lacke usw.;NULL;NULL;#WERT!
01.10.25;WA33;Etherische Öle, Riech-, Schönheitsmittel;NULL;NULL;#WERT!
01.10.25;WA34;Seifen, Waschmittel usw.;NULL;NULL;#WERT!
01.10.25;WA35;Eiweissstoffe, Klebstoffe, Enzyme;NULL;NULL;#WERT!
01.10.25;WA36;Sprengstoffe, pyrotechnische Artikel usw.;NULL;NULL;#WERT!
01.10.25;WA37;Photochemische Erzeugnisse;NULL;NULL;#WERT!
01.10.25;WA38;Verschiedene Erzeugnisse der Chemischen Industrie;NULL;NULL;#WERT!
01.10.25;WA39;Kunststoffe und Waren daraus;NULL;NULL;#WERT!
01.10.25;WA40;Kautschuk und Waren daraus;NULL;NULL;#WERT!
01.10.25;WA41;Häute, Felle, Leder;NULL;NULL;#WERT!
01.10.25;WA42;Lederwaren, Sattlerwaren;NULL;NULL;#WERT!
01.10.25;WA43;Pelzfelle, künstliches Pelzwerk;NULL;NULL;#WERT!
01.10.25;WA44;Holz, Holzwaren, Holzkohle;NULL;NULL;#WERT!
01.10.25;WA45;Kork, Korkwaren;NULL;NULL;#WERT!
01.10.25;WA46;Flechtwaren, Korbmacherwaren;NULL;NULL;#WERT!
01.10.25;WA47;Halbstoffe aus Holz usw., Papierabfall;NULL;NULL;#WERT!
01.10.25;WA48;Papier, Pappe und Waren daraus;NULL;NULL;#WERT!
01.10.25;WA49;Bücher, Zeitungen, Bilddrucke usw.;NULL;NULL;#WERT!
01.10.25;WA50;Seide;NULL;NULL;#WERT!
01.10.25;WA51;Wolle, feine und grobe Tierhaare;NULL;NULL;#WERT!
01.10.25;WA52;Baumwolle;NULL;NULL;#WERT!
01.10.25;WA53;Andere pflanzliche Spinnstoffe, Papiergarn;NULL;NULL;#WERT!
01.10.25;WA54;Synthetisches oder künstliches Filament;NULL;NULL;#WERT!
01.10.25;WA55;Synthetische oder künstliche Spinnfaser;NULL;NULL;#WERT!
01.10.25;WA56;Watte, Filz, Vliesstoff usw., Tauwerk;NULL;NULL;#WERT!
01.10.25;WA57;Teppiche, Fussbodenbelag aus Spinnstoff;NULL;NULL;#WERT!
01.10.25;WA58;Spezialgewebe, Spitzen, Tapisserien;NULL;NULL;#WERT!
01.10.25;WA59;Getränkte, bestrichene usw. Gewebe;NULL;NULL;#WERT!
01.10.25;WA60;Gewirke und Gestricke;NULL;NULL;#WERT!
01.10.25;WA61;Bekleidung usw. aus Gewirken, Gestricken;NULL;NULL;#WERT!
01.10.25;WA62;Andere Bekleidung, Bekleidungszubehör;NULL;NULL;#WERT!
01.10.25;WA63;Andere Konfektion, Spinnstoffwaren usw.;NULL;NULL;#WERT!
01.10.25;WA64;Schuhe, Gamaschen, ähnliche Waren;NULL;NULL;#WERT!
01.10.25;WA65;Kopfbedeckungen und Teile davon;NULL;NULL;#WERT!
01.10.25;WA66;Schirme, Gehstöcke usw., Peitschen;NULL;NULL;#WERT!
01.10.25;WA67;Zugerichtete Federn, Daunen, künstliche Blumen;NULL;NULL;#WERT!
01.10.25;WA68;Waren aus Steinen, Gips, Zement usw.;NULL;NULL;#WERT!
01.10.25;WA69;Keramische Waren;NULL;NULL;#WERT!
01.10.25;WA70;Glas und Glaswaren;NULL;NULL;#WERT!
01.10.25;WA71;Perlen, Edelsteine, Edelmetalle;NULL;NULL;#WERT!
01.10.25;WA72;Eisen und Stahl;NULL;NULL;#WERT!
01.10.25;WA73;Waren aus Eisen oder Stahl;NULL;NULL;#WERT!
01.10.25;WA74;Kupfer und Waren daraus;NULL;NULL;#WERT!
01.10.25;WA75;Nickel und Waren daraus;NULL;NULL;#WERT!
01.10.25;WA76;Aluminium und Waren daraus;NULL;NULL;#WERT!
01.10.25;WA78;Blei und Waren daraus;NULL;NULL;#WERT!
01.10.25;WA79;Zink und Waren daraus;NULL;NULL;#WERT!
01.10.25;WA80;Zinn und Waren daraus;NULL;NULL;#WERT!
01.10.25;WA81;Andere unedle Metalle, Cermets usw.;NULL;NULL;#WERT!
01.10.25;WA82;Werkzeuge, Schneidwaren, Essbestecke;NULL;NULL;#WERT!
01.10.25;WA83;Verschiedene Waren aus unedlen Metallen;NULL;NULL;#WERT!
01.10.25;WA84;Maschinen, Apparate, mechanische Geräte;NULL;NULL;#WERT!
01.10.25;WA85;Elektrotechnische Erzeugnisse;NULL;NULL;#WERT!
01.10.25;WA86;Schienenfahrzeuge;NULL;NULL;#WERT!
01.10.25;WA87;Kraftfahrzeuge, Landfahrzeuge;NULL;NULL;#WERT!
01.10.25;WA88;Luftfahrzeuge, Raumfahrzeuge;NULL;NULL;#WERT!
01.10.25;WA89;Wasserfahrzeuge;NULL;NULL;#WERT!
01.10.25;WA90;Optische, photografische usw. Erzeugnisse;NULL;NULL;#WERT!
01.10.25;WA91;Uhrmacherwaren;NULL;NULL;#WERT!
01.10.25;WA92;Musikinstrumente;NULL;NULL;#WERT!
01.10.25;WA93;Waffen und Munition;NULL;NULL;#WERT!
01.10.25;WA94;Möbel, Beleuchtungskörper usw.;NULL;NULL;#WERT!
01.10.25;WA95;Spielzeug, Spiele usw., Sportgeräte;NULL;NULL;#WERT!
01.10.25;WA96;Verschiedene Waren;NULL;NULL;#WERT!
01.10.25;WA97;Kunstgegenstände, Sammlungsstücke;NULL;NULL;#WERT!
01.10.25;WA98;Vollständige Fabrikationsanlagen;NULL;NULL;#WERT!
01.10.25;WA99;Zusammenstellungen verschiedener Waren;NULL;NULL;#WERT!
01.11.08;WA01;Lebende Tiere;77930;122550;-44620
01.11.08;WA02;Fleisch;494714;522509;-27795
01.11.08;WA03;Fische, Krebs- und Weichtiere;80632;225842;-145210
01.11.08;WA04;Milch, Milcherzeugnisse, Eier, Honig;496819;444360;52459
01.11.08;WA05;Andere Waren tierischen Ursprungs;52680;56026;-3346
01.11.08;WA06;Pflanzen, Waren des Blumenhandels;43446;167924;-124478
01.11.08;WA07;Gemüse, Pflanzen für Ernährung;66169;302558;-236389
01.11.08;WA08;Geniessbare Früchte und Nüsse;97436;516450;-419014
01.11.08;WA09;Kaffee, Tee, Mate, Gewürze;153285;240344;-87059
01.11.08;WA10;Getreide;295276;155657;139619
01.11.08;WA11;Müllereierzeugnisse, Malz usw.;69476;40731;28745
01.11.08;WA12;Ölsamen usw., Heilpflanzen usw.;58569;257532;-198963
01.11.08;WA13;Schellack, Gummen, Harz, Pflanzensaft;36480;30524;5956
01.11.08;WA14;Flechtstoffe usw. pflanzlichen Ursprungs;1248;2237;-989
01.11.08;WA15;Tierische und pflanzliche Fette, Öle, Wachs;133681;332478;-198797
01.11.08;WA16;Zubereitungen von Fleisch, Fisch usw.;173552;177156;-3604
01.11.08;WA17;Zucker und Zuckerwaren;125531;118264;7267
01.11.08;WA18;Kakao und Zubereitungen aus Kakao;249276;213601;35675
01.11.08;WA19;Zubereitungen aus Getreide usw., Backwaren;374133;206868;167265
01.11.08;WA20;Zubereitungen von Gemüse, Früchten usw.;169533;321855;-152322
01.11.08;WA21;Verschiedene Lebensmittelzubereitungen;269051;192166;76885
01.11.08;WA22;Getränke, alkoholhaltige Flüssigkeiten, Essig;315647;466307;-150660
01.11.08;WA23;Rückstände der Lebensmittelindustrie, Futter;186096;214267;-28171
01.11.08;WA24;Tabak;265053;110936;154117
01.11.08;WA25;Salz, Schwefel, Steine, Erden usw.;188392;135897;52495
01.11.08;WA26;Erze, Schlacken, Aschen;18573;341971;-323398
01.11.08;WA27;Mineralische Brennstoffe usw.;1981477;9245213;-7263736
01.11.08;WA28;Anorganische chemische Erzeugnisse;551183;583954;-32771
01.11.08;WA29;Organische chemische Erzeugnisse;1630624;1700102;-69478
01.11.08;WA30;Pharmazeutische Erzeugnisse;3946021;2577776;1368245
01.11.08;WA31;Düngemittel;238724;125433;113291
01.11.08;WA32;Gerb- und Farbstoffe, Farben, Lacke usw.;567040;280747;286293
01.11.08;WA33;Etherische Öle, Riech-, Schönheitsmittel;540134;300804;239330
01.11.08;WA34;Seifen, Waschmittel usw.;360255;198857;161398
01.11.08;WA35;Eiweissstoffe, Klebstoffe, Enzyme;147536;127455;20081
01.11.08;WA36;Sprengstoffe, pyrotechnische Artikel usw.;19913;20074;-161
01.11.08;WA37;Photochemische Erzeugnisse;83064;64484;18580
01.11.08;WA38;Verschiedene Erzeugnisse der Chemischen Industrie;1130383;660155;470228
01.11.08;WA39;Kunststoffe und Waren daraus;3129505;1970869;1158636
01.11.08;WA40;Kautschuk und Waren daraus;734634;776258;-41624
01.11.08;WA41;Häute, Felle, Leder;69504;72303;-2799
01.11.08;WA42;Lederwaren, Sattlerwaren;105935;218876;-112941
01.11.08;WA43;Pelzfelle, künstliches Pelzwerk;11244;11616;-372
01.11.08;WA44;Holz, Holzwaren, Holzkohle;551231;422238;128993
01.11.08;WA45;Kork, Korkwaren;3190;8402;-5212
01.11.08;WA46;Flechtwaren, Korbmacherwaren;3419;11448;-8029
01.11.08;WA47;Halbstoffe aus Holz usw., Papierabfall;62058;252521;-190463
01.11.08;WA48;Papier, Pappe und Waren daraus;1437212;969316;467896
01.11.08;WA49;Bücher, Zeitungen, Bilddrucke usw.;391115;197748;193367
01.11.08;WA50;Seide;8093;8239;-146
01.11.08;WA51;Wolle, feine und grobe Tierhaare;49416;56479;-7063
01.11.08;WA52;Baumwolle;90700;85332;5368
01.11.08;WA53;Andere pflanzliche Spinnstoffe, Papiergarn;7550;10164;-2614
01.11.08;WA54;Synthetisches oder künstliches Filament;165161;119546;45615
01.11.08;WA55;Synthetische oder künstliche Spinnfaser;123636;108642;14994
01.11.08;WA56;Watte, Filz, Vliesstoff usw., Tauwerk;135604;81705;53899
01.11.08;WA57;Teppiche, Fussbodenbelag aus Spinnstoff;37706;76282;-38576
01.11.08;WA58;Spezialgewebe, Spitzen, Tapisserien;37901;25157;12744
01.11.08;WA59;Getränkte, bestrichene usw. Gewebe;123505;100367;23138
01.11.08;WA60;Gewirke und Gestricke;61576;33167;28409
01.11.08;WA61;Bekleidung usw. aus Gewirken, Gestricken;386999;907540;-520541
01.11.08;WA62;Andere Bekleidung, Bekleidungszubehör;429551;880678;-451127
01.11.08;WA63;Andere Konfektion, Spinnstoffwaren usw.;135632;208485;-72853
01.11.08;WA64;Schuhe, Gamaschen, ähnliche Waren;143804;350096;-206292
01.11.08;WA65;Kopfbedeckungen und Teile davon;14682;25245;-10563
01.11.08;WA66;Schirme, Gehstöcke usw., Peitschen;8620;11916;-3296
01.11.08;WA67;Zugerichtete Federn, Daunen, künstliche Blumen;4848;11975;-7127
01.11.08;WA68;Waren aus Steinen, Gips, Zement usw.;264093;167663;96430
01.11.08;WA69;Keramische Waren;218276;177124;41152
01.11.08;WA70;Glas und Glaswaren;376017;286773;89244
01.11.08;WA71;Perlen, Edelsteine, Edelmetalle;644187;929028;-284841
01.11.08;WA72;Eisen und Stahl;1798794;2194802;-396008
01.11.08;WA73;Waren aus Eisen oder Stahl;1984752;1346878;637874
01.11.08;WA74;Kupfer und Waren daraus;559080;554512;4568
01.11.08;WA75;Nickel und Waren daraus;105139;113933;-8794
01.11.08;WA76;Aluminium und Waren daraus;872812;805722;67090
01.11.08;WA78;Blei und Waren daraus;35623;24694;10929
01.11.08;WA79;Zink und Waren daraus;34462;50454;-15992
01.11.08;WA80;Zinn und Waren daraus;8359;22223;-13864
01.11.08;WA81;Andere unedle Metalle, Cermets usw.;87792;126158;-38366
01.11.08;WA82;Werkzeuge, Schneidwaren, Essbestecke;479404;307008;172396
01.11.08;WA83;Verschiedene Waren aus unedlen Metallen;455720;274069;181651
01.11.08;WA84;Maschinen, Apparate, mechanische Geräte;14282242;8996411;5285831
01.11.08;WA85;Elektrotechnische Erzeugnisse;8164008;7930289;233719
01.11.08;WA86;Schienenfahrzeuge;326245;136568;189677
01.11.08;WA87;Kraftfahrzeuge, Landfahrzeuge;12033107;4931560;7101547
01.11.08;WA88;Luftfahrzeuge, Raumfahrzeuge;1733707;1434996;298711
01.11.08;WA89;Wasserfahrzeuge;407875;465377;-57502
01.11.08;WA90;Optische, photografische usw. Erzeugnisse;3233144;1872742;1360402
01.11.08;WA91;Uhrmacherwaren;98917;124737;-25820
01.11.08;WA92;Musikinstrumente;39897;38224;1673
01.11.08;WA93;Waffen und Munition;35103;12069;23034
01.11.08;WA94;Möbel, Beleuchtungskörper usw.;1014484;982307;32177
01.11.08;WA95;Spielzeug, Spiele usw., Sportgeräte;809846;749073;60773
01.11.08;WA96;Verschiedene Waren;152113;111791;40322
01.11.08;WA97;Kunstgegenstände, Sammlungsstücke;86880;18929;67951
01.11.08;WA98;Vollständige Fabrikationsanlagen;498869;13312;485557
01.11.08;WA99;Zusammenstellungen verschiedener Waren;1091046;1103606;-12560
01.11.09;WA01;Lebende Tiere;85388;109606;-24218
01.11.09;WA02;Fleisch;507313;399708;107605
01.11.09;WA03;Fische, Krebs- und Weichtiere;91435;230066;-138631
01.11.09;WA04;Milch, Milcherzeugnisse, Eier, Honig;469777;408989;60788
01.11.09;WA05;Andere Waren tierischen Ursprungs;44640;48264;-3624
01.11.09;WA06;Pflanzen, Waren des Blumenhandels;50169;171971;-121802
01.11.09;WA07;Gemüse, Pflanzen für Ernährung;51206;257694;-206488
01.11.09;WA08;Geniessbare Früchte und Nüsse;88891;479475;-390584
01.11.09;WA09;Kaffee, Tee, Mate, Gewürze;139782;208448;-68666
01.11.09;WA10;Getreide;159847;121242;38605
01.11.09;WA11;Müllereierzeugnisse, Malz usw.;76238;32361;43877
01.11.09;WA12;Ölsamen usw., Heilpflanzen usw.;60732;209198;-148466
01.11.09;WA13;Schellack, Gummen, Harz, Pflanzensaft;31094;25429;5665
01.11.09;WA14;Flechtstoffe usw. pflanzlichen Ursprungs;873;1620;-747
01.11.09;WA15;Tierische und pflanzliche Fette, Öle, Wachs;121545;204998;-83453
01.11.09;WA16;Zubereitungen von Fleisch, Fisch usw.;184703;159648;25055
01.11.09;WA17;Zucker und Zuckerwaren;145583;95254;50329
01.11.09;WA18;Kakao und Zubereitungen aus Kakao;289616;265216;24400
01.11.09;WA19;Zubereitungen aus Getreide usw., Backwaren;331475;181095;150380
01.11.09;WA20;Zubereitungen von Gemüse, Früchten usw.;140181;262896;-122715
01.11.09;WA21;Verschiedene Lebensmittelzubereitungen;286136;194690;91446
01.11.09;WA22;Getränke, alkoholhaltige Flüssigkeiten, Essig;327290;513746;-186456
01.11.09;WA23;Rückstände der Lebensmittelindustrie, Futter;219591;237511;-17920
01.11.09;WA24;Tabak;283169;124165;159004
01.11.09;WA25;Salz, Schwefel, Steine, Erden usw.;154407;125815;28592
01.11.09;WA26;Erze, Schlacken, Aschen;18704;374111;-355407
01.11.09;WA27;Mineralische Brennstoffe usw.;1397096;6258701;-4861605
01.11.09;WA28;Anorganische chemische Erzeugnisse;515699;367598;148101
01.11.09;WA29;Organische chemische Erzeugnisse;1729190;1379834;349356
01.11.09;WA30;Pharmazeutische Erzeugnisse;3864883;2972203;892680
01.11.09;WA31;Düngemittel;125311;51018;74293
01.11.09;WA32;Gerb- und Farbstoffe, Farben, Lacke usw.;648275;279445;368830
01.11.09;WA33;Etherische Öle, Riech-, Schönheitsmittel;611332;326666;284666
01.11.09;WA34;Seifen, Waschmittel usw.;395842;223148;172694
01.11.09;WA35;Eiweissstoffe, Klebstoffe, Enzyme;171187;116128;55059
01.11.09;WA36;Sprengstoffe, pyrotechnische Artikel usw.;20433;23635;-3202
01.11.09;WA37;Photochemische Erzeugnisse;98528;69829;28699
01.11.09;WA38;Verschiedene Erzeugnisse der Chemischen Industrie;1093839;616105;477734
01.11.09;WA39;Kunststoffe und Waren daraus;3255806;1871399;1384407
01.11.09;WA40;Kautschuk und Waren daraus;820060;711550;108510
01.11.09;WA41;Häute, Felle, Leder;67222;62039;5183
01.11.09;WA42;Lederwaren, Sattlerwaren;100060;174042;-73982
01.11.09;WA43;Pelzfelle, künstliches Pelzwerk;9853;10024;-171
01.11.09;WA44;Holz, Holzwaren, Holzkohle;532182;407766;124416
01.11.09;WA45;Kork, Korkwaren;2679;8139;-5460
01.11.09;WA46;Flechtwaren, Korbmacherwaren;4004;8219;-4215
01.11.09;WA47;Halbstoffe aus Holz usw., Papierabfall;67707;216733;-149026
01.11.09;WA48;Papier, Pappe und Waren daraus;1348544;910059;438485
01.11.09;WA49;Bücher, Zeitungen, Bilddrucke usw.;340022;168155;171867
01.11.09;WA50;Seide;5525;5918;-393
01.11.09;WA51;Wolle, feine und grobe Tierhaare;44185;45629;-1444
01.11.09;WA52;Baumwolle;82566;76413;6153
01.11.09;WA53;Andere pflanzliche Spinnstoffe, Papiergarn;5953;7853;-1900
01.11.09;WA54;Synthetisches oder künstliches Filament;151358;99578;51780
01.11.09;WA55;Synthetische oder künstliche Spinnfaser;143531;98847;44684
01.11.09;WA56;Watte, Filz, Vliesstoff usw., Tauwerk;144520;78632;65888
01.11.09;WA57;Teppiche, Fussbodenbelag aus Spinnstoff;37442;79533;-42091
01.11.09;WA58;Spezialgewebe, Spitzen, Tapisserien;40430;24482;15948
01.11.09;WA59;Getränkte, bestrichene usw. Gewebe;137643;84185;53458
01.11.09;WA60;Gewirke und Gestricke;61285;31536;29749
01.11.09;WA61;Bekleidung usw. aus Gewirken, Gestricken;396779;805488;-408709
01.11.09;WA62;Andere Bekleidung, Bekleidungszubehör;407768;751630;-343862
01.11.09;WA63;Andere Konfektion, Spinnstoffwaren usw.;144053;204464;-60411
01.11.09;WA64;Schuhe, Gamaschen, ähnliche Waren;131767;312422;-180655
01.11.09;WA65;Kopfbedeckungen und Teile davon;18860;26922;-8062
01.11.09;WA66;Schirme, Gehstöcke usw., Peitschen;16163;8244;7919
01.11.09;WA67;Zugerichtete Federn, Daunen, künstliche Blumen;4865;8242;-3377
01.11.09;WA68;Waren aus Steinen, Gips, Zement usw.;269856;158672;111184
01.11.09;WA69;Keramische Waren;225158;152759;72399
01.11.09;WA70;Glas und Glaswaren;383533;292324;91209
01.11.09;WA71;Perlen, Edelsteine, Edelmetalle;649392;756135;-106743
01.11.09;WA72;Eisen und Stahl;1482840;1296337;186503
01.11.09;WA73;Waren aus Eisen oder Stahl;1649184;1006611;642573
01.11.09;WA74;Kupfer und Waren daraus;697269;542761;154508
01.11.09;WA75;Nickel und Waren daraus;43518;70027;-26509
01.11.09;WA76;Aluminium und Waren daraus;750920;711528;39392
01.11.09;WA78;Blei und Waren daraus;50994;28487;22507
01.11.09;WA79;Zink und Waren daraus;50618;71964;-21346
01.11.09;WA80;Zinn und Waren daraus;5601;17895;-12294
01.11.09;WA81;Andere unedle Metalle, Cermets usw.;54082;68159;-14077
01.11.09;WA82;Werkzeuge, Schneidwaren, Essbestecke;444301;241147;203154
01.11.09;WA83;Verschiedene Waren aus unedlen Metallen;427844;257529;170315
01.11.09;WA84;Maschinen, Apparate, mechanische Geräte;12420286;7372735;5047551
01.11.09;WA85;Elektrotechnische Erzeugnisse;7517664;7573483;-55819
01.11.09;WA86;Schienenfahrzeuge;277742;100650;177092
01.11.09;WA87;Kraftfahrzeuge, Landfahrzeuge;12535563;4466134;8069429
01.11.09;WA88;Luftfahrzeuge, Raumfahrzeuge;1879308;747193;1132115
01.11.09;WA89;Wasserfahrzeuge;215193;338310;-123117
01.11.09;WA90;Optische, photografische usw. Erzeugnisse;3263202;1793770;1469432
01.11.09;WA91;Uhrmacherwaren;91591;111570;-19979
01.11.09;WA92;Musikinstrumente;33485;38850;-5365
01.11.09;WA93;Waffen und Munition;34743;16551;18192
01.11.09;WA94;Möbel, Beleuchtungskörper usw.;903307;909018;-5711
01.11.09;WA95;Spielzeug, Spiele usw., Sportgeräte;731111;685680;45431
01.11.09;WA96;Verschiedene Waren;136984;106953;30031
01.11.09;WA97;Kunstgegenstände, Sammlungsstücke;45776;17399;28377
01.11.09;WA98;Vollständige Fabrikationsanlagen;347093;24706;322387
01.11.09;WA99;Zusammenstellungen verschiedener Waren;1122444;931967;190477
01.11.10;WA01;Lebende Tiere;87503;118029;-30526
01.11.10;WA02;Fleisch;586009;464871;121138
01.11.10;WA03;Fische, Krebs- und Weichtiere;100529;281978;-181449
01.11.10;WA04;Milch, Milcherzeugnisse, Eier, Honig;597821;512633;85188
01.11.10;WA05;Andere Waren tierischen Ursprungs;50517;55627;-5110
01.11.10;WA06;Pflanzen, Waren des Blumenhandels;44998;178515;-133517
01.11.10;WA07;Gemüse, Pflanzen für Ernährung;67131;361542;-294411
01.11.10;WA08;Geniessbare Früchte und Nüsse;115264;566700;-451436
01.11.10;WA09;Kaffee, Tee, Mate, Gewürze;186582;308625;-122043
01.11.10;WA10;Getreide;254525;190902;63623
01.11.10;WA11;Müllereierzeugnisse, Malz usw.;83708;37276;46432
01.11.10;WA12;Ölsamen usw., Heilpflanzen usw.;79974;292007;-212033
01.11.10;WA13;Schellack, Gummen, Harz, Pflanzensaft;34183;28895;5288
01.11.10;WA14;Flechtstoffe usw. pflanzlichen Ursprungs;596;2526;-1930
01.11.10;WA15;Tierische und pflanzliche Fette, Öle, Wachs;180269;310489;-130220
01.11.10;WA16;Zubereitungen von Fleisch, Fisch usw.;189190;174665;14525
01.11.10;WA17;Zucker und Zuckerwaren;133516;107314;26202
01.11.10;WA18;Kakao und Zubereitungen aus Kakao;353385;304167;49218
01.11.10;WA19;Zubereitungen aus Getreide usw., Backwaren;355155;193632;161523
01.11.10;WA20;Zubereitungen von Gemüse, Früchten usw.;169267;337201;-167934
01.11.10;WA21;Verschiedene Lebensmittelzubereitungen;320556;159031;161525
01.11.10;WA22;Getränke, alkoholhaltige Flüssigkeiten, Essig;358907;526462;-167555
01.11.10;WA23;Rückstände der Lebensmittelindustrie, Futter;224020;269018;-44998
01.11.10;WA24;Tabak;306171;130300;175871
01.11.10;WA25;Salz, Schwefel, Steine, Erden usw.;170786;163052;7734
01.11.10;WA26;Erze, Schlacken, Aschen;35325;727114;-691789
01.11.10;WA27;Mineralische Brennstoffe usw.;1887575;8871513;-6983938
01.11.10;WA28;Anorganische chemische Erzeugnisse;664699;528312;136387
01.11.10;WA29;Organische chemische Erzeugnisse;1872998;2001312;-128314
01.11.10;WA30;Pharmazeutische Erzeugnisse;3718379;2814363;904016
01.11.10;WA31;Düngemittel;184639;112693;71946
01.11.10;WA32;Gerb- und Farbstoffe, Farben, Lacke usw.;752332;395599;356733
01.11.10;WA33;Etherische Öle, Riech-, Schönheitsmittel;585643;378351;207292
01.11.10;WA34;Seifen, Waschmittel usw.;461551;254363;207188
01.11.10;WA35;Eiweissstoffe, Klebstoffe, Enzyme;211516;131161;80355
01.11.10;WA36;Sprengstoffe, pyrotechnische Artikel usw.;22936;30299;-7363
01.11.10;WA37;Photochemische Erzeugnisse;91188;65221;25967
01.11.10;WA38;Verschiedene Erzeugnisse der Chemischen Industrie;1372344;884988;487356
01.11.10;WA39;Kunststoffe und Waren daraus;3901623;2306613;1595010
01.11.10;WA40;Kautschuk und Waren daraus;1112976;1067431;45545
01.11.10;WA41;Häute, Felle, Leder;78763;73562;5201
01.11.10;WA42;Lederwaren, Sattlerwaren;113451;232184;-118733
01.11.10;WA43;Pelzfelle, künstliches Pelzwerk;11496;11569;-73
01.11.10;WA44;Holz, Holzwaren, Holzkohle;566430;492677;73753
01.11.10;WA45;Kork, Korkwaren;2649;7235;-4586
01.11.10;WA46;Flechtwaren, Korbmacherwaren;3268;9258;-5990
01.11.10;WA47;Halbstoffe aus Holz usw., Papierabfall;89017;316898;-227881
01.11.10;WA48;Papier, Pappe und Waren daraus;1532962;991690;541272
01.11.10;WA49;Bücher, Zeitungen, Bilddrucke usw.;383141;142235;240906
01.11.10;WA50;Seide;6361;6943;-582
01.11.10;WA51;Wolle, feine und grobe Tierhaare;54706;72737;-18031
01.11.10;WA52;Baumwolle;100988;98325;2663
01.11.10;WA53;Andere pflanzliche Spinnstoffe, Papiergarn;6028;9529;-3501
01.11.10;WA54;Synthetisches oder künstliches Filament;164676;123384;41292
01.11.10;WA55;Synthetische oder künstliche Spinnfaser;171659;131397;40262
01.11.10;WA56;Watte, Filz, Vliesstoff usw., Tauwerk;160912;84586;76326
01.11.10;WA57;Teppiche, Fussbodenbelag aus Spinnstoff;43895;90478;-46583
01.11.10;WA58;Spezialgewebe, Spitzen, Tapisserien;40921;30010;10911
01.11.10;WA59;Getränkte, bestrichene usw. Gewebe;159011;84743;74268
01.11.10;WA60;Gewirke und Gestricke;72639;34576;38063
01.11.10;WA61;Bekleidung usw. aus Gewirken, Gestricken;484452;1024721;-540269
01.11.10;WA62;Andere Bekleidung, Bekleidungszubehör;477539;945681;-468142
01.11.10;WA63;Andere Konfektion, Spinnstoffwaren usw.;166016;241342;-75326
01.11.10;WA64;Schuhe, Gamaschen, ähnliche Waren;201171;436250;-235079
01.11.10;WA65;Kopfbedeckungen und Teile davon;22913;32740;-9827
01.11.10;WA66;Schirme, Gehstöcke usw., Peitschen;5919;9768;-3849
01.11.10;WA67;Zugerichtete Federn, Daunen, künstliche Blumen;5351;12566;-7215
01.11.10;WA68;Waren aus Steinen, Gips, Zement usw.;298645;191511;107134
01.11.10;WA69;Keramische Waren;245959;181400;64559
01.11.10;WA70;Glas und Glaswaren;420039;319743;100296
01.11.10;WA71;Perlen, Edelsteine, Edelmetalle;1243291;1279370;-36079
01.11.10;WA72;Eisen und Stahl;2075914;1967581;108333
01.11.10;WA73;Waren aus Eisen oder Stahl;1864761;1303776;560985
01.11.10;WA74;Kupfer und Waren daraus;916456;859369;57087
01.11.10;WA75;Nickel und Waren daraus;81389;167785;-86396
01.11.10;WA76;Aluminium und Waren daraus;908377;1048740;-140363
01.11.10;WA78;Blei und Waren daraus;70115;30382;39733
01.11.10;WA79;Zink und Waren daraus;57269;96053;-38784
01.11.10;WA80;Zinn und Waren daraus;12896;39347;-26451
01.11.10;WA81;Andere unedle Metalle, Cermets usw.;90031;111198;-21167
01.11.10;WA82;Werkzeuge, Schneidwaren, Essbestecke;517985;324200;193785
01.11.10;WA83;Verschiedene Waren aus unedlen Metallen;515527;316876;198651
01.11.10;WA84;Maschinen, Apparate, mechanische Geräte;15474075;9333631;6140444
01.11.10;WA85;Elektrotechnische Erzeugnisse;9734907;9383111;351796
01.11.10;WA86;Schienenfahrzeuge;364045;149300;214745
01.11.10;WA87;Kraftfahrzeuge, Landfahrzeuge;14575087;5655304;8919783
01.11.10;WA88;Luftfahrzeuge, Raumfahrzeuge;2141838;1965894;175944
01.11.10;WA89;Wasserfahrzeuge;843709;1367600;-523891
01.11.10;WA90;Optische, photografische usw. Erzeugnisse;4030221;2140100;1890121
01.11.10;WA91;Uhrmacherwaren;109232;148508;-39276
01.11.10;WA92;Musikinstrumente;53366;49773;3593
01.11.10;WA93;Waffen und Munition;29127;12873;16254
01.11.10;WA94;Möbel, Beleuchtungskörper usw.;1085787;1115261;-29474
01.11.10;WA95;Spielzeug, Spiele usw., Sportgeräte;730410;594869;135541
01.11.10;WA96;Verschiedene Waren;162333;121685;40648
01.11.10;WA97;Kunstgegenstände, Sammlungsstücke;102196;32236;69960
01.11.10;WA98;Vollständige Fabrikationsanlagen;289329;1012;288317
01.11.10;WA99;Zusammenstellungen verschiedener Waren;1527535;1039918;487617
01.11.11;WA01;Lebende Tiere;119390;125220;-5830
01.11.11;WA02;Fleisch;660612;545452;115160
01.11.11;WA03;Fische, Krebs- und Weichtiere;106663;280491;-173828
01.11.11;WA04;Milch, Milcherzeugnisse, Eier, Honig;658303;550357;107946
01.11.11;WA05;Andere Waren tierischen Ursprungs;67997;66387;1610
01.11.11;WA06;Pflanzen, Waren des Blumenhandels;59893;204877;-144984
01.11.11;WA07;Gemüse, Pflanzen für Ernährung;48235;303322;-255087
01.11.11;WA08;Geniessbare Früchte und Nüsse;103607;523562;-419955
01.11.11;WA09;Kaffee, Tee, Mate, Gewürze;223118;388811;-165693
01.11.11;WA10;Getreide;134874;178641;-43767
01.11.11;WA11;Müllereierzeugnisse, Malz usw.;92885;41689;51196
01.11.11;WA12;Ölsamen usw., Heilpflanzen usw.;85073;371509;-286436
01.11.11;WA13;Schellack, Gummen, Harz, Pflanzensaft;39451;27924;11527
01.11.11;WA14;Flechtstoffe usw. pflanzlichen Ursprungs;759;1807;-1048
01.11.11;WA15;Tierische und pflanzliche Fette, Öle, Wachs;228494;328565;-100071
01.11.11;WA16;Zubereitungen von Fleisch, Fisch usw.;202726;183232;19494
01.11.11;WA17;Zucker und Zuckerwaren;196824;122700;74124
01.11.11;WA18;Kakao und Zubereitungen aus Kakao;360427;286895;73532
01.11.11;WA19;Zubereitungen aus Getreide usw., Backwaren;392049;203817;188232
01.11.11;WA20;Zubereitungen von Gemüse, Früchten usw.;177946;346737;-168791
01.11.11;WA21;Verschiedene Lebensmittelzubereitungen;332911;174289;158622
01.11.11;WA22;Getränke, alkoholhaltige Flüssigkeiten, Essig;397316;583422;-186106
01.11.11;WA23;Rückstände der Lebensmittelindustrie, Futter;264025;246188;17837
01.11.11;WA24;Tabak;354255;198074;156181
01.11.11;WA25;Salz, Schwefel, Steine, Erden usw.;188993;163862;25131
01.11.11;WA26;Erze, Schlacken, Aschen;37832;872272;-834440
01.11.11;WA27;Mineralische Brennstoffe usw.;2371802;11248239;-8876437
01.11.11;WA28;Anorganische chemische Erzeugnisse;598165;466494;131671
01.11.11;WA29;Organische chemische Erzeugnisse;1861512;1833366;28146
01.11.11;WA30;Pharmazeutische Erzeugnisse;4420551;3082908;1337643
01.11.11;WA31;Düngemittel;210278;102919;107359
01.11.11;WA32;Gerb- und Farbstoffe, Farben, Lacke usw.;788763;459801;328962
01.11.11;WA33;Etherische Öle, Riech-, Schönheitsmittel;668446;401984;266462
01.11.11;WA34;Seifen, Waschmittel usw.;502134;267365;234769
01.11.11;WA35;Eiweissstoffe, Klebstoffe, Enzyme;230938;138128;92810
01.11.11;WA36;Sprengstoffe, pyrotechnische Artikel usw.;25993;33977;-7984
01.11.11;WA37;Photochemische Erzeugnisse;84207;63135;21072
01.11.11;WA38;Verschiedene Erzeugnisse der Chemischen Industrie;1498022;909991;588031
01.11.11;WA39;Kunststoffe und Waren daraus;4056306;2461738;1594568
01.11.11;WA40;Kautschuk und Waren daraus;1198241;1185384;12857
01.11.11;WA41;Häute, Felle, Leder;89301;82035;7266
01.11.11;WA42;Lederwaren, Sattlerwaren;133983;254467;-120484
01.11.11;WA43;Pelzfelle, künstliches Pelzwerk;15060;13621;1439
01.11.11;WA44;Holz, Holzwaren, Holzkohle;565797;550451;15346
01.11.11;WA45;Kork, Korkwaren;2651;6727;-4076
01.11.11;WA46;Flechtwaren, Korbmacherwaren;3294;9352;-6058
01.11.11;WA47;Halbstoffe aus Holz usw., Papierabfall;102872;288130;-185258
01.11.11;WA48;Papier, Pappe und Waren daraus;1557159;997024;560135
01.11.11;WA49;Bücher, Zeitungen, Bilddrucke usw.;365830;184309;181521
01.11.11;WA50;Seide;5418;7285;-1867
01.11.11;WA51;Wolle, feine und grobe Tierhaare;63065;72522;-9457
01.11.11;WA52;Baumwolle;106702;104676;2026
01.11.11;WA53;Andere pflanzliche Spinnstoffe, Papiergarn;6257;10459;-4202
01.11.11;WA54;Synthetisches oder künstliches Filament;170062;124127;45935
01.11.11;WA55;Synthetische oder künstliche Spinnfaser;157650;137506;20144
01.11.11;WA56;Watte, Filz, Vliesstoff usw., Tauwerk;172596;90903;81693
01.11.11;WA57;Teppiche, Fussbodenbelag aus Spinnstoff;49902;93737;-43835
01.11.11;WA58;Spezialgewebe, Spitzen, Tapisserien;44442;27394;17048
01.11.11;WA59;Getränkte, bestrichene usw. Gewebe;165305;102043;63262
01.11.11;WA60;Gewirke und Gestricke;80168;39680;40488
01.11.11;WA61;Bekleidung usw. aus Gewirken, Gestricken;517642;1046438;-528796
01.11.11;WA62;Andere Bekleidung, Bekleidungszubehör;505643;984003;-478360
01.11.11;WA63;Andere Konfektion, Spinnstoffwaren usw.;188978;264610;-75632
01.11.11;WA64;Schuhe, Gamaschen, ähnliche Waren;230147;489166;-259019
01.11.11;WA65;Kopfbedeckungen und Teile davon;25115;36927;-11812
01.11.11;WA66;Schirme, Gehstöcke usw., Peitschen;5638;12954;-7316
01.11.11;WA67;Zugerichtete Federn, Daunen, künstliche Blumen;7127;16042;-8915
01.11.11;WA68;Waren aus Steinen, Gips, Zement usw.;312914;214818;98096
01.11.11;WA69;Keramische Waren;245094;186755;58339
01.11.11;WA70;Glas und Glaswaren;440234;332015;108219
01.11.11;WA71;Perlen, Edelsteine, Edelmetalle;1522539;1538098;-15559
01.11.11;WA72;Eisen und Stahl;2111849;2159753;-47904
01.11.11;WA73;Waren aus Eisen oder Stahl;2125485;1472854;652631
01.11.11;WA74;Kupfer und Waren daraus;845867;793709;52158
01.11.11;WA75;Nickel und Waren daraus;90321;142510;-52189
01.11.11;WA76;Aluminium und Waren daraus;1013627;1050219;-36592
01.11.11;WA78;Blei und Waren daraus;35027;24287;10740
01.11.11;WA79;Zink und Waren daraus;53722;85168;-31446
01.11.11;WA80;Zinn und Waren daraus;10923;32714;-21791
01.11.11;WA81;Andere unedle Metalle, Cermets usw.;103454;129099;-25645
01.11.11;WA82;Werkzeuge, Schneidwaren, Essbestecke;563820;364893;198927
01.11.11;WA83;Verschiedene Waren aus unedlen Metallen;547308;331697;215611
01.11.11;WA84;Maschinen, Apparate, mechanische Geräte;16675926;9449241;7226685
01.11.11;WA85;Elektrotechnische Erzeugnisse;9469121;9191556;277565
01.11.11;WA86;Schienenfahrzeuge;302921;106517;196404
01.11.11;WA87;Kraftfahrzeuge, Landfahrzeuge;16174814;6317012;9857802
01.11.11;WA88;Luftfahrzeuge, Raumfahrzeuge;3354184;1648308;1705876
01.11.11;WA89;Wasserfahrzeuge;237161;629207;-392046
01.11.11;WA90;Optische, photografische usw. Erzeugnisse;4394482;2410111;1984371
01.11.11;WA91;Uhrmacherwaren;140369;192100;-51731
01.11.11;WA92;Musikinstrumente;46182;44931;1251
01.11.11;WA93;Waffen und Munition;42793;14274;28519
01.11.11;WA94;Möbel, Beleuchtungskörper usw.;1238498;1231478;7020
01.11.11;WA95;Spielzeug, Spiele usw., Sportgeräte;737218;630308;106910
01.11.11;WA96;Verschiedene Waren;174136;133900;40236
01.11.11;WA97;Kunstgegenstände, Sammlungsstücke;71654;25803;45851
01.11.11;WA98;Vollständige Fabrikationsanlagen;277330;1957;275373
01.11.11;WA99;Zusammenstellungen verschiedener Waren;1357605;1087336;270269
01.11.12;WA01;Lebende Tiere;105361;149022;-43661
01.11.12;WA02;Fleisch;681884;508364;173520
01.11.12;WA03;Fische, Krebs- und Weichtiere;115909;279993;-164084
01.11.12;WA04;Milch, Milcherzeugnisse, Eier, Honig;669344;507294;162050
01.11.12;WA05;Andere Waren tierischen Ursprungs;64114;72146;-8032
01.11.12;WA06;Pflanzen, Waren des Blumenhandels;52888;195956;-143068
01.11.12;WA07;Gemüse, Pflanzen für Ernährung;70513;346670;-276157
01.11.12;WA08;Geniessbare Früchte und Nüsse;106308;579159;-472851
01.11.12;WA09;Kaffee, Tee, Mate, Gewürze;213166;372187;-159021
01.11.12;WA10;Getreide;354985;283583;71402
01.11.12;WA11;Müllereierzeugnisse, Malz usw.;100111;47124;52987
01.11.12;WA12;Ölsamen usw., Heilpflanzen usw.;69118;482283;-413165
01.11.12;WA13;Schellack, Gummen, Harz, Pflanzensaft;40288;35617;4671
01.11.12;WA14;Flechtstoffe usw. pflanzlichen Ursprungs;713;1803;-1090
01.11.12;WA15;Tierische und pflanzliche Fette, Öle, Wachs;253902;280809;-26907
01.11.12;WA16;Zubereitungen von Fleisch, Fisch usw.;204094;207587;-3493
01.11.12;WA17;Zucker und Zuckerwaren;211313;141041;70272
01.11.12;WA18;Kakao und Zubereitungen aus Kakao;383743;273319;110424
01.11.12;WA19;Zubereitungen aus Getreide usw., Backwaren;438850;230805;208045
01.11.12;WA20;Zubereitungen von Gemüse, Früchten usw.;185814;357671;-171857
01.11.12;WA21;Verschiedene Lebensmittelzubereitungen;357881;200053;157828
01.11.12;WA22;Getränke, alkoholhaltige Flüssigkeiten, Essig;424898;608154;-183256
01.11.12;WA23;Rückstände der Lebensmittelindustrie, Futter;334517;307453;27064
01.11.12;WA24;Tabak;325018;169778;155240
01.11.12;WA25;Salz, Schwefel, Steine, Erden usw.;156853;140571;16282
01.11.12;WA26;Erze, Schlacken, Aschen;29363;632792;-603429
01.11.12;WA27;Mineralische Brennstoffe usw.;2215100;10428872;-8213772
01.11.12;WA28;Anorganische chemische Erzeugnisse;648115;580414;67701
01.11.12;WA29;Organische chemische Erzeugnisse;2084116;2740237;-656121
01.11.12;WA30;Pharmazeutische Erzeugnisse;4800410;2920091;1880319
01.11.12;WA31;Düngemittel;237768;121864;115904
01.11.12;WA32;Gerb- und Farbstoffe, Farben, Lacke usw.;785028;343695;441333
01.11.12;WA33;Etherische Öle, Riech-, Schönheitsmittel;737458;425084;312374
01.11.12;WA34;Seifen, Waschmittel usw.;522680;268967;253713
01.11.12;WA35;Eiweissstoffe, Klebstoffe, Enzyme;230225;153054;77171
01.11.12;WA36;Sprengstoffe, pyrotechnische Artikel usw.;19675;27623;-7948
01.11.12;WA37;Photochemische Erzeugnisse;86735;57758;28977
01.11.12;WA38;Verschiedene Erzeugnisse der Chemischen Industrie;1516630;835422;681208
01.11.12;WA39;Kunststoffe und Waren daraus;4123128;2502067;1621061
01.11.12;WA40;Kautschuk und Waren daraus;1158860;994973;163887
01.11.12;WA41;Häute, Felle, Leder;87748;74491;13257
01.11.12;WA42;Lederwaren, Sattlerwaren;126517;244942;-118425
01.11.12;WA43;Pelzfelle, künstliches Pelzwerk;14875;12227;2648
01.11.12;WA44;Holz, Holzwaren, Holzkohle;534691;503438;31253
01.11.12;WA45;Kork, Korkwaren;2478;6767;-4289
01.11.12;WA46;Flechtwaren, Korbmacherwaren;3417;8884;-5467
01.11.12;WA47;Halbstoffe aus Holz usw., Papierabfall;85918;282747;-196829
01.11.12;WA48;Papier, Pappe und Waren daraus;1487732;971514;516218
01.11.12;WA49;Bücher, Zeitungen, Bilddrucke usw.;348314;174352;173962
01.11.12;WA50;Seide;8206;9517;-1311
01.11.12;WA51;Wolle, feine und grobe Tierhaare;55111;65529;-10418
01.11.12;WA52;Baumwolle;102270;96044;6226
01.11.12;WA53;Andere pflanzliche Spinnstoffe, Papiergarn;5329;7551;-2222
01.11.12;WA54;Synthetisches oder künstliches Filament;153446;113526;39920
01.11.12;WA55;Synthetische oder künstliche Spinnfaser;154481;128105;26376
01.11.12;WA56;Watte, Filz, Vliesstoff usw., Tauwerk;171911;90338;81573
01.11.12;WA57;Teppiche, Fussbodenbelag aus Spinnstoff;40844;81292;-40448
01.11.12;WA58;Spezialgewebe, Spitzen, Tapisserien;39139;26123;13016
01.11.12;WA59;Getränkte, bestrichene usw. Gewebe;164001;89891;74110
01.11.12;WA60;Gewirke und Gestricke;65990;38477;27513
01.11.12;WA61;Bekleidung usw. aus Gewirken, Gestricken;483799;1016755;-532956
01.11.12;WA62;Andere Bekleidung, Bekleidungszubehör;457151;943712;-486561
01.11.12;WA63;Andere Konfektion, Spinnstoffwaren usw.;179025;262096;-83071
01.11.12;WA64;Schuhe, Gamaschen, ähnliche Waren;187969;447776;-259807
01.11.12;WA65;Kopfbedeckungen und Teile davon;21579;32426;-10847
01.11.12;WA66;Schirme, Gehstöcke usw., Peitschen;6102;7772;-1670
01.11.12;WA67;Zugerichtete Federn, Daunen, künstliche Blumen;6832;13727;-6895
01.11.12;WA68;Waren aus Steinen, Gips, Zement usw.;287869;201656;86213
01.11.12;WA69;Keramische Waren;239949;187576;52373
01.11.12;WA70;Glas und Glaswaren;421754;312484;109270
01.11.12;WA71;Perlen, Edelsteine, Edelmetalle;1280855;1339877;-59022
01.11.12;WA72;Eisen und Stahl;1937354;1847018;90336
01.11.12;WA73;Waren aus Eisen oder Stahl;2011850;1373020;638830
01.11.12;WA74;Kupfer und Waren daraus;951241;794976;156265
01.11.12;WA75;Nickel und Waren daraus;84616;148616;-64000
01.11.12;WA76;Aluminium und Waren daraus;1025978;990797;35181
01.11.12;WA78;Blei und Waren daraus;37111;17347;19764
01.11.12;WA79;Zink und Waren daraus;50530;85337;-34807
01.11.12;WA80;Zinn und Waren daraus;9982;18928;-8946
01.11.12;WA81;Andere unedle Metalle, Cermets usw.;101906;109760;-7854
01.11.12;WA82;Werkzeuge, Schneidwaren, Essbestecke;574093;331608;242485
01.11.12;WA83;Verschiedene Waren aus unedlen Metallen;533698;308380;225318
01.11.12;WA84;Maschinen, Apparate, mechanische Geräte;16100855;9439114;6661741
01.11.12;WA85;Elektrotechnische Erzeugnisse;9295099;8517602;777497
01.11.12;WA86;Schienenfahrzeuge;293433;190936;102497
01.11.12;WA87;Kraftfahrzeuge, Landfahrzeuge;15713724;6107652;9606072
01.11.12;WA88;Luftfahrzeuge, Raumfahrzeuge;3523639;2383997;1139642
01.11.12;WA89;Wasserfahrzeuge;100902;267439;-166537
01.11.12;WA90;Optische, photografische usw. Erzeugnisse;4545727;2366561;2179166
01.11.12;WA91;Uhrmacherwaren;162699;209531;-46832
01.11.12;WA92;Musikinstrumente;52983;60702;-7719
01.11.12;WA93;Waffen und Munition;42391;15412;26979
01.11.12;WA94;Möbel, Beleuchtungskörper usw.;1150323;1176862;-26539
01.11.12;WA95;Spielzeug, Spiele usw., Sportgeräte;457943;618614;-160671
01.11.12;WA96;Verschiedene Waren;286278;184620;101658
01.11.12;WA97;Kunstgegenstände, Sammlungsstücke;112745;24203;88542
01.11.12;WA98;Vollständige Fabrikationsanlagen;304291;518;303773
01.11.12;WA99;Zusammenstellungen verschiedener Waren;1541695;1002885;538810
01.11.13;WA01;Lebende Tiere;126009;166925;-40916
01.11.13;WA02;Fleisch;661738;517347;144391
01.11.13;WA03;Fische, Krebs- und Weichtiere;109208;293143;-183935
01.11.13;WA04;Milch, Milcherzeugnisse, Eier, Honig;752987;566761;186226
01.11.13;WA05;Andere Waren tierischen Ursprungs;65741;71662;-5921
01.11.13;WA06;Pflanzen, Waren des Blumenhandels;61228;170049;-108821
01.11.13;WA07;Gemüse, Pflanzen für Ernährung;81188;318423;-237235
01.11.13;WA08;Geniessbare Früchte und Nüsse;113752;563142;-449390
01.11.13;WA09;Kaffee, Tee, Mate, Gewürze;186834;271850;-85016
01.11.13;WA10;Getreide;221853;231285;-9432
01.11.13;WA11;Müllereierzeugnisse, Malz usw.;113464;42769;70695
01.11.13;WA12;Ölsamen usw., Heilpflanzen usw.;64533;391481;-326948
01.11.13;WA13;Schellack, Gummen, Harz, Pflanzensaft;37747;28360;9387
01.11.13;WA14;Flechtstoffe usw. pflanzlichen Ursprungs;517;1683;-1166
01.11.13;WA15;Tierische und pflanzliche Fette, Öle, Wachs;230327;289402;-59075
01.11.13;WA16;Zubereitungen von Fleisch, Fisch usw.;219119;195552;23567
01.11.13;WA17;Zucker und Zuckerwaren;174526;132940;41586
01.11.13;WA18;Kakao und Zubereitungen aus Kakao;393685;306518;87167
01.11.13;WA19;Zubereitungen aus Getreide usw., Backwaren;434731;258850;175881
01.11.13;WA20;Zubereitungen von Gemüse, Früchten usw.;184790;337461;-152671
01.11.13;WA21;Verschiedene Lebensmittelzubereitungen;380084;208042;172042
01.11.13;WA22;Getränke, alkoholhaltige Flüssigkeiten, Essig;407452;595886;-188434
01.11.13;WA23;Rückstände der Lebensmittelindustrie, Futter;308438;251407;57031
01.11.13;WA24;Tabak;292941;171033;121908
01.11.13;WA25;Salz, Schwefel, Steine, Erden usw.;151375;155332;-3957
01.11.13;WA26;Erze, Schlacken, Aschen;26208;650155;-623947
01.11.13;WA27;Mineralische Brennstoffe usw.;2313575;11004024;-8690449
01.11.13;WA28;Anorganische chemische Erzeugnisse;627296;517123;110173
01.11.13;WA29;Organische chemische Erzeugnisse;2139156;2166469;-27313
01.11.13;WA30;Pharmazeutische Erzeugnisse;5062138;2913080;2149058
01.11.13;WA31;Düngemittel;173092;122962;50130
01.11.13;WA32;Gerb- und Farbstoffe, Farben, Lacke usw.;838886;460257;378629
01.11.13;WA33;Etherische Öle, Riech-, Schönheitsmittel;704083;429156;274927
01.11.13;WA34;Seifen, Waschmittel usw.;526455;273087;253368
01.11.13;WA35;Eiweissstoffe, Klebstoffe, Enzyme;233657;156432;77225
01.11.13;WA36;Sprengstoffe, pyrotechnische Artikel usw.;25622;29534;-3912
01.11.13;WA37;Photochemische Erzeugnisse;94134;67075;27059
01.11.13;WA38;Verschiedene Erzeugnisse der Chemischen Industrie;1605561;894554;711007
01.11.13;WA39;Kunststoffe und Waren daraus;4190696;2584811;1605885
01.11.13;WA40;Kautschuk und Waren daraus;1178234;1086593;91641
01.11.13;WA41;Häute, Felle, Leder;99672;72340;27332
01.11.13;WA42;Lederwaren, Sattlerwaren;130308;269365;-139057
01.11.13;WA43;Pelzfelle, künstliches Pelzwerk;13411;11665;1746
01.11.13;WA44;Holz, Holzwaren, Holzkohle;568739;553175;15564
01.11.13;WA45;Kork, Korkwaren;1959;5628;-3669
01.11.13;WA46;Flechtwaren, Korbmacherwaren;2906;8230;-5324
01.11.13;WA47;Halbstoffe aus Holz usw., Papierabfall;95167;305442;-210275
01.11.13;WA48;Papier, Pappe und Waren daraus;1382023;932045;449978
01.11.13;WA49;Bücher, Zeitungen, Bilddrucke usw.;374572;158540;216032
01.11.13;WA50;Seide;5950;5740;210
01.11.13;WA51;Wolle, feine und grobe Tierhaare;36762;52457;-15695
01.11.13;WA52;Baumwolle;93865;95840;-1975
01.11.13;WA53;Andere pflanzliche Spinnstoffe, Papiergarn;4259;7624;-3365
01.11.13;WA54;Synthetisches oder künstliches Filament;156905;121212;35693
01.11.13;WA55;Synthetische oder künstliche Spinnfaser;162088;124869;37219
01.11.13;WA56;Watte, Filz, Vliesstoff usw., Tauwerk;176976;92064;84912
01.11.13;WA57;Teppiche, Fussbodenbelag aus Spinnstoff;39914;80072;-40158
01.11.13;WA58;Spezialgewebe, Spitzen, Tapisserien;39564;23964;15600
01.11.13;WA59;Getränkte, bestrichene usw. Gewebe;169381;88242;81139
01.11.13;WA60;Gewirke und Gestricke;65640;34802;30838
01.11.13;WA61;Bekleidung usw. aus Gewirken, Gestricken;490174;1067563;-577389
01.11.13;WA62;Andere Bekleidung, Bekleidungszubehör;476473;941793;-465320
01.11.13;WA63;Andere Konfektion, Spinnstoffwaren usw.;173896;244732;-70836
01.11.13;WA64;Schuhe, Gamaschen, ähnliche Waren;203793;491733;-287940
01.11.13;WA65;Kopfbedeckungen und Teile davon;24495;34051;-9556
01.11.13;WA66;Schirme, Gehstöcke usw., Peitschen;4530;7357;-2827
01.11.13;WA67;Zugerichtete Federn, Daunen, künstliche Blumen;6316;10697;-4381
01.11.13;WA68;Waren aus Steinen, Gips, Zement usw.;304700;211438;93262
01.11.13;WA69;Keramische Waren;242295;186876;55419
01.11.13;WA70;Glas und Glaswaren;450638;366347;84291
01.11.13;WA71;Perlen, Edelsteine, Edelmetalle;876255;1383245;-506990
01.11.13;WA72;Eisen und Stahl;1737445;1785640;-48195
01.11.13;WA73;Waren aus Eisen oder Stahl;2048048;1440183;607865
01.11.13;WA74;Kupfer und Waren daraus;873324;807932;65392
01.11.13;WA75;Nickel und Waren daraus;76953;112039;-35086
01.11.13;WA76;Aluminium und Waren daraus;1001723;1042358;-40635
01.11.13;WA78;Blei und Waren daraus;40225;21894;18331
01.11.13;WA79;Zink und Waren daraus;48751;86342;-37591
01.11.13;WA80;Zinn und Waren daraus;9947;27113;-17166
01.11.13;WA81;Andere unedle Metalle, Cermets usw.;107044;97142;9902
01.11.13;WA82;Werkzeuge, Schneidwaren, Essbestecke;586065;335253;250812
01.11.13;WA83;Verschiedene Waren aus unedlen Metallen;527097;302252;224845
01.11.13;WA84;Maschinen, Apparate, mechanische Geräte;15908402;9263817;6644585
01.11.13;WA85;Elektrotechnische Erzeugnisse;9355942;8529499;826443
01.11.13;WA86;Schienenfahrzeuge;253653;139779;113874
01.11.13;WA87;Kraftfahrzeuge, Landfahrzeuge;16505575;6457841;10047734
01.11.13;WA88;Luftfahrzeuge, Raumfahrzeuge;3460865;1894027;1566838
01.11.13;WA89;Wasserfahrzeuge;660552;485927;174625
01.11.13;WA90;Optische, photografische usw. Erzeugnisse;4354250;2345540;2008710
01.11.13;WA91;Uhrmacherwaren;171983;218463;-46480
01.11.13;WA92;Musikinstrumente;52644;46331;6313
01.11.13;WA93;Waffen und Munition;41377;18064;23313
01.11.13;WA94;Möbel, Beleuchtungskörper usw.;1138214;1222244;-84030
01.11.13;WA95;Spielzeug, Spiele usw., Sportgeräte;413405;450137;-36732
01.11.13;WA96;Verschiedene Waren;269266;183646;85620
01.11.13;WA97;Kunstgegenstände, Sammlungsstücke;79236;40442;38794
01.11.13;WA98;Vollständige Fabrikationsanlagen;253762;606;253156
01.11.13;WA99;Zusammenstellungen verschiedener Waren;1615547;778099;837448
01.11.14;WA01;Lebende Tiere;113674;145366;-31692
01.11.14;WA02;Fleisch;645104;504421;140683
01.11.14;WA03;Fische, Krebs- und Weichtiere;118970;316015;-197045
01.11.14;WA04;Milch, Milcherzeugnisse, Eier, Honig;693201;554109;139092
01.11.14;WA05;Andere Waren tierischen Ursprungs;68004;68801;-797
01.11.14;WA06;Pflanzen, Waren des Blumenhandels;60810;192093;-131283
01.11.14;WA07;Gemüse, Pflanzen für Ernährung;62168;368008;-305840
01.11.14;WA08;Geniessbare Früchte und Nüsse;130494;652309;-521815
01.11.14;WA09;Kaffee, Tee, Mate, Gewürze;226251;335959;-109708
01.11.14;WA10;Getreide;198345;212484;-14139
01.11.14;WA11;Müllereierzeugnisse, Malz usw.;119884;41364;78520
01.11.14;WA12;Ölsamen usw., Heilpflanzen usw.;74699;358390;-283691
01.11.14;WA13;Schellack, Gummen, Harz, Pflanzensaft;39489;33096;6393
01.11.14;WA14;Flechtstoffe usw. pflanzlichen Ursprungs;694;2840;-2146
01.11.14;WA15;Tierische und pflanzliche Fette, Öle, Wachs;185870;276441;-90571
01.11.14;WA16;Zubereitungen von Fleisch, Fisch usw.;217765;184734;33031
01.11.14;WA17;Zucker und Zuckerwaren;182720;132469;50251
01.11.14;WA18;Kakao und Zubereitungen aus Kakao;465353;386808;78545
01.11.14;WA19;Zubereitungen aus Getreide usw., Backwaren;451175;287130;164045
01.11.14;WA20;Zubereitungen von Gemüse, Früchten usw.;184329;366110;-181781
01.11.14;WA21;Verschiedene Lebensmittelzubereitungen;380907;219924;160983
01.11.14;WA22;Getränke, alkoholhaltige Flüssigkeiten, Essig;404253;527787;-123534
01.11.14;WA23;Rückstände der Lebensmittelindustrie, Futter;306958;323291;-16333
01.11.14;WA24;Tabak;302852;173412;129440
01.11.14;WA25;Salz, Schwefel, Steine, Erden usw.;154223;143646;10577
01.11.14;WA26;Erze, Schlacken, Aschen;29677;708284;-678607
01.11.14;WA27;Mineralische Brennstoffe usw.;2293261;9536368;-7243107
01.11.14;WA28;Anorganische chemische Erzeugnisse;645912;518435;127477
01.11.14;WA29;Organische chemische Erzeugnisse;1967804;2270914;-303110
01.11.14;WA30;Pharmazeutische Erzeugnisse;5246312;3145725;2100587
01.11.14;WA31;Düngemittel;191560;121172;70388
01.11.14;WA32;Gerb- und Farbstoffe, Farben, Lacke usw.;836474;455942;380532
01.11.14;WA33;Etherische Öle, Riech-, Schönheitsmittel;718652;467984;250668
01.11.14;WA34;Seifen, Waschmittel usw.;522554;276836;245718
01.11.14;WA35;Eiweissstoffe, Klebstoffe, Enzyme;242943;178364;64579
01.11.14;WA36;Sprengstoffe, pyrotechnische Artikel usw.;19734;30104;-10370
01.11.14;WA37;Photochemische Erzeugnisse;90305;64747;25558
01.11.14;WA38;Verschiedene Erzeugnisse der Chemischen Industrie;1604416;942946;661470
01.11.14;WA39;Kunststoffe und Waren daraus;4207475;2617723;1589752
01.11.14;WA40;Kautschuk und Waren daraus;1096574;971313;125261
01.11.14;WA41;Häute, Felle, Leder;101900;80314;21586
01.11.14;WA42;Lederwaren, Sattlerwaren;144537;303476;-158939
01.11.14;WA43;Pelzfelle, künstliches Pelzwerk;12289;11554;735
01.11.14;WA44;Holz, Holzwaren, Holzkohle;542060;546797;-4737
01.11.14;WA45;Kork, Korkwaren;1907;7019;-5112
01.11.14;WA46;Flechtwaren, Korbmacherwaren;3052;10117;-7065
01.11.14;WA47;Halbstoffe aus Holz usw., Papierabfall;85706;283167;-197461
01.11.14;WA48;Papier, Pappe und Waren daraus;1350230;958685;391545
01.11.14;WA49;Bücher, Zeitungen, Bilddrucke usw.;371259;193154;178105
01.11.14;WA50;Seide;6330;6732;-402
01.11.14;WA51;Wolle, feine und grobe Tierhaare;35919;50236;-14317
01.11.14;WA52;Baumwolle;85193;84322;871
01.11.14;WA53;Andere pflanzliche Spinnstoffe, Papiergarn;4448;6702;-2254
01.11.14;WA54;Synthetisches oder künstliches Filament;155083;116852;38231
01.11.14;WA55;Synthetische oder künstliche Spinnfaser;152064;123934;28130
01.11.14;WA56;Watte, Filz, Vliesstoff usw., Tauwerk;175265;99126;76139
01.11.14;WA57;Teppiche, Fussbodenbelag aus Spinnstoff;39108;89764;-50656
01.11.14;WA58;Spezialgewebe, Spitzen, Tapisserien;40100;23431;16669
01.11.14;WA59;Getränkte, bestrichene usw. Gewebe;158080;86451;71629
01.11.14;WA60;Gewirke und Gestricke;65601;34848;30753
01.11.14;WA61;Bekleidung usw. aus Gewirken, Gestricken;503016;1165212;-662196
01.11.14;WA62;Andere Bekleidung, Bekleidungszubehör;479694;1023270;-543576
01.11.14;WA63;Andere Konfektion, Spinnstoffwaren usw.;204464;292255;-87791
01.11.14;WA64;Schuhe, Gamaschen, ähnliche Waren;239240;531357;-292117
01.11.14;WA65;Kopfbedeckungen und Teile davon;26709;36099;-9390
01.11.14;WA66;Schirme, Gehstöcke usw., Peitschen;5305;12901;-7596
01.11.14;WA67;Zugerichtete Federn, Daunen, künstliche Blumen;6419;12668;-6249
01.11.14;WA68;Waren aus Steinen, Gips, Zement usw.;313355;214941;98414
01.11.14;WA69;Keramische Waren;237527;194911;42616
01.11.14;WA70;Glas und Glaswaren;455233;372754;82479
01.11.14;WA71;Perlen, Edelsteine, Edelmetalle;991132;1342899;-351767
01.11.14;WA72;Eisen und Stahl;1728964;1857574;-128610
01.11.14;WA73;Waren aus Eisen oder Stahl;2048503;1476972;571531
01.11.14;WA74;Kupfer und Waren daraus;861606;772907;88699
01.11.14;WA75;Nickel und Waren daraus;97035;125325;-28290
01.11.14;WA76;Aluminium und Waren daraus;1100497;1249628;-149131
01.11.14;WA78;Blei und Waren daraus;48134;32961;15173
01.11.14;WA79;Zink und Waren daraus;54759;104679;-49920
01.11.14;WA80;Zinn und Waren daraus;7978;28248;-20270
01.11.14;WA81;Andere unedle Metalle, Cermets usw.;114494;139524;-25030
01.11.14;WA82;Werkzeuge, Schneidwaren, Essbestecke;609013;354689;254324
01.11.14;WA83;Verschiedene Waren aus unedlen Metallen;563909;339398;224511
01.11.14;WA84;Maschinen, Apparate, mechanische Geräte;16574378;9716384;6857994
01.11.14;WA85;Elektrotechnische Erzeugnisse;9490278;9200057;290221
01.11.14;WA86;Schienenfahrzeuge;331235;166614;164621
01.11.14;WA87;Kraftfahrzeuge, Landfahrzeuge;17215667;6757770;10457897
01.11.14;WA88;Luftfahrzeuge, Raumfahrzeuge;2815824;1835627;980197
01.11.14;WA89;Wasserfahrzeuge;205726;111840;93886
01.11.14;WA90;Optische, photografische usw. Erzeugnisse;4398811;2550560;1848251
01.11.14;WA91;Uhrmacherwaren;185458;207895;-22437
01.11.14;WA92;Musikinstrumente;49487;48437;1050
01.11.14;WA93;Waffen und Munition;31767;12416;19351
01.11.14;WA94;Möbel, Beleuchtungskörper usw.;1152382;1383709;-231327
01.11.14;WA95;Spielzeug, Spiele usw., Sportgeräte;393148;605050;-211902
01.11.14;WA96;Verschiedene Waren;275860;207572;68288
01.11.14;WA97;Kunstgegenstände, Sammlungsstücke;44583;21132;23451
01.11.14;WA98;Vollständige Fabrikationsanlagen;227490;2979;224511
01.11.14;WA99;Zusammenstellungen verschiedener Waren;1781641;774513;1007128
01.11.15;WA01;Lebende Tiere;129715;130802;-1087
01.11.15;WA02;Fleisch;635417;535238;100179
01.11.15;WA03;Fische, Krebs- und Weichtiere;134191;342018;-207827
01.11.15;WA04;Milch, Milcherzeugnisse, Eier, Honig;677881;627187;50694
01.11.15;WA05;Andere Waren tierischen Ursprungs;66209;72115;-5906
01.11.15;WA06;Pflanzen, Waren des Blumenhandels;57716;183319;-125603
01.11.15;WA07;Gemüse, Pflanzen für Ernährung;96411;425914;-329503
01.11.15;WA08;Geniessbare Früchte und Nüsse;174117;840892;-666775
01.11.15;WA09;Kaffee, Tee, Mate, Gewürze;230035;324801;-94766
01.11.15;WA10;Getreide;182254;188473;-6219
01.11.15;WA11;Müllereierzeugnisse, Malz usw.;120217;50180;70037
01.11.15;WA12;Ölsamen usw., Heilpflanzen usw.;90017;402145;-312128
01.11.15;WA13;Schellack, Gummen, Harz, Pflanzensaft;47230;35864;11366
01.11.15;WA14;Flechtstoffe usw. pflanzlichen Ursprungs;564;3078;-2514
01.11.15;WA15;Tierische und pflanzliche Fette, Öle, Wachs;215171;341192;-126021
01.11.15;WA16;Zubereitungen von Fleisch, Fisch usw.;237398;207465;29933
01.11.15;WA17;Zucker und Zuckerwaren;161333;139880;21453
01.11.15;WA18;Kakao und Zubereitungen aus Kakao;542059;443634;98425
01.11.15;WA19;Zubereitungen aus Getreide usw., Backwaren;508293;356971;151322
01.11.15;WA20;Zubereitungen von Gemüse, Früchten usw.;209751;436177;-226426
01.11.15;WA21;Verschiedene Lebensmittelzubereitungen;395671;237403;158268
01.11.15;WA22;Getränke, alkoholhaltige Flüssigkeiten, Essig;449803;598825;-149022
01.11.15;WA23;Rückstände der Lebensmittelindustrie, Futter;341601;308388;33213
01.11.15;WA24;Tabak;382067;200790;181277
01.11.15;WA25;Salz, Schwefel, Steine, Erden usw.;175874;151294;24580
01.11.15;WA26;Erze, Schlacken, Aschen;25595;435338;-409743
01.11.15;WA27;Mineralische Brennstoffe usw.;2068592;7066506;-4997914
01.11.15;WA28;Anorganische chemische Erzeugnisse;666518;494179;172339
01.11.15;WA29;Organische chemische Erzeugnisse;1870301;2477744;-607443
01.11.15;WA30;Pharmazeutische Erzeugnisse;6258875;3534643;2724232
01.11.15;WA31;Düngemittel;210682;98499;112183
01.11.15;WA32;Gerb- und Farbstoffe, Farben, Lacke usw.;878984;475909;403075
01.11.15;WA33;Etherische Öle, Riech-, Schönheitsmittel;743188;530595;212593
01.11.15;WA34;Seifen, Waschmittel usw.;558643;321059;237584
01.11.15;WA35;Eiweissstoffe, Klebstoffe, Enzyme;266198;178901;87297
01.11.15;WA36;Sprengstoffe, pyrotechnische Artikel usw.;23807;30068;-6261
01.11.15;WA37;Photochemische Erzeugnisse;98369;59959;38410
01.11.15;WA38;Verschiedene Erzeugnisse der Chemischen Industrie;1725714;1034802;690912
01.11.15;WA39;Kunststoffe und Waren daraus;4485563;2950198;1535365
01.11.15;WA40;Kautschuk und Waren daraus;1180836;1051794;129042
01.11.15;WA41;Häute, Felle, Leder;92037;71990;20047
01.11.15;WA42;Lederwaren, Sattlerwaren;155586;335988;-180402
01.11.15;WA43;Pelzfelle, künstliches Pelzwerk;10049;10959;-910
01.11.15;WA44;Holz, Holzwaren, Holzkohle;602046;609552;-7506
01.11.15;WA45;Kork, Korkwaren;2333;7079;-4746
01.11.15;WA46;Flechtwaren, Korbmacherwaren;3411;11973;-8562
01.11.15;WA47;Halbstoffe aus Holz usw., Papierabfall;98595;328527;-229932
01.11.15;WA48;Papier, Pappe und Waren daraus;1413943;1052322;361621
01.11.15;WA49;Bücher, Zeitungen, Bilddrucke usw.;401159;243552;157607
01.11.15;WA50;Seide;2903;4314;-1411
01.11.15;WA51;Wolle, feine und grobe Tierhaare;42991;45052;-2061
01.11.15;WA52;Baumwolle;79292;84733;-5441
01.11.15;WA53;Andere pflanzliche Spinnstoffe, Papiergarn;4837;7870;-3033
01.11.15;WA54;Synthetisches oder künstliches Filament;158867;129723;29144
01.11.15;WA55;Synthetische oder künstliche Spinnfaser;155476;126865;28611
01.11.15;WA56;Watte, Filz, Vliesstoff usw., Tauwerk;198498;108439;90059
01.11.15;WA57;Teppiche, Fussbodenbelag aus Spinnstoff;46838;92575;-45737
01.11.15;WA58;Spezialgewebe, Spitzen, Tapisserien;41109;23493;17616
01.11.15;WA59;Getränkte, bestrichene usw. Gewebe;184837;91406;93431
01.11.15;WA60;Gewirke und Gestricke;67842;39473;28369
01.11.15;WA61;Bekleidung usw. aus Gewirken, Gestricken;549588;1203542;-653954
01.11.15;WA62;Andere Bekleidung, Bekleidungszubehör;501238;1071459;-570221
01.11.15;WA63;Andere Konfektion, Spinnstoffwaren usw.;210208;294566;-84358
01.11.15;WA64;Schuhe, Gamaschen, ähnliche Waren;296873;617177;-320304
01.11.15;WA65;Kopfbedeckungen und Teile davon;27909;42518;-14609
01.11.15;WA66;Schirme, Gehstöcke usw., Peitschen;6736;10316;-3580
01.11.15;WA67;Zugerichtete Federn, Daunen, künstliche Blumen;7700;15087;-7387
01.11.15;WA68;Waren aus Steinen, Gips, Zement usw.;345701;239196;106505
01.11.15;WA69;Keramische Waren;269957;225761;44196
01.11.15;WA70;Glas und Glaswaren;499015;411172;87843
01.11.15;WA71;Perlen, Edelsteine, Edelmetalle;957905;1119726;-161821
01.11.15;WA72;Eisen und Stahl;1563685;1776303;-212618
01.11.15;WA73;Waren aus Eisen oder Stahl;2187306;1610099;577207
01.11.15;WA74;Kupfer und Waren daraus;796794;782708;14086
01.11.15;WA75;Nickel und Waren daraus;79825;101208;-21383
01.11.15;WA76;Aluminium und Waren daraus;1155716;1179471;-23755
01.11.15;WA78;Blei und Waren daraus;32434;32892;-458
01.11.15;WA79;Zink und Waren daraus;45941;88912;-42971
01.11.15;WA80;Zinn und Waren daraus;8846;21524;-12678
01.11.15;WA81;Andere unedle Metalle, Cermets usw.;113704;129993;-16289
01.11.15;WA82;Werkzeuge, Schneidwaren, Essbestecke;647833;409440;238393
01.11.15;WA83;Verschiedene Waren aus unedlen Metallen;564839;366064;198775
01.11.15;WA84;Maschinen, Apparate, mechanische Geräte;17279439;10976857;6302582
01.11.15;WA85;Elektrotechnische Erzeugnisse;10646864;10745712;-98848
01.11.15;WA86;Schienenfahrzeuge;209338;176763;32575
01.11.15;WA87;Kraftfahrzeuge, Landfahrzeuge;19448420;8261689;11186731
01.11.15;WA88;Luftfahrzeuge, Raumfahrzeuge;2912198;1584430;1327768
01.11.15;WA89;Wasserfahrzeuge;308590;277317;31273
01.11.15;WA90;Optische, photografische usw. Erzeugnisse;4957465;2893275;2064190
01.11.15;WA91;Uhrmacherwaren;207074;232213;-25139
01.11.15;WA92;Musikinstrumente;58210;60421;-2211
01.11.15;WA93;Waffen und Munition;40303;15092;25211
01.11.15;WA94;Möbel, Beleuchtungskörper usw.;1361310;1531514;-170204
01.11.15;WA95;Spielzeug, Spiele usw., Sportgeräte;498737;636485;-137748
01.11.15;WA96;Verschiedene Waren;324290;232103;92187
01.11.15;WA97;Kunstgegenstände, Sammlungsstücke;76479;42324;34155
01.11.15;WA98;Vollständige Fabrikationsanlagen;255162;1438;253724
01.11.15;WA99;Zusammenstellungen verschiedener Waren;2144901;1012365;1132536
01.11.16;WA01;Lebende Tiere;115918;184534;-68616
01.11.16;WA02;Fleisch;717364;605853;111511
01.11.16;WA03;Fische, Krebs- und Weichtiere;154359;396987;-242628
01.11.16;WA04;Milch, Milcherzeugnisse, Eier, Honig;697807;653638;44169
01.11.16;WA05;Andere Waren tierischen Ursprungs;71384;80139;-8755
01.11.16;WA06;Pflanzen, Waren des Blumenhandels;64804;208883;-144079
01.11.16;WA07;Gemüse, Pflanzen für Ernährung;85231;439078;-353847
01.11.16;WA08;Geniessbare Früchte und Nüsse;165626;817667;-652041
01.11.16;WA09;Kaffee, Tee, Mate, Gewürze;245994;395997;-150003
01.11.16;WA10;Getreide;185446;235155;-49709
01.11.16;WA11;Müllereierzeugnisse, Malz usw.;118838;49900;68938
01.11.16;WA12;Ölsamen usw., Heilpflanzen usw.;107073;412086;-305013
01.11.16;WA13;Schellack, Gummen, Harz, Pflanzensaft;51679;32471;19208
01.11.16;WA14;Flechtstoffe usw. pflanzlichen Ursprungs;456;3258;-2802
01.11.16;WA15;Tierische und pflanzliche Fette, Öle, Wachs;252868;351578;-98710
01.11.16;WA16;Zubereitungen von Fleisch, Fisch usw.;234762;227574;7188
01.11.16;WA17;Zucker und Zuckerwaren;195404;131232;64172
01.11.16;WA18;Kakao und Zubereitungen aus Kakao;539241;436431;102810
01.11.16;WA19;Zubereitungen aus Getreide usw., Backwaren;540725;363555;177170
01.11.16;WA20;Zubereitungen von Gemüse, Früchten usw.;222166;418904;-196738
01.11.16;WA21;Verschiedene Lebensmittelzubereitungen;439700;264054;175646
01.11.16;WA22;Getränke, alkoholhaltige Flüssigkeiten, Essig;493427;671512;-178085
01.11.16;WA23;Rückstände der Lebensmittelindustrie, Futter;353294;337422;15872
01.11.16;WA24;Tabak;395343;173720;221623
01.11.16;WA25;Salz, Schwefel, Steine, Erden usw.;169271;147521;21750
01.11.16;WA26;Erze, Schlacken, Aschen;37713;476429;-438716
01.11.16;WA27;Mineralische Brennstoffe usw.;1792205;6825502;-5033297
01.11.16;WA28;Anorganische chemische Erzeugnisse;644704;506463;138241
01.11.16;WA29;Organische chemische Erzeugnisse;1931609;2522228;-590619
01.11.16;WA30;Pharmazeutische Erzeugnisse;6238882;3767590;2471292
01.11.16;WA31;Düngemittel;166121;83258;82863
01.11.16;WA32;Gerb- und Farbstoffe, Farben, Lacke usw.;914281;511159;403122
01.11.16;WA33;Etherische Öle, Riech-, Schönheitsmittel;802363;599303;203060
01.11.16;WA34;Seifen, Waschmittel usw.;616577;343159;273418
01.11.16;WA35;Eiweissstoffe, Klebstoffe, Enzyme;277335;169604;107731
01.11.16;WA36;Sprengstoffe, pyrotechnische Artikel usw.;29645;36765;-7120
01.11.16;WA37;Photochemische Erzeugnisse;111717;70948;40769
01.11.16;WA38;Verschiedene Erzeugnisse der Chemischen Industrie;1909138;1065811;843327
01.11.16;WA39;Kunststoffe und Waren daraus;4787580;3058446;1729134
01.11.16;WA40;Kautschuk und Waren daraus;1286044;1135637;150407
01.11.16;WA41;Häute, Felle, Leder;88939;76215;12724
01.11.16;WA42;Lederwaren, Sattlerwaren;185080;336772;-151692
01.11.16;WA43;Pelzfelle, künstliches Pelzwerk;11159;11489;-330
01.11.16;WA44;Holz, Holzwaren, Holzkohle;649913;631388;18525
01.11.16;WA45;Kork, Korkwaren;2641;8540;-5899
01.11.16;WA46;Flechtwaren, Korbmacherwaren;2905;8398;-5493
01.11.16;WA47;Halbstoffe aus Holz usw., Papierabfall;98773;326542;-227769
01.11.16;WA48;Papier, Pappe und Waren daraus;1487706;1050779;436927
01.11.16;WA49;Bücher, Zeitungen, Bilddrucke usw.;402078;241687;160391
01.11.16;WA50;Seide;3684;3198;486
01.11.16;WA51;Wolle, feine und grobe Tierhaare;49594;60014;-10420
01.11.16;WA52;Baumwolle;79577;84657;-5080
01.11.16;WA53;Andere pflanzliche Spinnstoffe, Papiergarn;4247;7129;-2882
01.11.16;WA54;Synthetisches oder künstliches Filament;156975;126800;30175
01.11.16;WA55;Synthetische oder künstliche Spinnfaser;144068;125746;18322
01.11.16;WA56;Watte, Filz, Vliesstoff usw., Tauwerk;193399;107046;86353
01.11.16;WA57;Teppiche, Fussbodenbelag aus Spinnstoff;51760;96692;-44932
01.11.16;WA58;Spezialgewebe, Spitzen, Tapisserien;46910;22829;24081
01.11.16;WA59;Getränkte, bestrichene usw. Gewebe;200737;95960;104777
01.11.16;WA60;Gewirke und Gestricke;68629;40854;27775
01.11.16;WA61;Bekleidung usw. aus Gewirken, Gestricken;607332;1369881;-762549
01.11.16;WA62;Andere Bekleidung, Bekleidungszubehör;579618;1191123;-611505
01.11.16;WA63;Andere Konfektion, Spinnstoffwaren usw.;217170;314852;-97682
01.11.16;WA64;Schuhe, Gamaschen, ähnliche Waren;357724;711454;-353730
01.11.16;WA65;Kopfbedeckungen und Teile davon;30743;41999;-11256
01.11.16;WA66;Schirme, Gehstöcke usw., Peitschen;6243;13562;-7319
01.11.16;WA67;Zugerichtete Federn, Daunen, künstliche Blumen;9038;15699;-6661
01.11.16;WA68;Waren aus Steinen, Gips, Zement usw.;370486;250294;120192
01.11.16;WA69;Keramische Waren;268240;240323;27917
01.11.16;WA70;Glas und Glaswaren;526853;444099;82754
01.11.16;WA71;Perlen, Edelsteine, Edelmetalle;1007633;1267176;-259543
01.11.16;WA72;Eisen und Stahl;1677605;1934723;-257118
01.11.16;WA73;Waren aus Eisen oder Stahl;2300720;1657955;642765
01.11.16;WA74;Kupfer und Waren daraus;852256;753328;98928
01.11.16;WA75;Nickel und Waren daraus;82007;110232;-28225
01.11.16;WA76;Aluminium und Waren daraus;1195070;1335077;-140007
01.11.16;WA78;Blei und Waren daraus;28307;41449;-13142
01.11.16;WA79;Zink und Waren daraus;52879;122746;-69867
01.11.16;WA80;Zinn und Waren daraus;10565;35077;-24512
01.11.16;WA81;Andere unedle Metalle, Cermets usw.;118813;136224;-17411
01.11.16;WA82;Werkzeuge, Schneidwaren, Essbestecke;715048;412629;302419
01.11.16;WA83;Verschiedene Waren aus unedlen Metallen;605722;379760;225962
01.11.16;WA84;Maschinen, Apparate, mechanische Geräte;17894708;11027956;6866752
01.11.16;WA85;Elektrotechnische Erzeugnisse;11351628;11120148;231480
01.11.16;WA86;Schienenfahrzeuge;359218;236014;123204
01.11.16;WA87;Kraftfahrzeuge, Landfahrzeuge;20340169;9439038;10901131
01.11.16;WA88;Luftfahrzeuge, Raumfahrzeuge;3750082;1255593;2494489
01.11.16;WA89;Wasserfahrzeuge;243521;205498;38023
01.11.16;WA90;Optische, photografische usw. Erzeugnisse;5447246;3093402;2353844
01.11.16;WA91;Uhrmacherwaren;179007;208787;-29780
01.11.16;WA92;Musikinstrumente;61167;61131;36
01.11.16;WA93;Waffen und Munition;48356;18851;29505
01.11.16;WA94;Möbel, Beleuchtungskörper usw.;1396523;1571053;-174530
01.11.16;WA95;Spielzeug, Spiele usw., Sportgeräte;458670;714934;-256264
01.11.16;WA96;Verschiedene Waren;328692;234189;94503
01.11.16;WA97;Kunstgegenstände, Sammlungsstücke;55171;32794;22377
01.11.16;WA98;Vollständige Fabrikationsanlagen;191493;39;191454
01.11.16;WA99;Zusammenstellungen verschiedener Waren;1817013;984975;832038
01.11.17;WA01;Lebende Tiere;120841;145841;-25000
01.11.17;WA02;Fleisch;699853;627355;72498
01.11.17;WA03;Fische, Krebs- und Weichtiere;146984;396625;-249641
01.11.17;WA04;Milch, Milcherzeugnisse, Eier, Honig;749204;784588;-35384
01.11.17;WA05;Andere Waren tierischen Ursprungs;78275;86612;-8337
01.11.17;WA06;Pflanzen, Waren des Blumenhandels;62838;191568;-128730
01.11.17;WA07;Gemüse, Pflanzen für Ernährung;72348;442059;-369711
01.11.17;WA08;Geniessbare Früchte und Nüsse;170090;888145;-718055
01.11.17;WA09;Kaffee, Tee, Mate, Gewürze;287684;391161;-103477
01.11.17;WA10;Getreide;128638;211678;-83040
01.11.17;WA11;Müllereierzeugnisse, Malz usw.;129078;49740;79338
01.11.17;WA12;Ölsamen usw., Heilpflanzen usw.;117724;451872;-334148
01.11.17;WA13;Schellack, Gummen, Harz, Pflanzensaft;50651;41934;8717
01.11.17;WA14;Flechtstoffe usw. pflanzlichen Ursprungs;629;3309;-2680
01.11.17;WA15;Tierische und pflanzliche Fette, Öle, Wachs;214557;331865;-117308
01.11.17;WA16;Zubereitungen von Fleisch, Fisch usw.;251831;245604;6227
01.11.17;WA17;Zucker und Zuckerwaren;248389;136329;112060
01.11.17;WA18;Kakao und Zubereitungen aus Kakao;524676;417520;107156
01.11.17;WA19;Zubereitungen aus Getreide usw., Backwaren;570284;406041;164243
01.11.17;WA20;Zubereitungen von Gemüse, Früchten usw.;234800;458880;-224080
01.11.17;WA21;Verschiedene Lebensmittelzubereitungen;479025;300118;178907
01.11.17;WA22;Getränke, alkoholhaltige Flüssigkeiten, Essig;526610;687958;-161348
01.11.17;WA23;Rückstände der Lebensmittelindustrie, Futter;354772;320116;34656
01.11.17;WA24;Tabak;316675;224059;92616
01.11.17;WA25;Salz, Schwefel, Steine, Erden usw.;173037;158144;14893
01.11.17;WA26;Erze, Schlacken, Aschen;45455;644350;-598895
01.11.17;WA27;Mineralische Brennstoffe usw.;2085656;7401313;-5315657
01.11.17;WA28;Anorganische chemische Erzeugnisse;818250;531386;286864
01.11.17;WA29;Organische chemische Erzeugnisse;2192337;2545172;-352835
01.11.17;WA30;Pharmazeutische Erzeugnisse;6726003;4377131;2348872
01.11.17;WA31;Düngemittel;188075;102749;85326
01.11.17;WA32;Gerb- und Farbstoffe, Farben, Lacke usw.;931982;519174;412808
01.11.17;WA33;Etherische Öle, Riech-, Schönheitsmittel;866608;666193;200415
01.11.17;WA34;Seifen, Waschmittel usw.;669909;373867;296042
01.11.17;WA35;Eiweissstoffe, Klebstoffe, Enzyme;311970;193249;118721
01.11.17;WA36;Sprengstoffe, pyrotechnische Artikel usw.;28439;27415;1024
01.11.17;WA37;Photochemische Erzeugnisse;104186;74421;29765
01.11.17;WA38;Verschiedene Erzeugnisse der Chemischen Industrie;1906794;1135093;771701
01.11.17;WA39;Kunststoffe und Waren daraus;5325045;3353602;1971443
01.11.17;WA40;Kautschuk und Waren daraus;1363735;1220789;142946
01.11.17;WA41;Häute, Felle, Leder;94954;78501;16453
01.11.17;WA42;Lederwaren, Sattlerwaren;205595;370086;-164491
01.11.17;WA43;Pelzfelle, künstliches Pelzwerk;9279;12590;-3311
01.11.17;WA44;Holz, Holzwaren, Holzkohle;710405;650550;59855
01.11.17;WA45;Kork, Korkwaren;2465;7553;-5088
01.11.17;WA46;Flechtwaren, Korbmacherwaren;3019;8344;-5325
01.11.17;WA47;Halbstoffe aus Holz usw., Papierabfall;108650;354702;-246052
01.11.17;WA48;Papier, Pappe und Waren daraus;1597608;1121643;475965
01.11.17;WA49;Bücher, Zeitungen, Bilddrucke usw.;423671;230579;193092
01.11.17;WA50;Seide;3077;4112;-1035
01.11.17;WA51;Wolle, feine und grobe Tierhaare;28508;50100;-21592
01.11.17;WA52;Baumwolle;81827;89815;-7988
01.11.17;WA53;Andere pflanzliche Spinnstoffe, Papiergarn;4284;7522;-3238
01.11.17;WA54;Synthetisches oder künstliches Filament;171717;135716;36001
01.11.17;WA55;Synthetische oder künstliche Spinnfaser;154060;125289;28771
01.11.17;WA56;Watte, Filz, Vliesstoff usw., Tauwerk;218536;117076;101460
01.11.17;WA57;Teppiche, Fussbodenbelag aus Spinnstoff;51149;98581;-47432
01.11.17;WA58;Spezialgewebe, Spitzen, Tapisserien;49221;23756;25465
01.11.17;WA59;Getränkte, bestrichene usw. Gewebe;224339;99664;124675
01.11.17;WA60;Gewirke und Gestricke;69798;40147;29651
01.11.17;WA61;Bekleidung usw. aus Gewirken, Gestricken;806202;1562340;-756138
01.11.17;WA62;Andere Bekleidung, Bekleidungszubehör;807566;1311569;-504003
01.11.17;WA63;Andere Konfektion, Spinnstoffwaren usw.;227310;326562;-99252
01.11.17;WA64;Schuhe, Gamaschen, ähnliche Waren;503736;879463;-375727
01.11.17;WA65;Kopfbedeckungen und Teile davon;37094;47652;-10558
01.11.17;WA66;Schirme, Gehstöcke usw., Peitschen;6385;12211;-5826
01.11.17;WA67;Zugerichtete Federn, Daunen, künstliche Blumen;9418;16925;-7507
01.11.17;WA68;Waren aus Steinen, Gips, Zement usw.;414808;262403;152405
01.11.17;WA69;Keramische Waren;299865;254432;45433
01.11.17;WA70;Glas und Glaswaren;579902;467271;112631
01.11.17;WA71;Perlen, Edelsteine, Edelmetalle;1086918;1458830;-371912
01.11.17;WA72;Eisen und Stahl;2114505;2304446;-189941
01.11.17;WA73;Waren aus Eisen oder Stahl;2427044;1841979;585065
01.11.17;WA74;Kupfer und Waren daraus;1013871;908772;105099
01.11.17;WA75;Nickel und Waren daraus;90953;121741;-30788
01.11.17;WA76;Aluminium und Waren daraus;1243881;1427674;-183793
01.11.17;WA78;Blei und Waren daraus;43774;42106;1668
01.11.17;WA79;Zink und Waren daraus;73649;148672;-75023
01.11.17;WA80;Zinn und Waren daraus;10178;35519;-25341
01.11.17;WA81;Andere unedle Metalle, Cermets usw.;134386;176825;-42439
01.11.17;WA82;Werkzeuge, Schneidwaren, Essbestecke;763200;440497;322703
01.11.17;WA83;Verschiedene Waren aus unedlen Metallen;661005;415350;245655
01.11.17;WA84;Maschinen, Apparate, mechanische Geräte;20092153;12087187;8004966
01.11.17;WA85;Elektrotechnische Erzeugnisse;12405961;12257963;147998
01.11.17;WA86;Schienenfahrzeuge;548063;204206;343857
01.11.17;WA87;Kraftfahrzeuge, Landfahrzeuge;21247365;9762303;11485062
01.11.17;WA88;Luftfahrzeuge, Raumfahrzeuge;3589267;1000046;2589221
01.11.17;WA89;Wasserfahrzeuge;145273;35213;110060
01.11.17;WA90;Optische, photografische usw. Erzeugnisse;6086391;3259417;2826974
01.11.17;WA91;Uhrmacherwaren;189578;203830;-14252
01.11.17;WA92;Musikinstrumente;65035;65280;-245
01.11.17;WA93;Waffen und Munition;40049;21370;18679
01.11.17;WA94;Möbel, Beleuchtungskörper usw.;1469848;1646006;-176158
01.11.17;WA95;Spielzeug, Spiele usw., Sportgeräte;584033;878032;-293999
01.11.17;WA96;Verschiedene Waren;339963;242565;97398
01.11.17;WA97;Kunstgegenstände, Sammlungsstücke;75625;37951;37674
01.11.17;WA98;Vollständige Fabrikationsanlagen;131805;14;131791
01.11.17;WA99;Zusammenstellungen verschiedener Waren;1425522;1079737;345785
01.11.18;WA01;Lebende Tiere;131693;129053;2640
01.11.18;WA02;Fleisch;630892;590067;40825
01.11.18;WA03;Fische, Krebs- und Weichtiere;137759;362877;-225118
01.11.18;WA04;Milch, Milcherzeugnisse, Eier, Honig;746780;740962;5818
01.11.18;WA05;Andere Waren tierischen Ursprungs;83517;87052;-3535
01.11.18;WA06;Pflanzen, Waren des Blumenhandels;66397;220204;-153807
01.11.18;WA07;Gemüse, Pflanzen für Ernährung;112803;480995;-368192
01.11.18;WA08;Geniessbare Früchte und Nüsse;160519;800603;-640084
01.11.18;WA09;Kaffee, Tee, Mate, Gewürze;284221;329074;-44853
01.11.18;WA10;Getreide;98847;273589;-174742
01.11.18;WA11;Müllereierzeugnisse, Malz usw.;151957;59560;92397
01.11.18;WA12;Ölsamen usw., Heilpflanzen usw.;119392;433080;-313688
01.11.18;WA13;Schellack, Gummen, Harz, Pflanzensaft;57293;44218;13075
01.11.18;WA14;Flechtstoffe usw. pflanzlichen Ursprungs;828;3609;-2781
01.11.18;WA15;Tierische und pflanzliche Fette, Öle, Wachs;219384;315715;-96331
01.11.18;WA16;Zubereitungen von Fleisch, Fisch usw.;245793;258042;-12249
01.11.18;WA17;Zucker und Zuckerwaren;210795;127063;83732
01.11.18;WA18;Kakao und Zubereitungen aus Kakao;525240;401314;123926
01.11.18;WA19;Zubereitungen aus Getreide usw., Backwaren;566890;363764;203126
01.11.18;WA20;Zubereitungen von Gemüse, Früchten usw.;249838;428404;-178566
01.11.18;WA21;Verschiedene Lebensmittelzubereitungen;471559;296550;175009
01.11.18;WA22;Getränke, alkoholhaltige Flüssigkeiten, Essig;506630;711894;-205264
01.11.18;WA23;Rückstände der Lebensmittelindustrie, Futter;362956;340699;22257
01.11.18;WA24;Tabak;310485;225470;85015
01.11.18;WA25;Salz, Schwefel, Steine, Erden usw.;178088;173464;4624
01.11.18;WA26;Erze, Schlacken, Aschen;43389;682182;-638793
01.11.18;WA27;Mineralische Brennstoffe usw.;2604154;8622149;-6017995
01.11.18;WA28;Anorganische chemische Erzeugnisse;792093;619056;173037
01.11.18;WA29;Organische chemische Erzeugnisse;2078874;3065879;-987005
01.11.18;WA30;Pharmazeutische Erzeugnisse;6551413;4416892;2134521
01.11.18;WA31;Düngemittel;203860;82686;121174
01.11.18;WA32;Gerb- und Farbstoffe, Farben, Lacke usw.;985175;500746;484429
01.11.18;WA33;Etherische Öle, Riech-, Schönheitsmittel;902215;625023;277192
01.11.18;WA34;Seifen, Waschmittel usw.;658794;372250;286544
01.11.18;WA35;Eiweissstoffe, Klebstoffe, Enzyme;308221;175528;132693
01.11.18;WA36;Sprengstoffe, pyrotechnische Artikel usw.;28002;36852;-8850
01.11.18;WA37;Photochemische Erzeugnisse;84684;84832;-148
01.11.18;WA38;Verschiedene Erzeugnisse der Chemischen Industrie;2020898;1141353;879545
01.11.18;WA39;Kunststoffe und Waren daraus;5160571;3453004;1707567
01.11.18;WA40;Kautschuk und Waren daraus;1338191;1228289;109902
01.11.18;WA41;Häute, Felle, Leder;70432;56736;13696
01.11.18;WA42;Lederwaren, Sattlerwaren;217191;368606;-151415
01.11.18;WA43;Pelzfelle, künstliches Pelzwerk;8698;11303;-2605
01.11.18;WA44;Holz, Holzwaren, Holzkohle;737661;675936;61725
01.11.18;WA45;Kork, Korkwaren;2155;8306;-6151
01.11.18;WA46;Flechtwaren, Korbmacherwaren;3307;8100;-4793
01.11.18;WA47;Halbstoffe aus Holz usw., Papierabfall;102494;334130;-231636
01.11.18;WA48;Papier, Pappe und Waren daraus;1652657;1111992;540665
01.11.18;WA49;Bücher, Zeitungen, Bilddrucke usw.;417843;263523;154320
01.11.18;WA50;Seide;2696;3258;-562
01.11.18;WA51;Wolle, feine und grobe Tierhaare;40007;54101;-14094
01.11.18;WA52;Baumwolle;73654;81325;-7671
01.11.18;WA53;Andere pflanzliche Spinnstoffe, Papiergarn;4368;7446;-3078
01.11.18;WA54;Synthetisches oder künstliches Filament;160306;126312;33994
01.11.18;WA55;Synthetische oder künstliche Spinnfaser;135837;120301;15536
01.11.18;WA56;Watte, Filz, Vliesstoff usw., Tauwerk;207946;123455;84491
01.11.18;WA57;Teppiche, Fussbodenbelag aus Spinnstoff;51913;94964;-43051
01.11.18;WA58;Spezialgewebe, Spitzen, Tapisserien;45558;21495;24063
01.11.18;WA59;Getränkte, bestrichene usw. Gewebe;210990;97294;113696
01.11.18;WA60;Gewirke und Gestricke;68702;37699;31003
01.11.18;WA61;Bekleidung usw. aus Gewirken, Gestricken;882368;1551745;-669377
01.11.18;WA62;Andere Bekleidung, Bekleidungszubehör;885229;1287264;-402035
01.11.18;WA63;Andere Konfektion, Spinnstoffwaren usw.;236361;334994;-98633
01.11.18;WA64;Schuhe, Gamaschen, ähnliche Waren;596370;830999;-234629
01.11.18;WA65;Kopfbedeckungen und Teile davon;39920;53201;-13281
01.11.18;WA66;Schirme, Gehstöcke usw., Peitschen;8549;13380;-4831
01.11.18;WA67;Zugerichtete Federn, Daunen, künstliche Blumen;12135;19125;-6990
01.11.18;WA68;Waren aus Steinen, Gips, Zement usw.;427445;287783;139662
01.11.18;WA69;Keramische Waren;316856;237032;79824
01.11.18;WA70;Glas und Glaswaren;611910;453879;158031
01.11.18;WA71;Perlen, Edelsteine, Edelmetalle;1063500;1496864;-433364
01.11.18;WA72;Eisen und Stahl;2054422;2426506;-372084
01.11.18;WA73;Waren aus Eisen oder Stahl;2464172;1898571;565601
01.11.18;WA74;Kupfer und Waren daraus;922755;875318;47437
01.11.18;WA75;Nickel und Waren daraus;115661;128889;-13228
01.11.18;WA76;Aluminium und Waren daraus;1262237;1395546;-133309
01.11.18;WA78;Blei und Waren daraus;39158;43081;-3923
01.11.18;WA79;Zink und Waren daraus;66088;135113;-69025
01.11.18;WA80;Zinn und Waren daraus;12143;31612;-19469
01.11.18;WA81;Andere unedle Metalle, Cermets usw.;135224;169970;-34746
01.11.18;WA82;Werkzeuge, Schneidwaren, Essbestecke;754561;459837;294724
01.11.18;WA83;Verschiedene Waren aus unedlen Metallen;652630;405415;247215
01.11.18;WA84;Maschinen, Apparate, mechanische Geräte;20577673;12737170;7840503
01.11.18;WA85;Elektrotechnische Erzeugnisse;12763488;12608815;154673
01.11.18;WA86;Schienenfahrzeuge;400063;257001;143062
01.11.18;WA87;Kraftfahrzeuge, Landfahrzeuge;19503909;10132392;9371517
01.11.18;WA88;Luftfahrzeuge, Raumfahrzeuge;4212435;1126129;3086306
01.11.18;WA89;Wasserfahrzeuge;104371;73016;31355
01.11.18;WA90;Optische, photografische usw. Erzeugnisse;6171556;3425396;2746160
01.11.18;WA91;Uhrmacherwaren;190406;193969;-3563
01.11.18;WA92;Musikinstrumente;67591;74064;-6473
01.11.18;WA93;Waffen und Munition;39514;20758;18756
01.11.18;WA94;Möbel, Beleuchtungskörper usw.;1460797;1589039;-128242
01.11.18;WA95;Spielzeug, Spiele usw., Sportgeräte;612116;960313;-348197
01.11.18;WA96;Verschiedene Waren;337663;241242;96421
01.11.18;WA97;Kunstgegenstände, Sammlungsstücke;77916;53545;24371
01.11.18;WA98;Vollständige Fabrikationsanlagen;182199;4611;177588
01.11.18;WA99;Zusammenstellungen verschiedener Waren;1394356;1167180;227176
01.11.19;WA01;Lebende Tiere;140784;155307;-14523
01.11.19;WA02;Fleisch;828693;629989;198704
01.11.19;WA03;Fische, Krebs- und Weichtiere;138944;359137;-220193
01.11.19;WA04;Milch, Milcherzeugnisse, Eier, Honig;774992;739790;35202
01.11.19;WA05;Andere Waren tierischen Ursprungs;80375;85927;-5552
01.11.19;WA06;Pflanzen, Waren des Blumenhandels;65338;203983;-138645
01.11.19;WA07;Gemüse, Pflanzen für Ernährung;99228;489927;-390699
01.11.19;WA08;Geniessbare Früchte und Nüsse;173985;915572;-741587
01.11.19;WA09;Kaffee, Tee, Mate, Gewürze;242210;299770;-57560
01.11.19;WA10;Getreide;158749;239750;-81001
01.11.19;WA11;Müllereierzeugnisse, Malz usw.;142644;60218;82426
01.11.19;WA12;Ölsamen usw., Heilpflanzen usw.;108806;410595;-301789
01.11.19;WA13;Schellack, Gummen, Harz, Pflanzensaft;60904;42348;18556
01.11.19;WA14;Flechtstoffe usw. pflanzlichen Ursprungs;580;4493;-3913
01.11.19;WA15;Tierische und pflanzliche Fette, Öle, Wachs;223502;286158;-62656
01.11.19;WA16;Zubereitungen von Fleisch, Fisch usw.;246383;282540;-36157
01.11.19;WA17;Zucker und Zuckerwaren;193879;129476;64403
01.11.19;WA18;Kakao und Zubereitungen aus Kakao;558521;465247;93274
01.11.19;WA19;Zubereitungen aus Getreide usw., Backwaren;573357;399754;173603
01.11.19;WA20;Zubereitungen von Gemüse, Früchten usw.;255357;466869;-211512
01.11.19;WA21;Verschiedene Lebensmittelzubereitungen;489004;289357;199647
01.11.19;WA22;Getränke, alkoholhaltige Flüssigkeiten, Essig;484830;682040;-197210
01.11.19;WA23;Rückstände der Lebensmittelindustrie, Futter;396467;378446;18021
01.11.19;WA24;Tabak;253245;212614;40631
01.11.19;WA25;Salz, Schwefel, Steine, Erden usw.;168740;152001;16739
01.11.19;WA26;Erze, Schlacken, Aschen;44218;629289;-585071
01.11.19;WA27;Mineralische Brennstoffe usw.;2354609;8117872;-5763263
01.11.19;WA28;Anorganische chemische Erzeugnisse;805758;517470;288288
01.11.19;WA29;Organische chemische Erzeugnisse;1999740;3064317;-1064577
01.11.19;WA30;Pharmazeutische Erzeugnisse;7079892;4547618;2532274
01.11.19;WA31;Düngemittel;176182;86366;89816
01.11.19;WA32;Gerb- und Farbstoffe, Farben, Lacke usw.;931673;479801;451872
01.11.19;WA33;Etherische Öle, Riech-, Schönheitsmittel;906847;669331;237516
01.11.19;WA34;Seifen, Waschmittel usw.;628589;382506;246083
01.11.19;WA35;Eiweissstoffe, Klebstoffe, Enzyme;309597;184880;124717
01.11.19;WA36;Sprengstoffe, pyrotechnische Artikel usw.;27298;16657;10641
01.11.19;WA37;Photochemische Erzeugnisse;105530;85256;20274
01.11.19;WA38;Verschiedene Erzeugnisse der Chemischen Industrie;1982195;1162205;819990
01.11.19;WA39;Kunststoffe und Waren daraus;4906455;3137340;1769115
01.11.19;WA40;Kautschuk und Waren daraus;1279997;1111010;168987
01.11.19;WA41;Häute, Felle, Leder;56363;47755;8608
01.11.19;WA42;Lederwaren, Sattlerwaren;213391;376906;-163515
01.11.19;WA43;Pelzfelle, künstliches Pelzwerk;12411;15587;-3176
01.11.19;WA44;Holz, Holzwaren, Holzkohle;712943;632827;80116
01.11.19;WA45;Kork, Korkwaren;2551;8523;-5972
01.11.19;WA46;Flechtwaren, Korbmacherwaren;3725;10712;-6987
01.11.19;WA47;Halbstoffe aus Holz usw., Papierabfall;78675;293087;-214412
01.11.19;WA48;Papier, Pappe und Waren daraus;1569909;1040889;529020
01.11.19;WA49;Bücher, Zeitungen, Bilddrucke usw.;374315;257184;117131
01.11.19;WA50;Seide;1895;3290;-1395
01.11.19;WA51;Wolle, feine und grobe Tierhaare;24591;41212;-16621
01.11.19;WA52;Baumwolle;67396;74286;-6890
01.11.19;WA53;Andere pflanzliche Spinnstoffe, Papiergarn;5139;7847;-2708
01.11.19;WA54;Synthetisches oder künstliches Filament;144033;120330;23703
01.11.19;WA55;Synthetische oder künstliche Spinnfaser;123015;110494;12521
01.11.19;WA56;Watte, Filz, Vliesstoff usw., Tauwerk;199677;125467;74210
01.11.19;WA57;Teppiche, Fussbodenbelag aus Spinnstoff;51165;99770;-48605
01.11.19;WA58;Spezialgewebe, Spitzen, Tapisserien;42000;21033;20967
01.11.19;WA59;Getränkte, bestrichene usw. Gewebe;191065;95249;95816
01.11.19;WA60;Gewirke und Gestricke;56792;38421;18371
01.11.19;WA61;Bekleidung usw. aus Gewirken, Gestricken;917220;1637983;-720763
01.11.19;WA62;Andere Bekleidung, Bekleidungszubehör;956285;1406946;-450661
01.11.19;WA63;Andere Konfektion, Spinnstoffwaren usw.;243995;336635;-92640
01.11.19;WA64;Schuhe, Gamaschen, ähnliche Waren;667157;943164;-276007
01.11.19;WA65;Kopfbedeckungen und Teile davon;41926;61962;-20036
01.11.19;WA66;Schirme, Gehstöcke usw., Peitschen;6652;14503;-7851
01.11.19;WA67;Zugerichtete Federn, Daunen, künstliche Blumen;12820;21090;-8270
01.11.19;WA68;Waren aus Steinen, Gips, Zement usw.;412774;287865;124909
01.11.19;WA69;Keramische Waren;317840;239472;78368
01.11.19;WA70;Glas und Glaswaren;546575;438590;107985
01.11.19;WA71;Perlen, Edelsteine, Edelmetalle;1580668;1912312;-331644
01.11.19;WA72;Eisen und Stahl;1719513;1778530;-59017
01.11.19;WA73;Waren aus Eisen oder Stahl;2333132;1737006;596126
01.11.19;WA74;Kupfer und Waren daraus;747117;862273;-115156
01.11.19;WA75;Nickel und Waren daraus;117239;128742;-11503
01.11.19;WA76;Aluminium und Waren daraus;1255273;1279263;-23990
01.11.19;WA78;Blei und Waren daraus;35993;39418;-3425
01.11.19;WA79;Zink und Waren daraus;60882;118149;-57267
01.11.19;WA80;Zinn und Waren daraus;7332;30028;-22696
01.11.19;WA81;Andere unedle Metalle, Cermets usw.;115885;155272;-39387
01.11.19;WA82;Werkzeuge, Schneidwaren, Essbestecke;710798;438655;272143
01.11.19;WA83;Verschiedene Waren aus unedlen Metallen;599233;410066;189167
01.11.19;WA84;Maschinen, Apparate, mechanische Geräte;19687173;12424335;7262838
01.11.19;WA85;Elektrotechnische Erzeugnisse;12554800;12278233;276567
01.11.19;WA86;Schienenfahrzeuge;367106;293488;73618
01.11.19;WA87;Kraftfahrzeuge, Landfahrzeuge;18579336;10263976;8315360
01.11.19;WA88;Luftfahrzeuge, Raumfahrzeuge;3558919;1355893;2203026
01.11.19;WA89;Wasserfahrzeuge;286408;171489;114919
01.11.19;WA90;Optische, photografische usw. Erzeugnisse;6176150;3434671;2741479
01.11.19;WA91;Uhrmacherwaren;162885;229037;-66152
01.11.19;WA92;Musikinstrumente;68571;69986;-1415
01.11.19;WA93;Waffen und Munition;36837;19791;17046
01.11.19;WA94;Möbel, Beleuchtungskörper usw.;1421809;1625150;-203341
01.11.19;WA95;Spielzeug, Spiele usw., Sportgeräte;601027;912846;-311819
01.11.19;WA96;Verschiedene Waren;335812;245239;90573
01.11.19;WA97;Kunstgegenstände, Sammlungsstücke;65425;36054;29371
01.11.19;WA98;Vollständige Fabrikationsanlagen;131176;15;131161
01.11.19;WA99;Zusammenstellungen verschiedener Waren;1474624;1080959;393665
01.11.20;WA01;Lebende Tiere;92839;91588;1251
01.11.20;WA02;Fleisch;495026;519090;-24064
01.11.20;WA03;Fische, Krebs- und Weichtiere;113409;324161;-210752
01.11.20;WA04;Milch, Milcherzeugnisse, Eier, Honig;727097;733794;-6697
01.11.20;WA05;Andere Waren tierischen Ursprungs;72107;77275;-5168
01.11.20;WA06;Pflanzen, Waren des Blumenhandels;64270;238938;-174668
01.11.20;WA07;Gemüse, Pflanzen für Ernährung;85427;518811;-433384
01.11.20;WA08;Geniessbare Früchte und Nüsse;167758;883615;-715857
01.11.20;WA09;Kaffee, Tee, Mate, Gewürze;238060;342330;-104270
01.11.20;WA10;Getreide;259436;269801;-10365
01.11.20;WA11;Müllereierzeugnisse, Malz usw.;142346;62406;79940
01.11.20;WA12;Ölsamen usw., Heilpflanzen usw.;120791;520737;-399946
01.11.20;WA13;Schellack, Gummen, Harz, Pflanzensaft;53143;45789;7354
01.11.20;WA14;Flechtstoffe usw. pflanzlichen Ursprungs;648;2303;-1655
01.11.20;WA15;Tierische und pflanzliche Fette, Öle, Wachs;241172;322643;-81471
01.11.20;WA16;Zubereitungen von Fleisch, Fisch usw.;241609;280618;-39009
01.11.20;WA17;Zucker und Zuckerwaren;236774;132522;104252
01.11.20;WA18;Kakao und Zubereitungen aus Kakao;500260;409716;90544
01.11.20;WA19;Zubereitungen aus Getreide usw., Backwaren;565341;413138;152203
01.11.20;WA20;Zubereitungen von Gemüse, Früchten usw.;241515;462613;-221098
01.11.20;WA21;Verschiedene Lebensmittelzubereitungen;505615;325099;180516
01.11.20;WA22;Getränke, alkoholhaltige Flüssigkeiten, Essig;450175;717090;-266915
01.11.20;WA23;Rückstände der Lebensmittelindustrie, Futter;473805;381866;91939
01.11.20;WA24;Tabak;208932;233836;-24904
01.11.20;WA25;Salz, Schwefel, Steine, Erden usw.;172714;148103;24611
01.11.20;WA26;Erze, Schlacken, Aschen;49330;849083;-799753
01.11.20;WA27;Mineralische Brennstoffe usw.;2043333;5629583;-3586250
01.11.20;WA28;Anorganische chemische Erzeugnisse;1035893;455356;580537
01.11.20;WA29;Organische chemische Erzeugnisse;2038354;1947206;91148
01.11.20;WA30;Pharmazeutische Erzeugnisse;7509215;5137484;2371731
01.11.20;WA31;Düngemittel;168085;83624;84461
01.11.20;WA32;Gerb- und Farbstoffe, Farben, Lacke usw.;996765;487598;509167
01.11.20;WA33;Etherische Öle, Riech-, Schönheitsmittel;828808;621370;207438
01.11.20;WA34;Seifen, Waschmittel usw.;679377;386409;292968
01.11.20;WA35;Eiweissstoffe, Klebstoffe, Enzyme;340826;193039;147787
01.11.20;WA36;Sprengstoffe, pyrotechnische Artikel usw.;27395;22388;5007
01.11.20;WA37;Photochemische Erzeugnisse;96838;68634;28204
01.11.20;WA38;Verschiedene Erzeugnisse der Chemischen Industrie;2202920;1482451;720469
01.11.20;WA39;Kunststoffe und Waren daraus;5122222;3286955;1835267
01.11.20;WA40;Kautschuk und Waren daraus;1246543;1207398;39145
01.11.20;WA41;Häute, Felle, Leder;53185;41720;11465
01.11.20;WA42;Lederwaren, Sattlerwaren;198162;336434;-138272
01.11.20;WA43;Pelzfelle, künstliches Pelzwerk;5627;9261;-3634
01.11.20;WA44;Holz, Holzwaren, Holzkohle;814670;714052;100618
01.11.20;WA45;Kork, Korkwaren;2889;7246;-4357
01.11.20;WA46;Flechtwaren, Korbmacherwaren;3919;9262;-5343
01.11.20;WA47;Halbstoffe aus Holz usw., Papierabfall;78278;252682;-174404
01.11.20;WA48;Papier, Pappe und Waren daraus;1525111;984185;540926
01.11.20;WA49;Bücher, Zeitungen, Bilddrucke usw.;355721;267986;87735
01.11.20;WA50;Seide;2434;1874;560
01.11.20;WA51;Wolle, feine und grobe Tierhaare;30510;34199;-3689
01.11.20;WA52;Baumwolle;58318;60776;-2458
01.11.20;WA53;Andere pflanzliche Spinnstoffe, Papiergarn;4936;7903;-2967
01.11.20;WA54;Synthetisches oder künstliches Filament;133468;100008;33460
01.11.20;WA55;Synthetische oder künstliche Spinnfaser;130202;102648;27554
01.11.20;WA56;Watte, Filz, Vliesstoff usw., Tauwerk;214707;131979;82728
01.11.20;WA57;Teppiche, Fussbodenbelag aus Spinnstoff;48934;109562;-60628
01.11.20;WA58;Spezialgewebe, Spitzen, Tapisserien;41255;19457;21798
01.11.20;WA59;Getränkte, bestrichene usw. Gewebe;198393;91659;106734
01.11.20;WA60;Gewirke und Gestricke;58805;39144;19661
01.11.20;WA61;Bekleidung usw. aus Gewirken, Gestricken;808992;1518345;-709353
01.11.20;WA62;Andere Bekleidung, Bekleidungszubehör;738871;1214290;-475419
01.11.20;WA63;Andere Konfektion, Spinnstoffwaren usw.;364407;567436;-203029
01.11.20;WA64;Schuhe, Gamaschen, ähnliche Waren;554105;809341;-255236
01.11.20;WA65;Kopfbedeckungen und Teile davon;42937;62990;-20053
01.11.20;WA66;Schirme, Gehstöcke usw., Peitschen;5066;12769;-7703
01.11.20;WA67;Zugerichtete Federn, Daunen, künstliche Blumen;11553;16488;-4935
01.11.20;WA68;Waren aus Steinen, Gips, Zement usw.;424489;291225;133264
01.11.20;WA69;Keramische Waren;310414;276183;34231
01.11.20;WA70;Glas und Glaswaren;557591;434490;123101
01.11.20;WA71;Perlen, Edelsteine, Edelmetalle;1858186;2534674;-676488
01.11.20;WA72;Eisen und Stahl;1843334;1774251;69083
01.11.20;WA73;Waren aus Eisen oder Stahl;2251964;1735710;516254
01.11.20;WA74;Kupfer und Waren daraus;922592;856805;65787
01.11.20;WA75;Nickel und Waren daraus;94246;108913;-14667
01.11.20;WA76;Aluminium und Waren daraus;1141715;1240051;-98336
01.11.20;WA78;Blei und Waren daraus;41733;37158;4575
01.11.20;WA79;Zink und Waren daraus;61833;123853;-62020
01.11.20;WA80;Zinn und Waren daraus;6893;23485;-16592
01.11.20;WA81;Andere unedle Metalle, Cermets usw.;95512;104231;-8719
01.11.20;WA82;Werkzeuge, Schneidwaren, Essbestecke;724598;442149;282449
01.11.20;WA83;Verschiedene Waren aus unedlen Metallen;659389;431162;228227
01.11.20;WA84;Maschinen, Apparate, mechanische Geräte;19103942;12212019;6891923
01.11.20;WA85;Elektrotechnische Erzeugnisse;12756440;13606550;-850110
01.11.20;WA86;Schienenfahrzeuge;249716;188898;60818
01.11.20;WA87;Kraftfahrzeuge, Landfahrzeuge;18854398;11655685;7198713
01.11.20;WA88;Luftfahrzeuge, Raumfahrzeuge;2398526;1351834;1046692
01.11.20;WA89;Wasserfahrzeuge;70854;99624;-28770
01.11.20;WA90;Optische, photografische usw. Erzeugnisse;6086156;3449971;2636185
01.11.20;WA91;Uhrmacherwaren;151686;227808;-76122
01.11.20;WA92;Musikinstrumente;65488;73232;-7744
01.11.20;WA93;Waffen und Munition;47095;17880;29215
01.11.20;WA94;Möbel, Beleuchtungskörper usw.;1445920;1777204;-331284
01.11.20;WA95;Spielzeug, Spiele usw., Sportgeräte;696116;1031704;-335588
01.11.20;WA96;Verschiedene Waren;341288;272175;69113
01.11.20;WA97;Kunstgegenstände, Sammlungsstücke;84414;39459;44955
01.11.20;WA98;Vollständige Fabrikationsanlagen;95883;NULL;#WERT!
01.11.20;WA99;Zusammenstellungen verschiedener Waren;1295100;1034273;260827
01.11.21;WA01;Lebende Tiere;103126;93091;10035
01.11.21;WA02;Fleisch;569374;599334;-29960
01.11.21;WA03;Fische, Krebs- und Weichtiere;137032;371348;-234316
01.11.21;WA04;Milch, Milcherzeugnisse, Eier, Honig;856431;873972;-17541
01.11.21;WA05;Andere Waren tierischen Ursprungs;78611;95238;-16627
01.11.21;WA06;Pflanzen, Waren des Blumenhandels;72700;234308;-161608
01.11.21;WA07;Gemüse, Pflanzen für Ernährung;90911;524535;-433624
01.11.21;WA08;Geniessbare Früchte und Nüsse;177940;933061;-755121
01.11.21;WA09;Kaffee, Tee, Mate, Gewürze;302621;432802;-130181
01.11.21;WA10;Getreide;238689;270412;-31723
01.11.21;WA11;Müllereierzeugnisse, Malz usw.;164051;70529;93522
01.11.21;WA12;Ölsamen usw., Heilpflanzen usw.;134446;623747;-489301
01.11.21;WA13;Schellack, Gummen, Harz, Pflanzensaft;58905;55795;3110
01.11.21;WA14;Flechtstoffe usw. pflanzlichen Ursprungs;768;3111;-2343
01.11.21;WA15;Tierische und pflanzliche Fette, Öle, Wachs;334393;452676;-118283
01.11.21;WA16;Zubereitungen von Fleisch, Fisch usw.;243661;292906;-49245
01.11.21;WA17;Zucker und Zuckerwaren;294481;154871;139610
01.11.21;WA18;Kakao und Zubereitungen aus Kakao;617256;470065;147191
01.11.21;WA19;Zubereitungen aus Getreide usw., Backwaren;627235;427475;199760
01.11.21;WA20;Zubereitungen von Gemüse, Früchten usw.;243746;486750;-243004
01.11.21;WA21;Verschiedene Lebensmittelzubereitungen;566359;345849;220510
01.11.21;WA22;Getränke, alkoholhaltige Flüssigkeiten, Essig;546231;824884;-278653
01.11.21;WA23;Rückstände der Lebensmittelindustrie, Futter;519050;440416;78634
01.11.21;WA24;Tabak;235293;301388;-66095
01.11.21;WA25;Salz, Schwefel, Steine, Erden usw.;186420;156270;30150
01.11.21;WA26;Erze, Schlacken, Aschen;78327;795372;-717045
01.11.21;WA27;Mineralische Brennstoffe usw.;3510908;12358365;-8847457
01.11.21;WA28;Anorganische chemische Erzeugnisse;1086174;602603;483571
01.11.21;WA29;Organische chemische Erzeugnisse;2664148;2635297;28851
01.11.21;WA30;Pharmazeutische Erzeugnisse;8772103;6699890;2072213
01.11.21;WA31;Düngemittel;310607;145056;165551
01.11.21;WA32;Gerb- und Farbstoffe, Farben, Lacke usw.;1028195;592988;435207
01.11.21;WA33;Etherische Öle, Riech-, Schönheitsmittel;1008184;713474;294710
01.11.21;WA34;Seifen, Waschmittel usw.;716128;436909;279219
01.11.21;WA35;Eiweissstoffe, Klebstoffe, Enzyme;378428;221794;156634
01.11.21;WA36;Sprengstoffe, pyrotechnische Artikel usw.;27274;18079;9195
01.11.21;WA37;Photochemische Erzeugnisse;96056;64229;31827
01.11.21;WA38;Verschiedene Erzeugnisse der Chemischen Industrie;2526793;1586120;940673
01.11.21;WA39;Kunststoffe und Waren daraus;6156188;4184931;1971257
01.11.21;WA40;Kautschuk und Waren daraus;1353880;1297487;56393
01.11.21;WA41;Häute, Felle, Leder;55125;46984;8141
01.11.21;WA42;Lederwaren, Sattlerwaren;227294;386443;-159149
01.11.21;WA43;Pelzfelle, künstliches Pelzwerk;6820;9375;-2555
01.11.21;WA44;Holz, Holzwaren, Holzkohle;1059984;857242;202742
01.11.21;WA45;Kork, Korkwaren;2254;9913;-7659
01.11.21;WA46;Flechtwaren, Korbmacherwaren;4317;13241;-8924
01.11.21;WA47;Halbstoffe aus Holz usw., Papierabfall;104411;352363;-247952
01.11.21;WA48;Papier, Pappe und Waren daraus;1808272;1188248;620024
01.11.21;WA49;Bücher, Zeitungen, Bilddrucke usw.;382649;293910;88739
01.11.21;WA50;Seide;2869;2449;420
01.11.21;WA51;Wolle, feine und grobe Tierhaare;40428;46087;-5659
01.11.21;WA52;Baumwolle;60266;67142;-6876
01.11.21;WA53;Andere pflanzliche Spinnstoffe, Papiergarn;5057;9345;-4288
01.11.21;WA54;Synthetisches oder künstliches Filament;141867;127873;13994
01.11.21;WA55;Synthetische oder künstliche Spinnfaser;128473;126887;1586
01.11.21;WA56;Watte, Filz, Vliesstoff usw., Tauwerk;221859;147512;74347
01.11.21;WA57;Teppiche, Fussbodenbelag aus Spinnstoff;49677;109523;-59846
01.11.21;WA58;Spezialgewebe, Spitzen, Tapisserien;45298;24345;20953
01.11.21;WA59;Getränkte, bestrichene usw. Gewebe;202224;102404;99820
01.11.21;WA60;Gewirke und Gestricke;65029;45285;19744
01.11.21;WA61;Bekleidung usw. aus Gewirken, Gestricken;1140795;1945812;-805017
01.11.21;WA62;Andere Bekleidung, Bekleidungszubehör;958500;1418227;-459727
01.11.21;WA63;Andere Konfektion, Spinnstoffwaren usw.;289727;479505;-189778
01.11.21;WA64;Schuhe, Gamaschen, ähnliche Waren;630731;947689;-316958
01.11.21;WA65;Kopfbedeckungen und Teile davon;55542;80785;-25243
01.11.21;WA66;Schirme, Gehstöcke usw., Peitschen;7342;16023;-8681
01.11.21;WA67;Zugerichtete Federn, Daunen, künstliche Blumen;14319;27493;-13174
01.11.21;WA68;Waren aus Steinen, Gips, Zement usw.;444933;308654;136279
01.11.21;WA69;Keramische Waren;331980;276922;55058
01.11.21;WA70;Glas und Glaswaren;621936;468167;153769
01.11.21;WA71;Perlen, Edelsteine, Edelmetalle;1862674;2538580;-675906
01.11.21;WA72;Eisen und Stahl;2651140;3004833;-353693
01.11.21;WA73;Waren aus Eisen oder Stahl;2445377;2289948;155429
01.11.21;WA74;Kupfer und Waren daraus;1301203;1047814;253389
01.11.21;WA75;Nickel und Waren daraus;120167;161559;-41392
01.11.21;WA76;Aluminium und Waren daraus;1543943;1786103;-242160
01.11.21;WA78;Blei und Waren daraus;41369;46374;-5005
01.11.21;WA79;Zink und Waren daraus;78652;121926;-43274
01.11.21;WA80;Zinn und Waren daraus;16001;52601;-36600
01.11.21;WA81;Andere unedle Metalle, Cermets usw.;128245;169466;-41221
01.11.21;WA82;Werkzeuge, Schneidwaren, Essbestecke;769800;553264;216536
01.11.21;WA83;Verschiedene Waren aus unedlen Metallen;646930;470693;176237
01.11.21;WA84;Maschinen, Apparate, mechanische Geräte;20038336;13560949;6477387
01.11.21;WA85;Elektrotechnische Erzeugnisse;13573247;15284803;-1711556
01.11.21;WA86;Schienenfahrzeuge;313691;251465;62226
01.11.21;WA87;Kraftfahrzeuge, Landfahrzeuge;19726233;10764051;8962182
01.11.21;WA88;Luftfahrzeuge, Raumfahrzeuge;2375079;974504;1400575
01.11.21;WA89;Wasserfahrzeuge;609618;164665;444953
01.11.21;WA90;Optische, photografische usw. Erzeugnisse;6346341;3773135;2573206
01.11.21;WA91;Uhrmacherwaren;175906;238355;-62449
01.11.21;WA92;Musikinstrumente;72197;75403;-3206
01.11.21;WA93;Waffen und Munition;60873;24485;36388
01.11.21;WA94;Möbel, Beleuchtungskörper usw.;1517191;2050952;-533761
01.11.21;WA95;Spielzeug, Spiele usw., Sportgeräte;800737;1196083;-395346
01.11.21;WA96;Verschiedene Waren;358855;320113;38742
01.11.21;WA97;Kunstgegenstände, Sammlungsstücke;133489;64518;68971
01.11.21;WA98;Vollständige Fabrikationsanlagen;34144;13;34131
01.11.21;WA99;Zusammenstellungen verschiedener Waren;1347268;992358;354910
01.11.22;WA01;Lebende Tiere;135322;114557;20765
01.11.22;WA02;Fleisch;708027;725721;-17694
01.11.22;WA03;Fische, Krebs- und Weichtiere;177611;496559;-318948
01.11.22;WA04;Milch, Milcherzeugnisse, Eier, Honig;1126842;1090564;36278
01.11.22;WA05;Andere Waren tierischen Ursprungs;93038;124379;-31341
01.11.22;WA06;Pflanzen, Waren des Blumenhandels;81410;251884;-170474
01.11.22;WA07;Gemüse, Pflanzen für Ernährung;106838;612379;-505541
01.11.22;WA08;Geniessbare Früchte und Nüsse;170357;973260;-802903
01.11.22;WA09;Kaffee, Tee, Mate, Gewürze;375300;594627;-219327
01.11.22;WA10;Getreide;221291;407539;-186248
01.11.22;WA11;Müllereierzeugnisse, Malz usw.;227074;93630;133444
01.11.22;WA12;Ölsamen usw., Heilpflanzen usw.;166652;684930;-518278
01.11.22;WA13;Schellack, Gummen, Harz, Pflanzensaft;64343;70513;-6170
01.11.22;WA14;Flechtstoffe usw. pflanzlichen Ursprungs;1338;5140;-3802
01.11.22;WA15;Tierische und pflanzliche Fette, Öle, Wachs;441630;565512;-123882
01.11.22;WA16;Zubereitungen von Fleisch, Fisch usw.;326010;356993;-30983
01.11.22;WA17;Zucker und Zuckerwaren;356270;186142;170128
01.11.22;WA18;Kakao und Zubereitungen aus Kakao;680425;507296;173129
01.11.22;WA19;Zubereitungen aus Getreide usw., Backwaren;785055;552785;232270
01.11.22;WA20;Zubereitungen von Gemüse, Früchten usw.;285850;574293;-288443
01.11.22;WA21;Verschiedene Lebensmittelzubereitungen;682322;427938;254384
01.11.22;WA22;Getränke, alkoholhaltige Flüssigkeiten, Essig;632641;888177;-255536
01.11.22;WA23;Rückstände der Lebensmittelindustrie, Futter;685117;576171;108946
01.11.22;WA24;Tabak;250340;332933;-82593
01.11.22;WA25;Salz, Schwefel, Steine, Erden usw.;211835;207018;4817
01.11.22;WA26;Erze, Schlacken, Aschen;71755;854286;-782531
01.11.22;WA27;Mineralische Brennstoffe usw.;4517014;14501560;-9984546
01.11.22;WA28;Anorganische chemische Erzeugnisse;1346037;952576;393461
01.11.22;WA29;Organische chemische Erzeugnisse;2630875;3066154;-435279
01.11.22;WA30;Pharmazeutische Erzeugnisse;10033600;6374093;3659507
01.11.22;WA31;Düngemittel;447343;257480;189863
01.11.22;WA32;Gerb- und Farbstoffe, Farben, Lacke usw.;1040265;519810;520455
01.11.22;WA33;Etherische Öle, Riech-, Schönheitsmittel;1119280;751373;367907
01.11.22;WA34;Seifen, Waschmittel usw.;801167;526661;274506
01.11.22;WA35;Eiweissstoffe, Klebstoffe, Enzyme;427546;267309;160237
01.11.22;WA36;Sprengstoffe, pyrotechnische Artikel usw.;37971;27122;10849
01.11.22;WA37;Photochemische Erzeugnisse;101985;56686;45299
01.11.22;WA38;Verschiedene Erzeugnisse der Chemischen Industrie;3205920;2004706;1201214
01.11.22;WA39;Kunststoffe und Waren daraus;6233827;4444276;1789551
01.11.22;WA40;Kautschuk und Waren daraus;1527817;1470578;57239
01.11.22;WA41;Häute, Felle, Leder;65863;45623;20240
01.11.22;WA42;Lederwaren, Sattlerwaren;290771;476546;-185775
01.11.22;WA43;Pelzfelle, künstliches Pelzwerk;6193;10961;-4768
01.11.22;WA44;Holz, Holzwaren, Holzkohle;1056694;864601;192093
01.11.22;WA45;Kork, Korkwaren;2344;8673;-6329
01.11.22;WA46;Flechtwaren, Korbmacherwaren;5237;14894;-9657
01.11.22;WA47;Halbstoffe aus Holz usw., Papierabfall;129986;419569;-289583
01.11.22;WA48;Papier, Pappe und Waren daraus;2130982;1423476;707506
01.11.22;WA49;Bücher, Zeitungen, Bilddrucke usw.;359778;303357;56421
01.11.22;WA50;Seide;2399;2891;-492
01.11.22;WA51;Wolle, feine und grobe Tierhaare;47848;54149;-6301
01.11.22;WA52;Baumwolle;71828;83136;-11308
01.11.22;WA53;Andere pflanzliche Spinnstoffe, Papiergarn;6082;9243;-3161
01.11.22;WA54;Synthetisches oder künstliches Filament;155011;136258;18753
01.11.22;WA55;Synthetische oder künstliche Spinnfaser;143108;146518;-3410
01.11.22;WA56;Watte, Filz, Vliesstoff usw., Tauwerk;228674;157420;71254
01.11.22;WA57;Teppiche, Fussbodenbelag aus Spinnstoff;59666;100636;-40970
01.11.22;WA58;Spezialgewebe, Spitzen, Tapisserien;47695;23881;23814
01.11.22;WA59;Getränkte, bestrichene usw. Gewebe;242252;127290;114962
01.11.22;WA60;Gewirke und Gestricke;66049;43673;22376
01.11.22;WA61;Bekleidung usw. aus Gewirken, Gestricken;1258111;2190475;-932364
01.11.22;WA62;Andere Bekleidung, Bekleidungszubehör;1106325;1765810;-659485
01.11.22;WA63;Andere Konfektion, Spinnstoffwaren usw.;299460;506433;-206973
01.11.22;WA64;Schuhe, Gamaschen, ähnliche Waren;858818;1349581;-490763
01.11.22;WA65;Kopfbedeckungen und Teile davon;71233;98324;-27091
01.11.22;WA66;Schirme, Gehstöcke usw., Peitschen;8255;19488;-11233
01.11.22;WA67;Zugerichtete Federn, Daunen, künstliche Blumen;17619;28035;-10416
01.11.22;WA68;Waren aus Steinen, Gips, Zement usw.;501467;338075;163392
01.11.22;WA69;Keramische Waren;373853;320456;53397
01.11.22;WA70;Glas und Glaswaren;723641;517251;206390
01.11.22;WA71;Perlen, Edelsteine, Edelmetalle;2174633;3378693;-1204060
01.11.22;WA72;Eisen und Stahl;2750243;2901166;-150923
01.11.22;WA73;Waren aus Eisen oder Stahl;2949205;2735387;213818
01.11.22;WA74;Kupfer und Waren daraus;1316104;1103735;212369
01.11.22;WA75;Nickel und Waren daraus;200409;186568;13841
01.11.22;WA76;Aluminium und Waren daraus;1749794;2043444;-293650
01.11.22;WA78;Blei und Waren daraus;35281;57958;-22677
01.11.22;WA79;Zink und Waren daraus;75434;174462;-99028
01.11.22;WA80;Zinn und Waren daraus;11736;32650;-20914
01.11.22;WA81;Andere unedle Metalle, Cermets usw.;149551;216514;-66963
01.11.22;WA82;Werkzeuge, Schneidwaren, Essbestecke;841992;574170;267822
01.11.22;WA83;Verschiedene Waren aus unedlen Metallen;713164;503886;209278
01.11.22;WA84;Maschinen, Apparate, mechanische Geräte;23013510;15497922;7515588
01.11.22;WA85;Elektrotechnische Erzeugnisse;16090155;20090041;-3999886
01.11.22;WA86;Schienenfahrzeuge;272805;288671;-15866
01.11.22;WA87;Kraftfahrzeuge, Landfahrzeuge;24713579;13414837;11298742
01.11.22;WA88;Luftfahrzeuge, Raumfahrzeuge;2549562;1095852;1453710
01.11.22;WA89;Wasserfahrzeuge;1116381;722960;393421
01.11.22;WA90;Optische, photografische usw. Erzeugnisse;7131097;4255418;2875679
01.11.22;WA91;Uhrmacherwaren;183442;287224;-103782
01.11.22;WA92;Musikinstrumente;101771;92001;9770
01.11.22;WA93;Waffen und Munition;63900;40996;22904
01.11.22;WA94;Möbel, Beleuchtungskörper usw.;1690585;2076266;-385681
01.11.22;WA95;Spielzeug, Spiele usw., Sportgeräte;732391;1059726;-327335
01.11.22;WA96;Verschiedene Waren;391427;354194;37233
01.11.22;WA97;Kunstgegenstände, Sammlungsstücke;102599;50254;52345
01.11.22;WA98;Vollständige Fabrikationsanlagen;39982;NULL;#WERT!
01.11.22;WA99;Zusammenstellungen verschiedener Waren;1541401;1107483;433918
01.11.23;WA01;Lebende Tiere;129613;137351;-7738
01.11.23;WA02;Fleisch;675286;699144;-23858
01.11.23;WA03;Fische, Krebs- und Weichtiere;134365;394330;-259965
01.11.23;WA04;Milch, Milcherzeugnisse, Eier, Honig;994312;972378;21934
01.11.23;WA05;Andere Waren tierischen Ursprungs;73329;90389;-17060
01.11.23;WA06;Pflanzen, Waren des Blumenhandels;72538;230337;-157799
01.11.23;WA07;Gemüse, Pflanzen für Ernährung;127951;700952;-573001
01.11.23;WA08;Geniessbare Früchte und Nüsse;196080;1016490;-820410
01.11.23;WA09;Kaffee, Tee, Mate, Gewürze;352973;443406;-90433
01.11.23;WA10;Getreide;227933;369756;-141823
01.11.23;WA11;Müllereierzeugnisse, Malz usw.;210813;87770;123043
01.11.23;WA12;Ölsamen usw., Heilpflanzen usw.;140781;595761;-454980
01.11.23;WA13;Schellack, Gummen, Harz, Pflanzensaft;58345;57107;1238
01.11.23;WA14;Flechtstoffe usw. pflanzlichen Ursprungs;1052;2710;-1658
01.11.23;WA15;Tierische und pflanzliche Fette, Öle, Wachs;334139;452514;-118375
01.11.23;WA16;Zubereitungen von Fleisch, Fisch usw.;322194;347190;-24996
01.11.23;WA17;Zucker und Zuckerwaren;350122;225173;124949
01.11.23;WA18;Kakao und Zubereitungen aus Kakao;730098;577681;152417
01.11.23;WA19;Zubereitungen aus Getreide usw., Backwaren;843916;599896;244020
01.11.23;WA20;Zubereitungen von Gemüse, Früchten usw.;296722;603902;-307180
01.11.23;WA21;Verschiedene Lebensmittelzubereitungen;733240;461866;271374
01.11.23;WA22;Getränke, alkoholhaltige Flüssigkeiten, Essig;649414;825860;-176446
01.11.23;WA23;Rückstände der Lebensmittelindustrie, Futter;634286;479853;154433
01.11.23;WA24;Tabak;295886;445373;-149487
01.11.23;WA25;Salz, Schwefel, Steine, Erden usw.;218098;176958;41140
01.11.23;WA26;Erze, Schlacken, Aschen;61640;746918;-685278
01.11.23;WA27;Mineralische Brennstoffe usw.;2732703;10078037;-7345334
01.11.23;WA28;Anorganische chemische Erzeugnisse;1179916;866184;313732
01.11.23;WA29;Organische chemische Erzeugnisse;2234754;3314838;-1080084
01.11.23;WA30;Pharmazeutische Erzeugnisse;10354215;6174243;4179972
01.11.23;WA31;Düngemittel;246585;131925;114660
01.11.23;WA32;Gerb- und Farbstoffe, Farben, Lacke usw.;1002737;482850;519887
01.11.23;WA33;Etherische Öle, Riech-, Schönheitsmittel;1120983;801342;319641
01.11.23;WA34;Seifen, Waschmittel usw.;757425;479449;277976
01.11.23;WA35;Eiweissstoffe, Klebstoffe, Enzyme;382342;238651;143691
01.11.23;WA36;Sprengstoffe, pyrotechnische Artikel usw.;37347;40330;-2983
01.11.23;WA37;Photochemische Erzeugnisse;94254;57126;37128
01.11.23;WA38;Verschiedene Erzeugnisse der Chemischen Industrie;2840900;1650442;1190458
01.11.23;WA39;Kunststoffe und Waren daraus;5733716;3687991;2045725
01.11.23;WA40;Kautschuk und Waren daraus;1543752;1356294;187458
01.11.23;WA41;Häute, Felle, Leder;50587;40333;10254
01.11.23;WA42;Lederwaren, Sattlerwaren;272150;393466;-121316
01.11.23;WA43;Pelzfelle, künstliches Pelzwerk;6693;8739;-2046
01.11.23;WA44;Holz, Holzwaren, Holzkohle;844191;675265;168926
01.11.23;WA45;Kork, Korkwaren;2021;7897;-5876
01.11.23;WA46;Flechtwaren, Korbmacherwaren;4296;10706;-6410
01.11.23;WA47;Halbstoffe aus Holz usw., Papierabfall;117219;286964;-169745
01.11.23;WA48;Papier, Pappe und Waren daraus;1756012;1120566;635446
01.11.23;WA49;Bücher, Zeitungen, Bilddrucke usw.;329372;269078;60294
01.11.23;WA50;Seide;1359;2723;-1364
01.11.23;WA51;Wolle, feine und grobe Tierhaare;32414;38195;-5781
01.11.23;WA52;Baumwolle;60625;53508;7117
01.11.23;WA53;Andere pflanzliche Spinnstoffe, Papiergarn;5899;8140;-2241
01.11.23;WA54;Synthetisches oder künstliches Filament;142301;110648;31653
01.11.23;WA55;Synthetische oder künstliche Spinnfaser;121593;105649;15944
01.11.23;WA56;Watte, Filz, Vliesstoff usw., Tauwerk;223383;137579;85804
01.11.23;WA57;Teppiche, Fussbodenbelag aus Spinnstoff;54255;96891;-42636
01.11.23;WA58;Spezialgewebe, Spitzen, Tapisserien;46608;20862;25746
01.11.23;WA59;Getränkte, bestrichene usw. Gewebe;220522;109243;111279
01.11.23;WA60;Gewirke und Gestricke;55343;36641;18702
01.11.23;WA61;Bekleidung usw. aus Gewirken, Gestricken;1198837;1637448;-438611
01.11.23;WA62;Andere Bekleidung, Bekleidungszubehör;1151852;1421520;-269668
01.11.23;WA63;Andere Konfektion, Spinnstoffwaren usw.;280185;371769;-91584
01.11.23;WA64;Schuhe, Gamaschen, ähnliche Waren;883926;922671;-38745
01.11.23;WA65;Kopfbedeckungen und Teile davon;83408;77774;5634
01.11.23;WA66;Schirme, Gehstöcke usw., Peitschen;7929;12311;-4382
01.11.23;WA67;Zugerichtete Federn, Daunen, künstliche Blumen;14660;20497;-5837
01.11.23;WA68;Waren aus Steinen, Gips, Zement usw.;480959;311416;169543
01.11.23;WA69;Keramische Waren;340928;244436;96492
01.11.23;WA70;Glas und Glaswaren;653068;476219;176849
01.11.23;WA71;Perlen, Edelsteine, Edelmetalle;2810779;1626425;1184354
01.11.23;WA72;Eisen und Stahl;2510306;2283739;226567
01.11.23;WA73;Waren aus Eisen oder Stahl;2834826;2220422;614404
01.11.23;WA74;Kupfer und Waren daraus;1135506;979405;156101
01.11.23;WA75;Nickel und Waren daraus;157358;189301;-31943
01.11.23;WA76;Aluminium und Waren daraus;1472751;1685150;-212399
01.11.23;WA78;Blei und Waren daraus;41440;55221;-13781
01.11.23;WA79;Zink und Waren daraus;53991;131400;-77409
01.11.23;WA80;Zinn und Waren daraus;10106;40236;-30130
01.11.23;WA81;Andere unedle Metalle, Cermets usw.;130228;171470;-41242
01.11.23;WA82;Werkzeuge, Schneidwaren, Essbestecke;829863;512396;317467
01.11.23;WA83;Verschiedene Waren aus unedlen Metallen;713404;466577;246827
01.11.23;WA84;Maschinen, Apparate, mechanische Geräte;22777633;14291313;8486320
01.11.23;WA85;Elektrotechnische Erzeugnisse;15536383;17878642;-2342259
01.11.23;WA86;Schienenfahrzeuge;318915;370371;-51456
01.11.23;WA87;Kraftfahrzeuge, Landfahrzeuge;25400280;13459977;11940303
01.11.23;WA88;Luftfahrzeuge, Raumfahrzeuge;2907759;1094879;1812880
01.11.23;WA89;Wasserfahrzeuge;237774;214447;23327
01.11.23;WA90;Optische, photografische usw. Erzeugnisse;7073470;3951447;3122023
01.11.23;WA91;Uhrmacherwaren;198791;268219;-69428
01.11.23;WA92;Musikinstrumente;100185;75652;24533
01.11.23;WA93;Waffen und Munition;57196;26912;30284
01.11.23;WA94;Möbel, Beleuchtungskörper usw.;1620632;1904266;-283634
01.11.23;WA95;Spielzeug, Spiele usw., Sportgeräte;580262;948846;-368584
01.11.23;WA96;Verschiedene Waren;374824;324858;49966
01.11.23;WA97;Kunstgegenstände, Sammlungsstücke;62849;52595;10254
01.11.23;WA98;Vollständige Fabrikationsanlagen;88155;23;88132
01.11.23;WA99;Zusammenstellungen verschiedener Waren;1506677;1213098;293579
01.11.24;WA01;Lebende Tiere;130176;124974;5202
01.11.24;WA02;Fleisch;667385;726047;-58662
01.11.24;WA03;Fische, Krebs- und Weichtiere;119720;377231;-257511
01.11.24;WA04;Milch, Milcherzeugnisse, Eier, Honig;1027509;1035017;-7508
01.11.24;WA05;Andere Waren tierischen Ursprungs;70459;96444;-25985
01.11.24;WA06;Pflanzen, Waren des Blumenhandels;72371;212982;-140611
01.11.24;WA07;Gemüse, Pflanzen für Ernährung;141519;686173;-544654
01.11.24;WA08;Geniessbare Früchte und Nüsse;176184;1107968;-931784
01.11.24;WA09;Kaffee, Tee, Mate, Gewürze;384385;793437;-409052
01.11.24;WA10;Getreide;204181;298990;-94809
01.11.24;WA11;Müllereierzeugnisse, Malz usw.;196890;84760;112130
01.11.24;WA12;Ölsamen usw., Heilpflanzen usw.;149193;555301;-406108
01.11.24;WA13;Schellack, Gummen, Harz, Pflanzensaft;56478;55956;522
01.11.24;WA14;Flechtstoffe usw. pflanzlichen Ursprungs;1005;2991;-1986
01.11.24;WA15;Tierische und pflanzliche Fette, Öle, Wachs;336013;416961;-80948
01.11.24;WA16;Zubereitungen von Fleisch, Fisch usw.;298461;332793;-34332
01.11.24;WA17;Zucker und Zuckerwaren;343724;192506;151218
01.11.24;WA18;Kakao und Zubereitungen aus Kakao;1017961;1031836;-13875
01.11.24;WA19;Zubereitungen aus Getreide usw., Backwaren;828314;584485;243829
01.11.24;WA20;Zubereitungen von Gemüse, Früchten usw.;302791;607214;-304423
01.11.24;WA21;Verschiedene Lebensmittelzubereitungen;742144;463029;279115
01.11.24;WA22;Getränke, alkoholhaltige Flüssigkeiten, Essig;619334;708658;-89324
01.11.24;WA23;Rückstände der Lebensmittelindustrie, Futter;617306;545416;71890
01.11.24;WA24;Tabak;280671;519837;-239166
01.11.24;WA25;Salz, Schwefel, Steine, Erden usw.;203946;150239;53707
01.11.24;WA26;Erze, Schlacken, Aschen;62153;764949;-702796
01.11.24;WA27;Mineralische Brennstoffe usw.;2762166;8978354;-6216188
01.11.24;WA28;Anorganische chemische Erzeugnisse;1080621;778561;302060
01.11.24;WA29;Organische chemische Erzeugnisse;2192357;2914027;-721670
01.11.24;WA30;Pharmazeutische Erzeugnisse;10165099;5896900;4268199
01.11.24;WA31;Düngemittel;253350;119693;133657
01.11.24;WA32;Gerb- und Farbstoffe, Farben, Lacke usw.;968549;463049;505500
01.11.24;WA33;Etherische Öle, Riech-, Schönheitsmittel;1030210;753596;276614
01.11.24;WA34;Seifen, Waschmittel usw.;747333;507438;239895
01.11.24;WA35;Eiweissstoffe, Klebstoffe, Enzyme;394199;251620;142579
01.11.24;WA36;Sprengstoffe, pyrotechnische Artikel usw.;31003;51723;-20720
01.11.24;WA37;Photochemische Erzeugnisse;84491;58406;26085
01.11.24;WA38;Verschiedene Erzeugnisse der Chemischen Industrie;2721618;1439911;1281707
01.11.24;WA39;Kunststoffe und Waren daraus;5478034;3640174;1837860
01.11.24;WA40;Kautschuk und Waren daraus;1376743;1373159;3584
01.11.24;WA41;Häute, Felle, Leder;41155;35443;5712
01.11.24;WA42;Lederwaren, Sattlerwaren;256209;399926;-143717
01.11.24;WA43;Pelzfelle, künstliches Pelzwerk;5443;7876;-2433
01.11.24;WA44;Holz, Holzwaren, Holzkohle;760951;664413;96538
01.11.24;WA45;Kork, Korkwaren;2386;7908;-5522
01.11.24;WA46;Flechtwaren, Korbmacherwaren;4342;11385;-7043
01.11.24;WA47;Halbstoffe aus Holz usw., Papierabfall;131923;323833;-191910
01.11.24;WA48;Papier, Pappe und Waren daraus;1673084;1109574;563510
01.11.24;WA49;Bücher, Zeitungen, Bilddrucke usw.;307398;242770;64628
01.11.24;WA50;Seide;1506;3325;-1819
01.11.24;WA51;Wolle, feine und grobe Tierhaare;28444;29297;-853
01.11.24;WA52;Baumwolle;48909;50810;-1901
01.11.24;WA53;Andere pflanzliche Spinnstoffe, Papiergarn;5132;8171;-3039
01.11.24;WA54;Synthetisches oder künstliches Filament;116910;100197;16713
01.11.24;WA55;Synthetische oder künstliche Spinnfaser;122684;115126;7558
01.11.24;WA56;Watte, Filz, Vliesstoff usw., Tauwerk;208275;138497;69778
01.11.24;WA57;Teppiche, Fussbodenbelag aus Spinnstoff;57757;97569;-39812
01.11.24;WA58;Spezialgewebe, Spitzen, Tapisserien;43925;20259;23666
01.11.24;WA59;Getränkte, bestrichene usw. Gewebe;213873;103476;110397
01.11.24;WA60;Gewirke und Gestricke;48150;32062;16088
01.11.24;WA61;Bekleidung usw. aus Gewirken, Gestricken;1191506;1840127;-648621
01.11.24;WA62;Andere Bekleidung, Bekleidungszubehör;1079223;1429150;-349927
01.11.24;WA63;Andere Konfektion, Spinnstoffwaren usw.;274564;397307;-122743
01.11.24;WA64;Schuhe, Gamaschen, ähnliche Waren;839490;1000663;-161173
01.11.24;WA65;Kopfbedeckungen und Teile davon;67851;79538;-11687
01.11.24;WA66;Schirme, Gehstöcke usw., Peitschen;8000;15182;-7182
01.11.24;WA67;Zugerichtete Federn, Daunen, künstliche Blumen;16231;30866;-14635
01.11.24;WA68;Waren aus Steinen, Gips, Zement usw.;452527;274189;178338
01.11.24;WA69;Keramische Waren;317973;255923;62050
01.11.24;WA70;Glas und Glaswaren;616129;460379;155750
01.11.24;WA71;Perlen, Edelsteine, Edelmetalle;2958190;2164742;793448
01.11.24;WA72;Eisen und Stahl;2179316;1917398;261918
01.11.24;WA73;Waren aus Eisen oder Stahl;2694186;2048216;645970
01.11.24;WA74;Kupfer und Waren daraus;1154589;1013978;140611
01.11.24;WA75;Nickel und Waren daraus;167682;163773;3909
01.11.24;WA76;Aluminium und Waren daraus;1493003;1681190;-188187
01.11.24;WA78;Blei und Waren daraus;66796;50289;16507
01.11.24;WA79;Zink und Waren daraus;76613;108757;-32144
01.11.24;WA80;Zinn und Waren daraus;13060;38526;-25466
01.11.24;WA81;Andere unedle Metalle, Cermets usw.;132813;180512;-47699
01.11.24;WA82;Werkzeuge, Schneidwaren, Essbestecke;778575;498072;280503
01.11.24;WA83;Verschiedene Waren aus unedlen Metallen;680051;451565;228486
01.11.24;WA84;Maschinen, Apparate, mechanische Geräte;21408153;13781466;7626687
01.11.24;WA85;Elektrotechnische Erzeugnisse;13911934;16450948;-2539014
01.11.24;WA86;Schienenfahrzeuge;265129;241831;23298
01.11.24;WA87;Kraftfahrzeuge, Landfahrzeuge;22358198;12118048;10240150
01.11.24;WA88;Luftfahrzeuge, Raumfahrzeuge;3425914;1348834;2077080
01.11.24;WA89;Wasserfahrzeuge;98388;293330;-194942
01.11.24;WA90;Optische, photografische usw. Erzeugnisse;6996344;3931229;3065115
01.11.24;WA91;Uhrmacherwaren;191342;240918;-49576
01.11.24;WA92;Musikinstrumente;98198;79530;18668
01.11.24;WA93;Waffen und Munition;47109;27729;19380
01.11.24;WA94;Möbel, Beleuchtungskörper usw.;1492669;1883794;-391125
01.11.24;WA95;Spielzeug, Spiele usw., Sportgeräte;552024;941735;-389711
01.11.24;WA96;Verschiedene Waren;338058;308666;29392
01.11.24;WA97;Kunstgegenstände, Sammlungsstücke;152571;68919;83652
01.11.24;WA98;Vollständige Fabrikationsanlagen;58708;9;58699
01.11.24;WA99;Zusammenstellungen verschiedener Waren;1532555;1174111;358444
01.11.25;WA01;Lebende Tiere;NULL;NULL;#WERT!
01.11.25;WA02;Fleisch;NULL;NULL;#WERT!
01.11.25;WA03;Fische, Krebs- und Weichtiere;NULL;NULL;#WERT!
01.11.25;WA04;Milch, Milcherzeugnisse, Eier, Honig;NULL;NULL;#WERT!
01.11.25;WA05;Andere Waren tierischen Ursprungs;NULL;NULL;#WERT!
01.11.25;WA06;Pflanzen, Waren des Blumenhandels;NULL;NULL;#WERT!
01.11.25;WA07;Gemüse, Pflanzen für Ernährung;NULL;NULL;#WERT!
01.11.25;WA08;Geniessbare Früchte und Nüsse;NULL;NULL;#WERT!
01.11.25;WA09;Kaffee, Tee, Mate, Gewürze;NULL;NULL;#WERT!
01.11.25;WA10;Getreide;NULL;NULL;#WERT!
01.11.25;WA11;Müllereierzeugnisse, Malz usw.;NULL;NULL;#WERT!
01.11.25;WA12;Ölsamen usw., Heilpflanzen usw.;NULL;NULL;#WERT!
01.11.25;WA13;Schellack, Gummen, Harz, Pflanzensaft;NULL;NULL;#WERT!
01.11.25;WA14;Flechtstoffe usw. pflanzlichen Ursprungs;NULL;NULL;#WERT!
01.11.25;WA15;Tierische und pflanzliche Fette, Öle, Wachs;NULL;NULL;#WERT!
01.11.25;WA16;Zubereitungen von Fleisch, Fisch usw.;NULL;NULL;#WERT!
01.11.25;WA17;Zucker und Zuckerwaren;NULL;NULL;#WERT!
01.11.25;WA18;Kakao und Zubereitungen aus Kakao;NULL;NULL;#WERT!
01.11.25;WA19;Zubereitungen aus Getreide usw., Backwaren;NULL;NULL;#WERT!
01.11.25;WA20;Zubereitungen von Gemüse, Früchten usw.;NULL;NULL;#WERT!
01.11.25;WA21;Verschiedene Lebensmittelzubereitungen;NULL;NULL;#WERT!
01.11.25;WA22;Getränke, alkoholhaltige Flüssigkeiten, Essig;NULL;NULL;#WERT!
01.11.25;WA23;Rückstände der Lebensmittelindustrie, Futter;NULL;NULL;#WERT!
01.11.25;WA24;Tabak;NULL;NULL;#WERT!
01.11.25;WA25;Salz, Schwefel, Steine, Erden usw.;NULL;NULL;#WERT!
01.11.25;WA26;Erze, Schlacken, Aschen;NULL;NULL;#WERT!
01.11.25;WA27;Mineralische Brennstoffe usw.;NULL;NULL;#WERT!
01.11.25;WA28;Anorganische chemische Erzeugnisse;NULL;NULL;#WERT!
01.11.25;WA29;Organische chemische Erzeugnisse;NULL;NULL;#WERT!
01.11.25;WA30;Pharmazeutische Erzeugnisse;NULL;NULL;#WERT!
01.11.25;WA31;Düngemittel;NULL;NULL;#WERT!
01.11.25;WA32;Gerb- und Farbstoffe, Farben, Lacke usw.;NULL;NULL;#WERT!
01.11.25;WA33;Etherische Öle, Riech-, Schönheitsmittel;NULL;NULL;#WERT!
01.11.25;WA34;Seifen, Waschmittel usw.;NULL;NULL;#WERT!
01.11.25;WA35;Eiweissstoffe, Klebstoffe, Enzyme;NULL;NULL;#WERT!
01.11.25;WA36;Sprengstoffe, pyrotechnische Artikel usw.;NULL;NULL;#WERT!
01.11.25;WA37;Photochemische Erzeugnisse;NULL;NULL;#WERT!
01.11.25;WA38;Verschiedene Erzeugnisse der Chemischen Industrie;NULL;NULL;#WERT!
01.11.25;WA39;Kunststoffe und Waren daraus;NULL;NULL;#WERT!
01.11.25;WA40;Kautschuk und Waren daraus;NULL;NULL;#WERT!
01.11.25;WA41;Häute, Felle, Leder;NULL;NULL;#WERT!
01.11.25;WA42;Lederwaren, Sattlerwaren;NULL;NULL;#WERT!
01.11.25;WA43;Pelzfelle, künstliches Pelzwerk;NULL;NULL;#WERT!
01.11.25;WA44;Holz, Holzwaren, Holzkohle;NULL;NULL;#WERT!
01.11.25;WA45;Kork, Korkwaren;NULL;NULL;#WERT!
01.11.25;WA46;Flechtwaren, Korbmacherwaren;NULL;NULL;#WERT!
01.11.25;WA47;Halbstoffe aus Holz usw., Papierabfall;NULL;NULL;#WERT!
01.11.25;WA48;Papier, Pappe und Waren daraus;NULL;NULL;#WERT!
01.11.25;WA49;Bücher, Zeitungen, Bilddrucke usw.;NULL;NULL;#WERT!
01.11.25;WA50;Seide;NULL;NULL;#WERT!
01.11.25;WA51;Wolle, feine und grobe Tierhaare;NULL;NULL;#WERT!
01.11.25;WA52;Baumwolle;NULL;NULL;#WERT!
01.11.25;WA53;Andere pflanzliche Spinnstoffe, Papiergarn;NULL;NULL;#WERT!
01.11.25;WA54;Synthetisches oder künstliches Filament;NULL;NULL;#WERT!
01.11.25;WA55;Synthetische oder künstliche Spinnfaser;NULL;NULL;#WERT!
01.11.25;WA56;Watte, Filz, Vliesstoff usw., Tauwerk;NULL;NULL;#WERT!
01.11.25;WA57;Teppiche, Fussbodenbelag aus Spinnstoff;NULL;NULL;#WERT!
01.11.25;WA58;Spezialgewebe, Spitzen, Tapisserien;NULL;NULL;#WERT!
01.11.25;WA59;Getränkte, bestrichene usw. Gewebe;NULL;NULL;#WERT!
01.11.25;WA60;Gewirke und Gestricke;NULL;NULL;#WERT!
01.11.25;WA61;Bekleidung usw. aus Gewirken, Gestricken;NULL;NULL;#WERT!
01.11.25;WA62;Andere Bekleidung, Bekleidungszubehör;NULL;NULL;#WERT!
01.11.25;WA63;Andere Konfektion, Spinnstoffwaren usw.;NULL;NULL;#WERT!
01.11.25;WA64;Schuhe, Gamaschen, ähnliche Waren;NULL;NULL;#WERT!
01.11.25;WA65;Kopfbedeckungen und Teile davon;NULL;NULL;#WERT!
01.11.25;WA66;Schirme, Gehstöcke usw., Peitschen;NULL;NULL;#WERT!
01.11.25;WA67;Zugerichtete Federn, Daunen, künstliche Blumen;NULL;NULL;#WERT!
01.11.25;WA68;Waren aus Steinen, Gips, Zement usw.;NULL;NULL;#WERT!
01.11.25;WA69;Keramische Waren;NULL;NULL;#WERT!
01.11.25;WA70;Glas und Glaswaren;NULL;NULL;#WERT!
01.11.25;WA71;Perlen, Edelsteine, Edelmetalle;NULL;NULL;#WERT!
01.11.25;WA72;Eisen und Stahl;NULL;NULL;#WERT!
01.11.25;WA73;Waren aus Eisen oder Stahl;NULL;NULL;#WERT!
01.11.25;WA74;Kupfer und Waren daraus;NULL;NULL;#WERT!
01.11.25;WA75;Nickel und Waren daraus;NULL;NULL;#WERT!
01.11.25;WA76;Aluminium und Waren daraus;NULL;NULL;#WERT!
01.11.25;WA78;Blei und Waren daraus;NULL;NULL;#WERT!
01.11.25;WA79;Zink und Waren daraus;NULL;NULL;#WERT!
01.11.25;WA80;Zinn und Waren daraus;NULL;NULL;#WERT!
01.11.25;WA81;Andere unedle Metalle, Cermets usw.;NULL;NULL;#WERT!
01.11.25;WA82;Werkzeuge, Schneidwaren, Essbestecke;NULL;NULL;#WERT!
01.11.25;WA83;Verschiedene Waren aus unedlen Metallen;NULL;NULL;#WERT!
01.11.25;WA84;Maschinen, Apparate, mechanische Geräte;NULL;NULL;#WERT!
01.11.25;WA85;Elektrotechnische Erzeugnisse;NULL;NULL;#WERT!
01.11.25;WA86;Schienenfahrzeuge;NULL;NULL;#WERT!
01.11.25;WA87;Kraftfahrzeuge, Landfahrzeuge;NULL;NULL;#WERT!
01.11.25;WA88;Luftfahrzeuge, Raumfahrzeuge;NULL;NULL;#WERT!
01.11.25;WA89;Wasserfahrzeuge;NULL;NULL;#WERT!
01.11.25;WA90;Optische, photografische usw. Erzeugnisse;NULL;NULL;#WERT!
01.11.25;WA91;Uhrmacherwaren;NULL;NULL;#WERT!
01.11.25;WA92;Musikinstrumente;NULL;NULL;#WERT!
01.11.25;WA93;Waffen und Munition;NULL;NULL;#WERT!
01.11.25;WA94;Möbel, Beleuchtungskörper usw.;NULL;NULL;#WERT!
01.11.25;WA95;Spielzeug, Spiele usw., Sportgeräte;NULL;NULL;#WERT!
01.11.25;WA96;Verschiedene Waren;NULL;NULL;#WERT!
01.11.25;WA97;Kunstgegenstände, Sammlungsstücke;NULL;NULL;#WERT!
01.11.25;WA98;Vollständige Fabrikationsanlagen;NULL;NULL;#WERT!
01.11.25;WA99;Zusammenstellungen verschiedener Waren;NULL;NULL;#WERT!
01.12.08;WA01;Lebende Tiere;77587;111044;-33457
01.12.08;WA02;Fleisch;549084;455779;93305
01.12.08;WA03;Fische, Krebs- und Weichtiere;100851;211902;-111051
01.12.08;WA04;Milch, Milcherzeugnisse, Eier, Honig;521315;477934;43381
01.12.08;WA05;Andere Waren tierischen Ursprungs;44398;55337;-10939
01.12.08;WA06;Pflanzen, Waren des Blumenhandels;44318;197171;-152853
01.12.08;WA07;Gemüse, Pflanzen für Ernährung;60552;335108;-274556
01.12.08;WA08;Geniessbare Früchte und Nüsse;111998;484757;-372759
01.12.08;WA09;Kaffee, Tee, Mate, Gewürze;129613;244359;-114746
01.12.08;WA10;Getreide;189489;182721;6768
01.12.08;WA11;Müllereierzeugnisse, Malz usw.;74724;35436;39288
01.12.08;WA12;Ölsamen usw., Heilpflanzen usw.;68135;335366;-267231
01.12.08;WA13;Schellack, Gummen, Harz, Pflanzensaft;33680;20929;12751
01.12.08;WA14;Flechtstoffe usw. pflanzlichen Ursprungs;752;2270;-1518
01.12.08;WA15;Tierische und pflanzliche Fette, Öle, Wachs;166128;319051;-152923
01.12.08;WA16;Zubereitungen von Fleisch, Fisch usw.;212867;206007;6860
01.12.08;WA17;Zucker und Zuckerwaren;102099;89926;12173
01.12.08;WA18;Kakao und Zubereitungen aus Kakao;208804;189720;19084
01.12.08;WA19;Zubereitungen aus Getreide usw., Backwaren;318759;182469;136290
01.12.08;WA20;Zubereitungen von Gemüse, Früchten usw.;167922;296478;-128556
01.12.08;WA21;Verschiedene Lebensmittelzubereitungen;261388;184522;76866
01.12.08;WA22;Getränke, alkoholhaltige Flüssigkeiten, Essig;303448;475884;-172436
01.12.08;WA23;Rückstände der Lebensmittelindustrie, Futter;211169;214592;-3423
01.12.08;WA24;Tabak;214920;135334;79586
01.12.08;WA25;Salz, Schwefel, Steine, Erden usw.;134826;114857;19969
01.12.08;WA26;Erze, Schlacken, Aschen;12093;553193;-541100
01.12.08;WA27;Mineralische Brennstoffe usw.;1781448;8224112;-6442664
01.12.08;WA28;Anorganische chemische Erzeugnisse;529400;449893;79507
01.12.08;WA29;Organische chemische Erzeugnisse;1328398;1306081;22317
01.12.08;WA30;Pharmazeutische Erzeugnisse;3368912;2645330;723582
01.12.08;WA31;Düngemittel;180688;126033;54655
01.12.08;WA32;Gerb- und Farbstoffe, Farben, Lacke usw.;443131;230724;212407
01.12.08;WA33;Etherische Öle, Riech-, Schönheitsmittel;492455;314567;177888
01.12.08;WA34;Seifen, Waschmittel usw.;317901;186937;130964
01.12.08;WA35;Eiweissstoffe, Klebstoffe, Enzyme;136678;109517;27161
01.12.08;WA36;Sprengstoffe, pyrotechnische Artikel usw.;18762;14538;4224
01.12.08;WA37;Photochemische Erzeugnisse;82333;55976;26357
01.12.08;WA38;Verschiedene Erzeugnisse der Chemischen Industrie;943417;659644;283773
01.12.08;WA39;Kunststoffe und Waren daraus;2387377;1588372;799005
01.12.08;WA40;Kautschuk und Waren daraus;561239;507248;53991
01.12.08;WA41;Häute, Felle, Leder;55445;53467;1978
01.12.08;WA42;Lederwaren, Sattlerwaren;95246;196098;-100852
01.12.08;WA43;Pelzfelle, künstliches Pelzwerk;7531;9937;-2406
01.12.08;WA44;Holz, Holzwaren, Holzkohle;451100;341275;109825
01.12.08;WA45;Kork, Korkwaren;2089;5638;-3549
01.12.08;WA46;Flechtwaren, Korbmacherwaren;3230;11161;-7931
01.12.08;WA47;Halbstoffe aus Holz usw., Papierabfall;46896;224664;-177768
01.12.08;WA48;Papier, Pappe und Waren daraus;1231168;911666;319502
01.12.08;WA49;Bücher, Zeitungen, Bilddrucke usw.;429826;203129;226697
01.12.08;WA50;Seide;5946;6756;-810
01.12.08;WA51;Wolle, feine und grobe Tierhaare;31867;42655;-10788
01.12.08;WA52;Baumwolle;83183;69173;14010
01.12.08;WA53;Andere pflanzliche Spinnstoffe, Papiergarn;8065;8656;-591
01.12.08;WA54;Synthetisches oder künstliches Filament;129955;84480;45475
01.12.08;WA55;Synthetische oder künstliche Spinnfaser;114849;84276;30573
01.12.08;WA56;Watte, Filz, Vliesstoff usw., Tauwerk;112991;63973;49018
01.12.08;WA57;Teppiche, Fussbodenbelag aus Spinnstoff;35202;76890;-41688
01.12.08;WA58;Spezialgewebe, Spitzen, Tapisserien;32651;20852;11799
01.12.08;WA59;Getränkte, bestrichene usw. Gewebe;106198;77089;29109
01.12.08;WA60;Gewirke und Gestricke;51748;29485;22263
01.12.08;WA61;Bekleidung usw. aus Gewirken, Gestricken;337441;802511;-465070
01.12.08;WA62;Andere Bekleidung, Bekleidungszubehör;398917;880098;-481181
01.12.08;WA63;Andere Konfektion, Spinnstoffwaren usw.;118561;187558;-68997
01.12.08;WA64;Schuhe, Gamaschen, ähnliche Waren;148331;382338;-234007
01.12.08;WA65;Kopfbedeckungen und Teile davon;15409;25010;-9601
01.12.08;WA66;Schirme, Gehstöcke usw., Peitschen;11761;13060;-1299
01.12.08;WA67;Zugerichtete Federn, Daunen, künstliche Blumen;4080;13351;-9271
01.12.08;WA68;Waren aus Steinen, Gips, Zement usw.;195649;138481;57168
01.12.08;WA69;Keramische Waren;188396;137745;50651
01.12.08;WA70;Glas und Glaswaren;333841;291883;41958
01.12.08;WA71;Perlen, Edelsteine, Edelmetalle;470526;664791;-194265
01.12.08;WA72;Eisen und Stahl;1308207;1635471;-327264
01.12.08;WA73;Waren aus Eisen oder Stahl;1655898;1097016;558882
01.12.08;WA74;Kupfer und Waren daraus;479307;547193;-67886
01.12.08;WA75;Nickel und Waren daraus;57279;99441;-42162
01.12.08;WA76;Aluminium und Waren daraus;716872;639357;77515
01.12.08;WA78;Blei und Waren daraus;31744;10513;21231
01.12.08;WA79;Zink und Waren daraus;24556;39863;-15307
01.12.08;WA80;Zinn und Waren daraus;4532;13819;-9287
01.12.08;WA81;Andere unedle Metalle, Cermets usw.;68715;90989;-22274
01.12.08;WA82;Werkzeuge, Schneidwaren, Essbestecke;410356;255350;155006
01.12.08;WA83;Verschiedene Waren aus unedlen Metallen;337155;233189;103966
01.12.08;WA84;Maschinen, Apparate, mechanische Geräte;13813673;8105480;5708193
01.12.08;WA85;Elektrotechnische Erzeugnisse;6998236;6295734;702502
01.12.08;WA86;Schienenfahrzeuge;399527;135954;263573
01.12.08;WA87;Kraftfahrzeuge, Landfahrzeuge;8936370;3769548;5166822
01.12.08;WA88;Luftfahrzeuge, Raumfahrzeuge;2227029;1872417;354612
01.12.08;WA89;Wasserfahrzeuge;294164;1466483;-1172319
01.12.08;WA90;Optische, photografische usw. Erzeugnisse;3097835;1779026;1318809
01.12.08;WA91;Uhrmacherwaren;106139;120122;-13983
01.12.08;WA92;Musikinstrumente;42215;38543;3672
01.12.08;WA93;Waffen und Munition;34474;13298;21176
01.12.08;WA94;Möbel, Beleuchtungskörper usw.;872794;937635;-64841
01.12.08;WA95;Spielzeug, Spiele usw., Sportgeräte;689339;597274;92065
01.12.08;WA96;Verschiedene Waren;137350;94408;42942
01.12.08;WA97;Kunstgegenstände, Sammlungsstücke;55543;32937;22606
01.12.08;WA98;Vollständige Fabrikationsanlagen;498219;7516;490703
01.12.08;WA99;Zusammenstellungen verschiedener Waren;1264254;856545;407709
01.12.09;WA01;Lebende Tiere;87155;123759;-36604
01.12.09;WA02;Fleisch;561791;441998;119793
01.12.09;WA03;Fische, Krebs- und Weichtiere;83883;235457;-151574
01.12.09;WA04;Milch, Milcherzeugnisse, Eier, Honig;532977;512341;20636
01.12.09;WA05;Andere Waren tierischen Ursprungs;41497;56605;-15108
01.12.09;WA06;Pflanzen, Waren des Blumenhandels;35922;182252;-146330
01.12.09;WA07;Gemüse, Pflanzen für Ernährung;63557;343092;-279535
01.12.09;WA08;Geniessbare Früchte und Nüsse;111385;526178;-414793
01.12.09;WA09;Kaffee, Tee, Mate, Gewürze;117590;208983;-91393
01.12.09;WA10;Getreide;141732;123779;17953
01.12.09;WA11;Müllereierzeugnisse, Malz usw.;67853;32610;35243
01.12.09;WA12;Ölsamen usw., Heilpflanzen usw.;54952;228024;-173072
01.12.09;WA13;Schellack, Gummen, Harz, Pflanzensaft;28002;27585;417
01.12.09;WA14;Flechtstoffe usw. pflanzlichen Ursprungs;834;1392;-558
01.12.09;WA15;Tierische und pflanzliche Fette, Öle, Wachs;136531;185089;-48558
01.12.09;WA16;Zubereitungen von Fleisch, Fisch usw.;194492;179394;15098
01.12.09;WA17;Zucker und Zuckerwaren;126874;91881;34993
01.12.09;WA18;Kakao und Zubereitungen aus Kakao;241064;214076;26988
01.12.09;WA19;Zubereitungen aus Getreide usw., Backwaren;323352;191243;132109
01.12.09;WA20;Zubereitungen von Gemüse, Früchten usw.;169446;286873;-117427
01.12.09;WA21;Verschiedene Lebensmittelzubereitungen;279743;219732;60011
01.12.09;WA22;Getränke, alkoholhaltige Flüssigkeiten, Essig;351267;458477;-107210
01.12.09;WA23;Rückstände der Lebensmittelindustrie, Futter;225807;214784;11023
01.12.09;WA24;Tabak;228990;95936;133054
01.12.09;WA25;Salz, Schwefel, Steine, Erden usw.;131131;122702;8429
01.12.09;WA26;Erze, Schlacken, Aschen;19946;447895;-427949
01.12.09;WA27;Mineralische Brennstoffe usw.;1523075;6936402;-5413327
01.12.09;WA28;Anorganische chemische Erzeugnisse;505383;560563;-55180
01.12.09;WA29;Organische chemische Erzeugnisse;1435050;1551800;-116750
01.12.09;WA30;Pharmazeutische Erzeugnisse;3576488;2431112;1145376
01.12.09;WA31;Düngemittel;161637;59171;102466
01.12.09;WA32;Gerb- und Farbstoffe, Farben, Lacke usw.;530304;275931;254373
01.12.09;WA33;Etherische Öle, Riech-, Schönheitsmittel;514939;310420;204519
01.12.09;WA34;Seifen, Waschmittel usw.;339041;214053;124988
01.12.09;WA35;Eiweissstoffe, Klebstoffe, Enzyme;147198;107298;39900
01.12.09;WA36;Sprengstoffe, pyrotechnische Artikel usw.;19664;15439;4225
01.12.09;WA37;Photochemische Erzeugnisse;91002;61102;29900
01.12.09;WA38;Verschiedene Erzeugnisse der Chemischen Industrie;998249;707869;290380
01.12.09;WA39;Kunststoffe und Waren daraus;2756049;1687691;1068358
01.12.09;WA40;Kautschuk und Waren daraus;694186;605663;88523
01.12.09;WA41;Häute, Felle, Leder;52873;54844;-1971
01.12.09;WA42;Lederwaren, Sattlerwaren;91338;169344;-78006
01.12.09;WA43;Pelzfelle, künstliches Pelzwerk;8563;11648;-3085
01.12.09;WA44;Holz, Holzwaren, Holzkohle;423409;362709;60700
01.12.09;WA45;Kork, Korkwaren;2515;5893;-3378
01.12.09;WA46;Flechtwaren, Korbmacherwaren;3631;9787;-6156
01.12.09;WA47;Halbstoffe aus Holz usw., Papierabfall;61990;214233;-152243
01.12.09;WA48;Papier, Pappe und Waren daraus;1300928;825619;475309
01.12.09;WA49;Bücher, Zeitungen, Bilddrucke usw.;379721;180674;199047
01.12.09;WA50;Seide;4849;4256;593
01.12.09;WA51;Wolle, feine und grobe Tierhaare;38736;34516;4220
01.12.09;WA52;Baumwolle;77314;58546;18768
01.12.09;WA53;Andere pflanzliche Spinnstoffe, Papiergarn;5947;6659;-712
01.12.09;WA54;Synthetisches oder künstliches Filament;128467;78697;49770
01.12.09;WA55;Synthetische oder künstliche Spinnfaser;122833;82071;40762
01.12.09;WA56;Watte, Filz, Vliesstoff usw., Tauwerk;119939;73987;45952
01.12.09;WA57;Teppiche, Fussbodenbelag aus Spinnstoff;32137;82781;-50644
01.12.09;WA58;Spezialgewebe, Spitzen, Tapisserien;31711;21105;10606
01.12.09;WA59;Getränkte, bestrichene usw. Gewebe;110834;77991;32843
01.12.09;WA60;Gewirke und Gestricke;56901;24044;32857
01.12.09;WA61;Bekleidung usw. aus Gewirken, Gestricken;337320;756918;-419598
01.12.09;WA62;Andere Bekleidung, Bekleidungszubehör;361441;786958;-425517
01.12.09;WA63;Andere Konfektion, Spinnstoffwaren usw.;129436;207488;-78052
01.12.09;WA64;Schuhe, Gamaschen, ähnliche Waren;135795;305845;-170050
01.12.09;WA65;Kopfbedeckungen und Teile davon;14294;24441;-10147
01.12.09;WA66;Schirme, Gehstöcke usw., Peitschen;13793;8206;5587
01.12.09;WA67;Zugerichtete Federn, Daunen, künstliche Blumen;4130;11936;-7806
01.12.09;WA68;Waren aus Steinen, Gips, Zement usw.;198838;133221;65617
01.12.09;WA69;Keramische Waren;213891;145995;67896
01.12.09;WA70;Glas und Glaswaren;322113;246076;76037
01.12.09;WA71;Perlen, Edelsteine, Edelmetalle;608746;655818;-47072
01.12.09;WA72;Eisen und Stahl;1227404;1083872;143532
01.12.09;WA73;Waren aus Eisen oder Stahl;1463706;954293;509413
01.12.09;WA74;Kupfer und Waren daraus;576299;573822;2477
01.12.09;WA75;Nickel und Waren daraus;44241;65616;-21375
01.12.09;WA76;Aluminium und Waren daraus;760225;691498;68727
01.12.09;WA78;Blei und Waren daraus;39577;27427;12150
01.12.09;WA79;Zink und Waren daraus;33553;62390;-28837
01.12.09;WA80;Zinn und Waren daraus;4526;10126;-5600
01.12.09;WA81;Andere unedle Metalle, Cermets usw.;63092;63800;-708
01.12.09;WA82;Werkzeuge, Schneidwaren, Essbestecke;423224;239449;183775
01.12.09;WA83;Verschiedene Waren aus unedlen Metallen;381316;225305;156011
01.12.09;WA84;Maschinen, Apparate, mechanische Geräte;13082498;6943491;6139007
01.12.09;WA85;Elektrotechnische Erzeugnisse;7182818;6954007;228811
01.12.09;WA86;Schienenfahrzeuge;374563;137051;237512
01.12.09;WA87;Kraftfahrzeuge, Landfahrzeuge;9781611;3931620;5849991
01.12.09;WA88;Luftfahrzeuge, Raumfahrzeuge;2338517;1181265;1157252
01.12.09;WA89;Wasserfahrzeuge;38257;580407;-542150
01.12.09;WA90;Optische, photografische usw. Erzeugnisse;3266709;1733703;1533006
01.12.09;WA91;Uhrmacherwaren;90276;90175;101
01.12.09;WA92;Musikinstrumente;38187;40552;-2365
01.12.09;WA93;Waffen und Munition;32625;9475;23150
01.12.09;WA94;Möbel, Beleuchtungskörper usw.;894068;948057;-53989
01.12.09;WA95;Spielzeug, Spiele usw., Sportgeräte;641872;529671;112201
01.12.09;WA96;Verschiedene Waren;139386;86372;53014
01.12.09;WA97;Kunstgegenstände, Sammlungsstücke;45964;29916;16048
01.12.09;WA98;Vollständige Fabrikationsanlagen;328336;21015;307321
01.12.09;WA99;Zusammenstellungen verschiedener Waren;1175921;877521;298400
01.12.10;WA01;Lebende Tiere;113110;134065;-20955
01.12.10;WA02;Fleisch;612813;489336;123477
01.12.10;WA03;Fische, Krebs- und Weichtiere;116493;277079;-160586
01.12.10;WA04;Milch, Milcherzeugnisse, Eier, Honig;604714;530010;74704
01.12.10;WA05;Andere Waren tierischen Ursprungs;48254;61282;-13028
01.12.10;WA06;Pflanzen, Waren des Blumenhandels;42184;180511;-138327
01.12.10;WA07;Gemüse, Pflanzen für Ernährung;76972;386273;-309301
01.12.10;WA08;Geniessbare Früchte und Nüsse;115836;505267;-389431
01.12.10;WA09;Kaffee, Tee, Mate, Gewürze;165673;307194;-141521
01.12.10;WA10;Getreide;225276;192259;33017
01.12.10;WA11;Müllereierzeugnisse, Malz usw.;84102;34971;49131
01.12.10;WA12;Ölsamen usw., Heilpflanzen usw.;80130;240535;-160405
01.12.10;WA13;Schellack, Gummen, Harz, Pflanzensaft;36076;27663;8413
01.12.10;WA14;Flechtstoffe usw. pflanzlichen Ursprungs;663;1406;-743
01.12.10;WA15;Tierische und pflanzliche Fette, Öle, Wachs;154004;304092;-150088
01.12.10;WA16;Zubereitungen von Fleisch, Fisch usw.;188501;191744;-3243
01.12.10;WA17;Zucker und Zuckerwaren;121223;91846;29377
01.12.10;WA18;Kakao und Zubereitungen aus Kakao;275102;255540;19562
01.12.10;WA19;Zubereitungen aus Getreide usw., Backwaren;353272;206468;146804
01.12.10;WA20;Zubereitungen von Gemüse, Früchten usw.;176292;369108;-192816
01.12.10;WA21;Verschiedene Lebensmittelzubereitungen;288214;166853;121361
01.12.10;WA22;Getränke, alkoholhaltige Flüssigkeiten, Essig;357590;507579;-149989
01.12.10;WA23;Rückstände der Lebensmittelindustrie, Futter;236524;260040;-23516
01.12.10;WA24;Tabak;253685;97836;155849
01.12.10;WA25;Salz, Schwefel, Steine, Erden usw.;129751;160538;-30787
01.12.10;WA26;Erze, Schlacken, Aschen;21698;714931;-693233
01.12.10;WA27;Mineralische Brennstoffe usw.;2129576;8875903;-6746327
01.12.10;WA28;Anorganische chemische Erzeugnisse;647440;599774;47666
01.12.10;WA29;Organische chemische Erzeugnisse;1719055;1813518;-94463
01.12.10;WA30;Pharmazeutische Erzeugnisse;4200869;2569849;1631020
01.12.10;WA31;Düngemittel;174588;92000;82588
01.12.10;WA32;Gerb- und Farbstoffe, Farben, Lacke usw.;593917;345563;248354
01.12.10;WA33;Etherische Öle, Riech-, Schönheitsmittel;646586;361501;285085
01.12.10;WA34;Seifen, Waschmittel usw.;407082;231792;175290
01.12.10;WA35;Eiweissstoffe, Klebstoffe, Enzyme;162401;118843;43558
01.12.10;WA36;Sprengstoffe, pyrotechnische Artikel usw.;25051;22864;2187
01.12.10;WA37;Photochemische Erzeugnisse;84826;72531;12295
01.12.10;WA38;Verschiedene Erzeugnisse der Chemischen Industrie;1296699;831447;465252
01.12.10;WA39;Kunststoffe und Waren daraus;3292224;2169225;1122999
01.12.10;WA40;Kautschuk und Waren daraus;925442;854247;71195
01.12.10;WA41;Häute, Felle, Leder;70356;68415;1941
01.12.10;WA42;Lederwaren, Sattlerwaren;112743;225560;-112817
01.12.10;WA43;Pelzfelle, künstliches Pelzwerk;9446;15613;-6167
01.12.10;WA44;Holz, Holzwaren, Holzkohle;450337;419606;30731
01.12.10;WA45;Kork, Korkwaren;2092;8278;-6186
01.12.10;WA46;Flechtwaren, Korbmacherwaren;2541;9057;-6516
01.12.10;WA47;Halbstoffe aus Holz usw., Papierabfall;99385;317847;-218462
01.12.10;WA48;Papier, Pappe und Waren daraus;1491457;959719;531738
01.12.10;WA49;Bücher, Zeitungen, Bilddrucke usw.;422802;187728;235074
01.12.10;WA50;Seide;5081;5912;-831
01.12.10;WA51;Wolle, feine und grobe Tierhaare;51832;59450;-7618
01.12.10;WA52;Baumwolle;94888;89669;5219
01.12.10;WA53;Andere pflanzliche Spinnstoffe, Papiergarn;6309;7679;-1370
01.12.10;WA54;Synthetisches oder künstliches Filament;151438;103562;47876
01.12.10;WA55;Synthetische oder künstliche Spinnfaser;159724;115308;44416
01.12.10;WA56;Watte, Filz, Vliesstoff usw., Tauwerk;141385;75616;65769
01.12.10;WA57;Teppiche, Fussbodenbelag aus Spinnstoff;41443;92639;-51196
01.12.10;WA58;Spezialgewebe, Spitzen, Tapisserien;34111;25480;8631
01.12.10;WA59;Getränkte, bestrichene usw. Gewebe;137836;81900;55936
01.12.10;WA60;Gewirke und Gestricke;62840;32500;30340
01.12.10;WA61;Bekleidung usw. aus Gewirken, Gestricken;468565;999879;-531314
01.12.10;WA62;Andere Bekleidung, Bekleidungszubehör;445095;983606;-538511
01.12.10;WA63;Andere Konfektion, Spinnstoffwaren usw.;145161;242252;-97091
01.12.10;WA64;Schuhe, Gamaschen, ähnliche Waren;180806;448027;-267221
01.12.10;WA65;Kopfbedeckungen und Teile davon;16291;31658;-15367
01.12.10;WA66;Schirme, Gehstöcke usw., Peitschen;4951;13050;-8099
01.12.10;WA67;Zugerichtete Federn, Daunen, künstliche Blumen;5188;13796;-8608
01.12.10;WA68;Waren aus Steinen, Gips, Zement usw.;229939;160804;69135
01.12.10;WA69;Keramische Waren;215657;169168;46489
01.12.10;WA70;Glas und Glaswaren;373845;292752;81093
01.12.10;WA71;Perlen, Edelsteine, Edelmetalle;1238116;1118946;119170
01.12.10;WA72;Eisen und Stahl;1616671;1775296;-158625
01.12.10;WA73;Waren aus Eisen oder Stahl;1651305;1152143;499162
01.12.10;WA74;Kupfer und Waren daraus;809522;967070;-157548
01.12.10;WA75;Nickel und Waren daraus;71946;121431;-49485
01.12.10;WA76;Aluminium und Waren daraus;787157;976820;-189663
01.12.10;WA78;Blei und Waren daraus;32516;37040;-4524
01.12.10;WA79;Zink und Waren daraus;42410;72565;-30155
01.12.10;WA80;Zinn und Waren daraus;10836;29806;-18970
01.12.10;WA81;Andere unedle Metalle, Cermets usw.;86283;103772;-17489
01.12.10;WA82;Werkzeuge, Schneidwaren, Essbestecke;485140;290572;194568
01.12.10;WA83;Verschiedene Waren aus unedlen Metallen;402044;256333;145711
01.12.10;WA84;Maschinen, Apparate, mechanische Geräte;15155939;8579445;6576494
01.12.10;WA85;Elektrotechnische Erzeugnisse;9405960;8487694;918266
01.12.10;WA86;Schienenfahrzeuge;326025;142913;183112
01.12.10;WA87;Kraftfahrzeuge, Landfahrzeuge;12372608;4971610;7400998
01.12.10;WA88;Luftfahrzeuge, Raumfahrzeuge;1910024;1918481;-8457
01.12.10;WA89;Wasserfahrzeuge;65496;646183;-580687
01.12.10;WA90;Optische, photografische usw. Erzeugnisse;3897518;2023178;1874340
01.12.10;WA91;Uhrmacherwaren;148801;130386;18415
01.12.10;WA92;Musikinstrumente;42405;45264;-2859
01.12.10;WA93;Waffen und Munition;32727;12815;19912
01.12.10;WA94;Möbel, Beleuchtungskörper usw.;966523;1080442;-113919
01.12.10;WA95;Spielzeug, Spiele usw., Sportgeräte;576988;463365;113623
01.12.10;WA96;Verschiedene Waren;156314;98835;57479
01.12.10;WA97;Kunstgegenstände, Sammlungsstücke;45508;32115;13393
01.12.10;WA98;Vollständige Fabrikationsanlagen;247957;23682;224275
01.12.10;WA99;Zusammenstellungen verschiedener Waren;1606874;960468;646406
01.12.11;WA01;Lebende Tiere;135070;131482;3588
01.12.11;WA02;Fleisch;623541;556822;66719
01.12.11;WA03;Fische, Krebs- und Weichtiere;115074;297056;-181982
01.12.11;WA04;Milch, Milcherzeugnisse, Eier, Honig;606290;556057;50233
01.12.11;WA05;Andere Waren tierischen Ursprungs;55163;74788;-19625
01.12.11;WA06;Pflanzen, Waren des Blumenhandels;43902;206453;-162551
01.12.11;WA07;Gemüse, Pflanzen für Ernährung;65637;374104;-308467
01.12.11;WA08;Geniessbare Früchte und Nüsse;106583;533763;-427180
01.12.11;WA09;Kaffee, Tee, Mate, Gewürze;193417;382216;-188799
01.12.11;WA10;Getreide;162885;235093;-72208
01.12.11;WA11;Müllereierzeugnisse, Malz usw.;107299;43324;63975
01.12.11;WA12;Ölsamen usw., Heilpflanzen usw.;82148;336198;-254050
01.12.11;WA13;Schellack, Gummen, Harz, Pflanzensaft;29756;36227;-6471
01.12.11;WA14;Flechtstoffe usw. pflanzlichen Ursprungs;584;1878;-1294
01.12.11;WA15;Tierische und pflanzliche Fette, Öle, Wachs;190278;326027;-135749
01.12.11;WA16;Zubereitungen von Fleisch, Fisch usw.;213918;201098;12820
01.12.11;WA17;Zucker und Zuckerwaren;172343;107934;64409
01.12.11;WA18;Kakao und Zubereitungen aus Kakao;290662;257576;33086
01.12.11;WA19;Zubereitungen aus Getreide usw., Backwaren;364457;224657;139800
01.12.11;WA20;Zubereitungen von Gemüse, Früchten usw.;171570;368517;-196947
01.12.11;WA21;Verschiedene Lebensmittelzubereitungen;326504;181301;145203
01.12.11;WA22;Getränke, alkoholhaltige Flüssigkeiten, Essig;374339;607964;-233625
01.12.11;WA23;Rückstände der Lebensmittelindustrie, Futter;262456;255258;7198
01.12.11;WA24;Tabak;294114;150924;143190
01.12.11;WA25;Salz, Schwefel, Steine, Erden usw.;151039;148967;2072
01.12.11;WA26;Erze, Schlacken, Aschen;28553;588078;-559525
01.12.11;WA27;Mineralische Brennstoffe usw.;2570398;11199859;-8629461
01.12.11;WA28;Anorganische chemische Erzeugnisse;678691;574684;104007
01.12.11;WA29;Organische chemische Erzeugnisse;1758677;2169139;-410462
01.12.11;WA30;Pharmazeutische Erzeugnisse;4122743;2740359;1382384
01.12.11;WA31;Düngemittel;285841;105246;180595
01.12.11;WA32;Gerb- und Farbstoffe, Farben, Lacke usw.;621447;394214;227233
01.12.11;WA33;Etherische Öle, Riech-, Schönheitsmittel;600000;374914;225086
01.12.11;WA34;Seifen, Waschmittel usw.;430219;254178;176041
01.12.11;WA35;Eiweissstoffe, Klebstoffe, Enzyme;177497;127307;50190
01.12.11;WA36;Sprengstoffe, pyrotechnische Artikel usw.;27372;22004;5368
01.12.11;WA37;Photochemische Erzeugnisse;81150;65324;15826
01.12.11;WA38;Verschiedene Erzeugnisse der Chemischen Industrie;1258766;868145;390621
01.12.11;WA39;Kunststoffe und Waren daraus;3268084;2185178;1082906
01.12.11;WA40;Kautschuk und Waren daraus;951911;1005243;-53332
01.12.11;WA41;Häute, Felle, Leder;77563;70926;6637
01.12.11;WA42;Lederwaren, Sattlerwaren;122277;240823;-118546
01.12.11;WA43;Pelzfelle, künstliches Pelzwerk;12966;20405;-7439
01.12.11;WA44;Holz, Holzwaren, Holzkohle;457419;430857;26562
01.12.11;WA45;Kork, Korkwaren;2544;8513;-5969
01.12.11;WA46;Flechtwaren, Korbmacherwaren;2575;11359;-8784
01.12.11;WA47;Halbstoffe aus Holz usw., Papierabfall;82070;261539;-179469
01.12.11;WA48;Papier, Pappe und Waren daraus;1428702;919178;509524
01.12.11;WA49;Bücher, Zeitungen, Bilddrucke usw.;373720;182673;191047
01.12.11;WA50;Seide;5075;6097;-1022
01.12.11;WA51;Wolle, feine und grobe Tierhaare;66145;58809;7336
01.12.11;WA52;Baumwolle;96141;85070;11071
01.12.11;WA53;Andere pflanzliche Spinnstoffe, Papiergarn;7048;8056;-1008
01.12.11;WA54;Synthetisches oder künstliches Filament;132655;96309;36346
01.12.11;WA55;Synthetische oder künstliche Spinnfaser;141890;106669;35221
01.12.11;WA56;Watte, Filz, Vliesstoff usw., Tauwerk;134764;77249;57515
01.12.11;WA57;Teppiche, Fussbodenbelag aus Spinnstoff;39181;99464;-60283
01.12.11;WA58;Spezialgewebe, Spitzen, Tapisserien;31799;22776;9023
01.12.11;WA59;Getränkte, bestrichene usw. Gewebe;142295;84256;58039
01.12.11;WA60;Gewirke und Gestricke;63518;32922;30596
01.12.11;WA61;Bekleidung usw. aus Gewirken, Gestricken;410074;901613;-491539
01.12.11;WA62;Andere Bekleidung, Bekleidungszubehör;418176;981826;-563650
01.12.11;WA63;Andere Konfektion, Spinnstoffwaren usw.;159033;244422;-85389
01.12.11;WA64;Schuhe, Gamaschen, ähnliche Waren;212755;482148;-269393
01.12.11;WA65;Kopfbedeckungen und Teile davon;15689;28087;-12398
01.12.11;WA66;Schirme, Gehstöcke usw., Peitschen;5530;14045;-8515
01.12.11;WA67;Zugerichtete Federn, Daunen, künstliche Blumen;5893;16694;-10801
01.12.11;WA68;Waren aus Steinen, Gips, Zement usw.;239064;171386;67678
01.12.11;WA69;Keramische Waren;242487;173316;69171
01.12.11;WA70;Glas und Glaswaren;349976;287884;62092
01.12.11;WA71;Perlen, Edelsteine, Edelmetalle;1360926;1503750;-142824
01.12.11;WA72;Eisen und Stahl;1665456;1760664;-95208
01.12.11;WA73;Waren aus Eisen oder Stahl;2005466;1301574;703892
01.12.11;WA74;Kupfer und Waren daraus;785058;722494;62564
01.12.11;WA75;Nickel und Waren daraus;83646;119096;-35450
01.12.11;WA76;Aluminium und Waren daraus;823238;886020;-62782
01.12.11;WA78;Blei und Waren daraus;26914;19667;7247
01.12.11;WA79;Zink und Waren daraus;43544;68908;-25364
01.12.11;WA80;Zinn und Waren daraus;5797;29225;-23428
01.12.11;WA81;Andere unedle Metalle, Cermets usw.;102127;121041;-18914
01.12.11;WA82;Werkzeuge, Schneidwaren, Essbestecke;524036;316656;207380
01.12.11;WA83;Verschiedene Waren aus unedlen Metallen;420647;268276;152371
01.12.11;WA84;Maschinen, Apparate, mechanische Geräte;16252808;9459791;6793017
01.12.11;WA85;Elektrotechnische Erzeugnisse;8445875;8088378;357497
01.12.11;WA86;Schienenfahrzeuge;373179;130892;242287
01.12.11;WA87;Kraftfahrzeuge, Landfahrzeuge;13519177;5215370;8303807
01.12.11;WA88;Luftfahrzeuge, Raumfahrzeuge;2956259;1463546;1492713
01.12.11;WA89;Wasserfahrzeuge;155542;372374;-216832
01.12.11;WA90;Optische, photografische usw. Erzeugnisse;4323381;2219876;2103505
01.12.11;WA91;Uhrmacherwaren;141573;159946;-18373
01.12.11;WA92;Musikinstrumente;50339;50822;-483
01.12.11;WA93;Waffen und Munition;35103;12046;23057
01.12.11;WA94;Möbel, Beleuchtungskörper usw.;1015844;1101289;-85445
01.12.11;WA95;Spielzeug, Spiele usw., Sportgeräte;440356;384534;55822
01.12.11;WA96;Verschiedene Waren;143364;109753;33611
01.12.11;WA97;Kunstgegenstände, Sammlungsstücke;58483;40602;17881
01.12.11;WA98;Vollständige Fabrikationsanlagen;390317;13328;376989
01.12.11;WA99;Zusammenstellungen verschiedener Waren;1177428;950387;227041
01.12.12;WA01;Lebende Tiere;119761;144318;-24557
01.12.12;WA02;Fleisch;631324;542809;88515
01.12.12;WA03;Fische, Krebs- und Weichtiere;103680;268087;-164407
01.12.12;WA04;Milch, Milcherzeugnisse, Eier, Honig;629912;562955;66957
01.12.12;WA05;Andere Waren tierischen Ursprungs;56214;65062;-8848
01.12.12;WA06;Pflanzen, Waren des Blumenhandels;49839;180802;-130963
01.12.12;WA07;Gemüse, Pflanzen für Ernährung;70708;428396;-357688
01.12.12;WA08;Geniessbare Früchte und Nüsse;107270;580380;-473110
01.12.12;WA09;Kaffee, Tee, Mate, Gewürze;167194;288531;-121337
01.12.12;WA10;Getreide;219380;197267;22113
01.12.12;WA11;Müllereierzeugnisse, Malz usw.;97260;37917;59343
01.12.12;WA12;Ölsamen usw., Heilpflanzen usw.;73245;350498;-277253
01.12.12;WA13;Schellack, Gummen, Harz, Pflanzensaft;33230;29443;3787
01.12.12;WA14;Flechtstoffe usw. pflanzlichen Ursprungs;970;1555;-585
01.12.12;WA15;Tierische und pflanzliche Fette, Öle, Wachs;219815;242865;-23050
01.12.12;WA16;Zubereitungen von Fleisch, Fisch usw.;206281;201132;5149
01.12.12;WA17;Zucker und Zuckerwaren;160943;109277;51666
01.12.12;WA18;Kakao und Zubereitungen aus Kakao;304067;205095;98972
01.12.12;WA19;Zubereitungen aus Getreide usw., Backwaren;353422;220930;132492
01.12.12;WA20;Zubereitungen von Gemüse, Früchten usw.;174171;349111;-174940
01.12.12;WA21;Verschiedene Lebensmittelzubereitungen;326303;178651;147652
01.12.12;WA22;Getränke, alkoholhaltige Flüssigkeiten, Essig;385290;539445;-154155
01.12.12;WA23;Rückstände der Lebensmittelindustrie, Futter;309898;327196;-17298
01.12.12;WA24;Tabak;285343;129253;156090
01.12.12;WA25;Salz, Schwefel, Steine, Erden usw.;123637;133188;-9551
01.12.12;WA26;Erze, Schlacken, Aschen;29695;644457;-614762
01.12.12;WA27;Mineralische Brennstoffe usw.;2402051;11863601;-9461550
01.12.12;WA28;Anorganische chemische Erzeugnisse;655794;536402;119392
01.12.12;WA29;Organische chemische Erzeugnisse;1851436;1788386;63050
01.12.12;WA30;Pharmazeutische Erzeugnisse;3852519;2269696;1582823
01.12.12;WA31;Düngemittel;164704;92362;72342
01.12.12;WA32;Gerb- und Farbstoffe, Farben, Lacke usw.;646515;399280;247235
01.12.12;WA33;Etherische Öle, Riech-, Schönheitsmittel;571237;379767;191470
01.12.12;WA34;Seifen, Waschmittel usw.;398968;228721;170247
01.12.12;WA35;Eiweissstoffe, Klebstoffe, Enzyme;192111;126916;65195
01.12.12;WA36;Sprengstoffe, pyrotechnische Artikel usw.;29483;24545;4938
01.12.12;WA37;Photochemische Erzeugnisse;100985;68170;32815
01.12.12;WA38;Verschiedene Erzeugnisse der Chemischen Industrie;1218607;817044;401563
01.12.12;WA39;Kunststoffe und Waren daraus;3167374;2147119;1020255
01.12.12;WA40;Kautschuk und Waren daraus;893744;728383;165361
01.12.12;WA41;Häute, Felle, Leder;67732;59000;8732
01.12.12;WA42;Lederwaren, Sattlerwaren;114077;232929;-118852
01.12.12;WA43;Pelzfelle, künstliches Pelzwerk;10680;14083;-3403
01.12.12;WA44;Holz, Holzwaren, Holzkohle;382742;422647;-39905
01.12.12;WA45;Kork, Korkwaren;1998;5620;-3622
01.12.12;WA46;Flechtwaren, Korbmacherwaren;2463;8083;-5620
01.12.12;WA47;Halbstoffe aus Holz usw., Papierabfall;79579;252674;-173095
01.12.12;WA48;Papier, Pappe und Waren daraus;1198749;802632;396117
01.12.12;WA49;Bücher, Zeitungen, Bilddrucke usw.;344443;146730;197713
01.12.12;WA50;Seide;7936;6774;1162
01.12.12;WA51;Wolle, feine und grobe Tierhaare;43002;56950;-13948
01.12.12;WA52;Baumwolle;77370;76496;874
01.12.12;WA53;Andere pflanzliche Spinnstoffe, Papiergarn;5227;7250;-2023
01.12.12;WA54;Synthetisches oder künstliches Filament;117115;88474;28641
01.12.12;WA55;Synthetische oder künstliche Spinnfaser;126470;99751;26719
01.12.12;WA56;Watte, Filz, Vliesstoff usw., Tauwerk;126268;79329;46939
01.12.12;WA57;Teppiche, Fussbodenbelag aus Spinnstoff;36143;73834;-37691
01.12.12;WA58;Spezialgewebe, Spitzen, Tapisserien;27988;20712;7276
01.12.12;WA59;Getränkte, bestrichene usw. Gewebe;124567;71938;52629
01.12.12;WA60;Gewirke und Gestricke;49048;30891;18157
01.12.12;WA61;Bekleidung usw. aus Gewirken, Gestricken;384265;834072;-449807
01.12.12;WA62;Andere Bekleidung, Bekleidungszubehör;388820;855684;-466864
01.12.12;WA63;Andere Konfektion, Spinnstoffwaren usw.;146705;225730;-79025
01.12.12;WA64;Schuhe, Gamaschen, ähnliche Waren;172711;471652;-298941
01.12.12;WA65;Kopfbedeckungen und Teile davon;16032;29602;-13570
01.12.12;WA66;Schirme, Gehstöcke usw., Peitschen;3506;9553;-6047
01.12.12;WA67;Zugerichtete Federn, Daunen, künstliche Blumen;5218;13911;-8693
01.12.12;WA68;Waren aus Steinen, Gips, Zement usw.;216912;162241;54671
01.12.12;WA69;Keramische Waren;198074;149960;48114
01.12.12;WA70;Glas und Glaswaren;331642;241189;90453
01.12.12;WA71;Perlen, Edelsteine, Edelmetalle;1167243;1087231;80012
01.12.12;WA72;Eisen und Stahl;1432428;1370630;61798
01.12.12;WA73;Waren aus Eisen oder Stahl;1566615;1098396;468219
01.12.12;WA74;Kupfer und Waren daraus;863011;688292;174719
01.12.12;WA75;Nickel und Waren daraus;75645;93199;-17554
01.12.12;WA76;Aluminium und Waren daraus;752387;800939;-48552
01.12.12;WA78;Blei und Waren daraus;41142;37479;3663
01.12.12;WA79;Zink und Waren daraus;34583;70004;-35421
01.12.12;WA80;Zinn und Waren daraus;6768;22441;-15673
01.12.12;WA81;Andere unedle Metalle, Cermets usw.;88255;104558;-16303
01.12.12;WA82;Werkzeuge, Schneidwaren, Essbestecke;444683;286092;158591
01.12.12;WA83;Verschiedene Waren aus unedlen Metallen;377317;238865;138452
01.12.12;WA84;Maschinen, Apparate, mechanische Geräte;14851414;8153260;6698154
01.12.12;WA85;Elektrotechnische Erzeugnisse;7665470;6773651;891819
01.12.12;WA86;Schienenfahrzeuge;249145;155427;93718
01.12.12;WA87;Kraftfahrzeuge, Landfahrzeuge;11689983;4666766;7023217
01.12.12;WA88;Luftfahrzeuge, Raumfahrzeuge;3131792;1021835;2109957
01.12.12;WA89;Wasserfahrzeuge;172044;598440;-426396
01.12.12;WA90;Optische, photografische usw. Erzeugnisse;3914698;2085801;1828897
01.12.12;WA91;Uhrmacherwaren;141867;167420;-25553
01.12.12;WA92;Musikinstrumente;44591;42900;1691
01.12.12;WA93;Waffen und Munition;33753;14158;19595
01.12.12;WA94;Möbel, Beleuchtungskörper usw.;926195;981545;-55350
01.12.12;WA95;Spielzeug, Spiele usw., Sportgeräte;370174;466055;-95881
01.12.12;WA96;Verschiedene Waren;243666;166394;77272
01.12.12;WA97;Kunstgegenstände, Sammlungsstücke;47798;32580;15218
01.12.12;WA98;Vollständige Fabrikationsanlagen;204137;1626;202511
01.12.12;WA99;Zusammenstellungen verschiedener Waren;1488361;786388;701973
01.12.13;WA01;Lebende Tiere;135318;164626;-29308
01.12.13;WA02;Fleisch;617563;546789;70774
01.12.13;WA03;Fische, Krebs- und Weichtiere;107831;293779;-185948
01.12.13;WA04;Milch, Milcherzeugnisse, Eier, Honig;743659;624072;119587
01.12.13;WA05;Andere Waren tierischen Ursprungs;62582;79012;-16430
01.12.13;WA06;Pflanzen, Waren des Blumenhandels;54221;191703;-137482
01.12.13;WA07;Gemüse, Pflanzen für Ernährung;81767;489096;-407329
01.12.13;WA08;Geniessbare Früchte und Nüsse;128406;707004;-578598
01.12.13;WA09;Kaffee, Tee, Mate, Gewürze;150974;234117;-83143
01.12.13;WA10;Getreide;269627;235164;34463
01.12.13;WA11;Müllereierzeugnisse, Malz usw.;94912;37134;57778
01.12.13;WA12;Ölsamen usw., Heilpflanzen usw.;89620;421325;-331705
01.12.13;WA13;Schellack, Gummen, Harz, Pflanzensaft;34219;28923;5296
01.12.13;WA14;Flechtstoffe usw. pflanzlichen Ursprungs;557;2661;-2104
01.12.13;WA15;Tierische und pflanzliche Fette, Öle, Wachs;182329;289080;-106751
01.12.13;WA16;Zubereitungen von Fleisch, Fisch usw.;223667;209713;13954
01.12.13;WA17;Zucker und Zuckerwaren;149915;112373;37542
01.12.13;WA18;Kakao und Zubereitungen aus Kakao;341976;255354;86622
01.12.13;WA19;Zubereitungen aus Getreide usw., Backwaren;391926;257786;134140
01.12.13;WA20;Zubereitungen von Gemüse, Früchten usw.;192922;377834;-184912
01.12.13;WA21;Verschiedene Lebensmittelzubereitungen;340532;192797;147735
01.12.13;WA22;Getränke, alkoholhaltige Flüssigkeiten, Essig;389571;542109;-152538
01.12.13;WA23;Rückstände der Lebensmittelindustrie, Futter;304892;344406;-39514
01.12.13;WA24;Tabak;255602;134609;120993
01.12.13;WA25;Salz, Schwefel, Steine, Erden usw.;133885;124171;9714
01.12.13;WA26;Erze, Schlacken, Aschen;24254;549611;-525357
01.12.13;WA27;Mineralische Brennstoffe usw.;2430527;10344681;-7914154
01.12.13;WA28;Anorganische chemische Erzeugnisse;568036;431543;136493
01.12.13;WA29;Organische chemische Erzeugnisse;1857134;1711051;146083
01.12.13;WA30;Pharmazeutische Erzeugnisse;4174576;2501055;1673521
01.12.13;WA31;Düngemittel;149225;115907;33318
01.12.13;WA32;Gerb- und Farbstoffe, Farben, Lacke usw.;655403;414333;241070
01.12.13;WA33;Etherische Öle, Riech-, Schönheitsmittel;611924;422621;189303
01.12.13;WA34;Seifen, Waschmittel usw.;428747;248406;180341
01.12.13;WA35;Eiweissstoffe, Klebstoffe, Enzyme;199857;133460;66397
01.12.13;WA36;Sprengstoffe, pyrotechnische Artikel usw.;27128;26394;734
01.12.13;WA37;Photochemische Erzeugnisse;71685;63713;7972
01.12.13;WA38;Verschiedene Erzeugnisse der Chemischen Industrie;1296464;868034;428430
01.12.13;WA39;Kunststoffe und Waren daraus;3351614;2257520;1094094
01.12.13;WA40;Kautschuk und Waren daraus;883148;796967;86181
01.12.13;WA41;Häute, Felle, Leder;79661;76733;2928
01.12.13;WA42;Lederwaren, Sattlerwaren;118738;261138;-142400
01.12.13;WA43;Pelzfelle, künstliches Pelzwerk;11082;12879;-1797
01.12.13;WA44;Holz, Holzwaren, Holzkohle;442515;445969;-3454
01.12.13;WA45;Kork, Korkwaren;1505;8546;-7041
01.12.13;WA46;Flechtwaren, Korbmacherwaren;2409;8066;-5657
01.12.13;WA47;Halbstoffe aus Holz usw., Papierabfall;79640;299899;-220259
01.12.13;WA48;Papier, Pappe und Waren daraus;1173194;830549;342645
01.12.13;WA49;Bücher, Zeitungen, Bilddrucke usw.;356835;161162;195673
01.12.13;WA50;Seide;3634;4961;-1327
01.12.13;WA51;Wolle, feine und grobe Tierhaare;27494;44699;-17205
01.12.13;WA52;Baumwolle;77761;78475;-714
01.12.13;WA53;Andere pflanzliche Spinnstoffe, Papiergarn;3749;5481;-1732
01.12.13;WA54;Synthetisches oder künstliches Filament;113968;84269;29699
01.12.13;WA55;Synthetische oder künstliche Spinnfaser;135292;98570;36722
01.12.13;WA56;Watte, Filz, Vliesstoff usw., Tauwerk;139995;72587;67408
01.12.13;WA57;Teppiche, Fussbodenbelag aus Spinnstoff;35551;76176;-40625
01.12.13;WA58;Spezialgewebe, Spitzen, Tapisserien;28699;18565;10134
01.12.13;WA59;Getränkte, bestrichene usw. Gewebe;136716;76901;59815
01.12.13;WA60;Gewirke und Gestricke;48342;25268;23074
01.12.13;WA61;Bekleidung usw. aus Gewirken, Gestricken;405388;945125;-539737
01.12.13;WA62;Andere Bekleidung, Bekleidungszubehör;397108;911860;-514752
01.12.13;WA63;Andere Konfektion, Spinnstoffwaren usw.;165612;230474;-64862
01.12.13;WA64;Schuhe, Gamaschen, ähnliche Waren;224366;515974;-291608
01.12.13;WA65;Kopfbedeckungen und Teile davon;20001;32408;-12407
01.12.13;WA66;Schirme, Gehstöcke usw., Peitschen;6367;9422;-3055
01.12.13;WA67;Zugerichtete Federn, Daunen, künstliche Blumen;6095;12699;-6604
01.12.13;WA68;Waren aus Steinen, Gips, Zement usw.;254836;168806;86030
01.12.13;WA69;Keramische Waren;227723;161293;66430
01.12.13;WA70;Glas und Glaswaren;365680;277256;88424
01.12.13;WA71;Perlen, Edelsteine, Edelmetalle;1032054;1093838;-61784
01.12.13;WA72;Eisen und Stahl;1423740;1383124;40616
01.12.13;WA73;Waren aus Eisen oder Stahl;1736182;1212054;524128
01.12.13;WA74;Kupfer und Waren daraus;672074;684984;-12910
01.12.13;WA75;Nickel und Waren daraus;70086;87029;-16943
01.12.13;WA76;Aluminium und Waren daraus;809094;826436;-17342
01.12.13;WA78;Blei und Waren daraus;26187;18067;8120
01.12.13;WA79;Zink und Waren daraus;37709;69144;-31435
01.12.13;WA80;Zinn und Waren daraus;7432;23524;-16092
01.12.13;WA81;Andere unedle Metalle, Cermets usw.;89980;102487;-12507
01.12.13;WA82;Werkzeuge, Schneidwaren, Essbestecke;493159;289673;203486
01.12.13;WA83;Verschiedene Waren aus unedlen Metallen;418326;256277;162049
01.12.13;WA84;Maschinen, Apparate, mechanische Geräte;15494580;8314668;7179912
01.12.13;WA85;Elektrotechnische Erzeugnisse;7892984;7224624;668360
01.12.13;WA86;Schienenfahrzeuge;300395;301598;-1203
01.12.13;WA87;Kraftfahrzeuge, Landfahrzeuge;12623030;5497310;7125720
01.12.13;WA88;Luftfahrzeuge, Raumfahrzeuge;3168489;1456999;1711490
01.12.13;WA89;Wasserfahrzeuge;249452;32752;216700
01.12.13;WA90;Optische, photografische usw. Erzeugnisse;4129662;2188121;1941541
01.12.13;WA91;Uhrmacherwaren;150634;162469;-11835
01.12.13;WA92;Musikinstrumente;47601;46167;1434
01.12.13;WA93;Waffen und Munition;35575;12052;23523
01.12.13;WA94;Möbel, Beleuchtungskörper usw.;985800;1142069;-156269
01.12.13;WA95;Spielzeug, Spiele usw., Sportgeräte;311960;505600;-193640
01.12.13;WA96;Verschiedene Waren;254086;168718;85368
01.12.13;WA97;Kunstgegenstände, Sammlungsstücke;52963;30376;22587
01.12.13;WA98;Vollständige Fabrikationsanlagen;207676;1626;206050
01.12.13;WA99;Zusammenstellungen verschiedener Waren;1358982;699351;659631
01.12.14;WA01;Lebende Tiere;125192;139348;-14156
01.12.14;WA02;Fleisch;613631;543835;69796
01.12.14;WA03;Fische, Krebs- und Weichtiere;141982;357845;-215863
01.12.14;WA04;Milch, Milcherzeugnisse, Eier, Honig;679326;626822;52504
01.12.14;WA05;Andere Waren tierischen Ursprungs;58199;68623;-10424
01.12.14;WA06;Pflanzen, Waren des Blumenhandels;51847;185412;-133565
01.12.14;WA07;Gemüse, Pflanzen für Ernährung;68768;444297;-375529
01.12.14;WA08;Geniessbare Früchte und Nüsse;132360;690751;-558391
01.12.14;WA09;Kaffee, Tee, Mate, Gewürze;211595;355828;-144233
01.12.14;WA10;Getreide;216745;216730;15
01.12.14;WA11;Müllereierzeugnisse, Malz usw.;104630;37982;66648
01.12.14;WA12;Ölsamen usw., Heilpflanzen usw.;78004;419140;-341136
01.12.14;WA13;Schellack, Gummen, Harz, Pflanzensaft;41341;40275;1066
01.12.14;WA14;Flechtstoffe usw. pflanzlichen Ursprungs;397;2002;-1605
01.12.14;WA15;Tierische und pflanzliche Fette, Öle, Wachs;187425;278741;-91316
01.12.14;WA16;Zubereitungen von Fleisch, Fisch usw.;240360;202808;37552
01.12.14;WA17;Zucker und Zuckerwaren;176441;106004;70437
01.12.14;WA18;Kakao und Zubereitungen aus Kakao;386438;319362;67076
01.12.14;WA19;Zubereitungen aus Getreide usw., Backwaren;406466;267949;138517
01.12.14;WA20;Zubereitungen von Gemüse, Früchten usw.;185883;370708;-184825
01.12.14;WA21;Verschiedene Lebensmittelzubereitungen;348139;215350;132789
01.12.14;WA22;Getränke, alkoholhaltige Flüssigkeiten, Essig;418846;535169;-116323
01.12.14;WA23;Rückstände der Lebensmittelindustrie, Futter;346907;310775;36132
01.12.14;WA24;Tabak;286275;148674;137601
01.12.14;WA25;Salz, Schwefel, Steine, Erden usw.;144265;142229;2036
01.12.14;WA26;Erze, Schlacken, Aschen;25829;521354;-495525
01.12.14;WA27;Mineralische Brennstoffe usw.;2166544;8667059;-6500515
01.12.14;WA28;Anorganische chemische Erzeugnisse;609930;443118;166812
01.12.14;WA29;Organische chemische Erzeugnisse;1976467;1670043;306424
01.12.14;WA30;Pharmazeutische Erzeugnisse;4888005;2838504;2049501
01.12.14;WA31;Düngemittel;165441;104630;60811
01.12.14;WA32;Gerb- und Farbstoffe, Farben, Lacke usw.;670853;409430;261423
01.12.14;WA33;Etherische Öle, Riech-, Schönheitsmittel;631791;445777;186014
01.12.14;WA34;Seifen, Waschmittel usw.;462538;284228;178310
01.12.14;WA35;Eiweissstoffe, Klebstoffe, Enzyme;222978;148237;74741
01.12.14;WA36;Sprengstoffe, pyrotechnische Artikel usw.;25556;27882;-2326
01.12.14;WA37;Photochemische Erzeugnisse;89396;60528;28868
01.12.14;WA38;Verschiedene Erzeugnisse der Chemischen Industrie;1454919;932013;522906
01.12.14;WA39;Kunststoffe und Waren daraus;3581960;2341626;1240334
01.12.14;WA40;Kautschuk und Waren daraus;902384;744583;157801
01.12.14;WA41;Häute, Felle, Leder;74689;68720;5969
01.12.14;WA42;Lederwaren, Sattlerwaren;135332;297146;-161814
01.12.14;WA43;Pelzfelle, künstliches Pelzwerk;17348;15576;1772
01.12.14;WA44;Holz, Holzwaren, Holzkohle;451811;458024;-6213
01.12.14;WA45;Kork, Korkwaren;1567;4209;-2642
01.12.14;WA46;Flechtwaren, Korbmacherwaren;3073;9707;-6634
01.12.14;WA47;Halbstoffe aus Holz usw., Papierabfall;93870;286239;-192369
01.12.14;WA48;Papier, Pappe und Waren daraus;1279826;935012;344814
01.12.14;WA49;Bücher, Zeitungen, Bilddrucke usw.;383281;234083;149198
01.12.14;WA50;Seide;4512;5390;-878
01.12.14;WA51;Wolle, feine und grobe Tierhaare;36801;42497;-5696
01.12.14;WA52;Baumwolle;67308;68214;-906
01.12.14;WA53;Andere pflanzliche Spinnstoffe, Papiergarn;3869;5722;-1853
01.12.14;WA54;Synthetisches oder künstliches Filament;128560;85688;42872
01.12.14;WA55;Synthetische oder künstliche Spinnfaser;151123;104337;46786
01.12.14;WA56;Watte, Filz, Vliesstoff usw., Tauwerk;160113;79655;80458
01.12.14;WA57;Teppiche, Fussbodenbelag aus Spinnstoff;41456;82969;-41513
01.12.14;WA58;Spezialgewebe, Spitzen, Tapisserien;30061;17514;12547
01.12.14;WA59;Getränkte, bestrichene usw. Gewebe;139772;65575;74197
01.12.14;WA60;Gewirke und Gestricke;51115;27248;23867
01.12.14;WA61;Bekleidung usw. aus Gewirken, Gestricken;472625;1059338;-586713
01.12.14;WA62;Andere Bekleidung, Bekleidungszubehör;461763;1063011;-601248
01.12.14;WA63;Andere Konfektion, Spinnstoffwaren usw.;176165;259409;-83244
01.12.14;WA64;Schuhe, Gamaschen, ähnliche Waren;248554;604679;-356125
01.12.14;WA65;Kopfbedeckungen und Teile davon;20107;31659;-11552
01.12.14;WA66;Schirme, Gehstöcke usw., Peitschen;5326;14924;-9598
01.12.14;WA67;Zugerichtete Federn, Daunen, künstliche Blumen;6503;14037;-7534
01.12.14;WA68;Waren aus Steinen, Gips, Zement usw.;249011;191040;57971
01.12.14;WA69;Keramische Waren;212422;185501;26921
01.12.14;WA70;Glas und Glaswaren;390341;304993;85348
01.12.14;WA71;Perlen, Edelsteine, Edelmetalle;892085;1189358;-297273
01.12.14;WA72;Eisen und Stahl;1495531;1503364;-7833
01.12.14;WA73;Waren aus Eisen oder Stahl;1860086;1234418;625668
01.12.14;WA74;Kupfer und Waren daraus;640041;587069;52972
01.12.14;WA75;Nickel und Waren daraus;85123;96212;-11089
01.12.14;WA76;Aluminium und Waren daraus;930742;985864;-55122
01.12.14;WA78;Blei und Waren daraus;34043;21284;12759
01.12.14;WA79;Zink und Waren daraus;38391;82701;-44310
01.12.14;WA80;Zinn und Waren daraus;8968;25517;-16549
01.12.14;WA81;Andere unedle Metalle, Cermets usw.;108516;110746;-2230
01.12.14;WA82;Werkzeuge, Schneidwaren, Essbestecke;563950;363680;200270
01.12.14;WA83;Verschiedene Waren aus unedlen Metallen;435063;277483;157580
01.12.14;WA84;Maschinen, Apparate, mechanische Geräte;16439127;9239891;7199236
01.12.14;WA85;Elektrotechnische Erzeugnisse;9048600;8211377;837223
01.12.14;WA86;Schienenfahrzeuge;316017;227037;88980
01.12.14;WA87;Kraftfahrzeuge, Landfahrzeuge;14436701;6115046;8321655
01.12.14;WA88;Luftfahrzeuge, Raumfahrzeuge;3737867;1286217;2451650
01.12.14;WA89;Wasserfahrzeuge;337220;165607;171613
01.12.14;WA90;Optische, photografische usw. Erzeugnisse;4475518;2472835;2002683
01.12.14;WA91;Uhrmacherwaren;170764;175621;-4857
01.12.14;WA92;Musikinstrumente;50597;47413;3184
01.12.14;WA93;Waffen und Munition;36427;9181;27246
01.12.14;WA94;Möbel, Beleuchtungskörper usw.;1090244;1252978;-162734
01.12.14;WA95;Spielzeug, Spiele usw., Sportgeräte;317547;525970;-208423
01.12.14;WA96;Verschiedene Waren;262402;194668;67734
01.12.14;WA97;Kunstgegenstände, Sammlungsstücke;54406;54931;-525
01.12.14;WA98;Vollständige Fabrikationsanlagen;245692;8106;237586
01.12.14;WA99;Zusammenstellungen verschiedener Waren;1923804;861344;1062460
01.12.15;WA01;Lebende Tiere;124900;132502;-7602
01.12.15;WA02;Fleisch;587065;534994;52071
01.12.15;WA03;Fische, Krebs- und Weichtiere;136240;332787;-196547
01.12.15;WA04;Milch, Milcherzeugnisse, Eier, Honig;652667;607652;45015
01.12.15;WA05;Andere Waren tierischen Ursprungs;54602;64420;-9818
01.12.15;WA06;Pflanzen, Waren des Blumenhandels;54515;202517;-148002
01.12.15;WA07;Gemüse, Pflanzen für Ernährung;70963;472282;-401319
01.12.15;WA08;Geniessbare Früchte und Nüsse;159309;753353;-594044
01.12.15;WA09;Kaffee, Tee, Mate, Gewürze;195879;300642;-104763
01.12.15;WA10;Getreide;200642;217531;-16889
01.12.15;WA11;Müllereierzeugnisse, Malz usw.;121074;42859;78215
01.12.15;WA12;Ölsamen usw., Heilpflanzen usw.;82490;464704;-382214
01.12.15;WA13;Schellack, Gummen, Harz, Pflanzensaft;46396;31891;14505
01.12.15;WA14;Flechtstoffe usw. pflanzlichen Ursprungs;457;3175;-2718
01.12.15;WA15;Tierische und pflanzliche Fette, Öle, Wachs;207307;285181;-77874
01.12.15;WA16;Zubereitungen von Fleisch, Fisch usw.;233244;203367;29877
01.12.15;WA17;Zucker und Zuckerwaren;155696;124759;30937
01.12.15;WA18;Kakao und Zubereitungen aus Kakao;491286;422582;68704
01.12.15;WA19;Zubereitungen aus Getreide usw., Backwaren;477123;335178;141945
01.12.15;WA20;Zubereitungen von Gemüse, Früchten usw.;219907;402833;-182926
01.12.15;WA21;Verschiedene Lebensmittelzubereitungen;377073;231421;145652
01.12.15;WA22;Getränke, alkoholhaltige Flüssigkeiten, Essig;423457;558192;-134735
01.12.15;WA23;Rückstände der Lebensmittelindustrie, Futter;354708;348827;5881
01.12.15;WA24;Tabak;281087;151114;129973
01.12.15;WA25;Salz, Schwefel, Steine, Erden usw.;132627;131957;670
01.12.15;WA26;Erze, Schlacken, Aschen;32348;528584;-496236
01.12.15;WA27;Mineralische Brennstoffe usw.;2054788;6625951;-4571163
01.12.15;WA28;Anorganische chemische Erzeugnisse;614645;444946;169699
01.12.15;WA29;Organische chemische Erzeugnisse;1811554;2253902;-442348
01.12.15;WA30;Pharmazeutische Erzeugnisse;5352280;3276954;2075326
01.12.15;WA31;Düngemittel;182425;110087;72338
01.12.15;WA32;Gerb- und Farbstoffe, Farben, Lacke usw.;723358;402697;320661
01.12.15;WA33;Etherische Öle, Riech-, Schönheitsmittel;703850;538915;164935
01.12.15;WA34;Seifen, Waschmittel usw.;497539;291524;206015
01.12.15;WA35;Eiweissstoffe, Klebstoffe, Enzyme;226640;145277;81363
01.12.15;WA36;Sprengstoffe, pyrotechnische Artikel usw.;23578;26035;-2457
01.12.15;WA37;Photochemische Erzeugnisse;94643;63308;31335
01.12.15;WA38;Verschiedene Erzeugnisse der Chemischen Industrie;1556465;990704;565761
01.12.15;WA39;Kunststoffe und Waren daraus;3708595;2518579;1190016
01.12.15;WA40;Kautschuk und Waren daraus;941690;783037;158653
01.12.15;WA41;Häute, Felle, Leder;72379;48933;23446
01.12.15;WA42;Lederwaren, Sattlerwaren;149346;329233;-179887
01.12.15;WA43;Pelzfelle, künstliches Pelzwerk;10969;9478;1491
01.12.15;WA44;Holz, Holzwaren, Holzkohle;485732;479601;6131
01.12.15;WA45;Kork, Korkwaren;1849;7231;-5382
01.12.15;WA46;Flechtwaren, Korbmacherwaren;3313;10140;-6827
01.12.15;WA47;Halbstoffe aus Holz usw., Papierabfall;97838;324338;-226500
01.12.15;WA48;Papier, Pappe und Waren daraus;1317202;873777;443425
01.12.15;WA49;Bücher, Zeitungen, Bilddrucke usw.;387061;238836;148225
01.12.15;WA50;Seide;4789;3297;1492
01.12.15;WA51;Wolle, feine und grobe Tierhaare;43927;36200;7727
01.12.15;WA52;Baumwolle;72531;67990;4541
01.12.15;WA53;Andere pflanzliche Spinnstoffe, Papiergarn;4099;6165;-2066
01.12.15;WA54;Synthetisches oder künstliches Filament;133608;93046;40562
01.12.15;WA55;Synthetische oder künstliche Spinnfaser;141888;102336;39552
01.12.15;WA56;Watte, Filz, Vliesstoff usw., Tauwerk;163412;87952;75460
01.12.15;WA57;Teppiche, Fussbodenbelag aus Spinnstoff;38659;90843;-52184
01.12.15;WA58;Spezialgewebe, Spitzen, Tapisserien;32827;18846;13981
01.12.15;WA59;Getränkte, bestrichene usw. Gewebe;156914;76942;79972
01.12.15;WA60;Gewirke und Gestricke;55197;31283;23914
01.12.15;WA61;Bekleidung usw. aus Gewirken, Gestricken;512617;1164032;-651415
01.12.15;WA62;Andere Bekleidung, Bekleidungszubehör;506985;1142623;-635638
01.12.15;WA63;Andere Konfektion, Spinnstoffwaren usw.;196491;284663;-88172
01.12.15;WA64;Schuhe, Gamaschen, ähnliche Waren;290426;676056;-385630
01.12.15;WA65;Kopfbedeckungen und Teile davon;21547;39053;-17506
01.12.15;WA66;Schirme, Gehstöcke usw., Peitschen;5143;16243;-11100
01.12.15;WA67;Zugerichtete Federn, Daunen, künstliche Blumen;6903;18741;-11838
01.12.15;WA68;Waren aus Steinen, Gips, Zement usw.;282375;199132;83243
01.12.15;WA69;Keramische Waren;236823;193833;42990
01.12.15;WA70;Glas und Glaswaren;404194;323793;80401
01.12.15;WA71;Perlen, Edelsteine, Edelmetalle;732520;990162;-257642
01.12.15;WA72;Eisen und Stahl;1235250;1276575;-41325
01.12.15;WA73;Waren aus Eisen oder Stahl;1901518;1458206;443312
01.12.15;WA74;Kupfer und Waren daraus;553852;565929;-12077
01.12.15;WA75;Nickel und Waren daraus;59917;74673;-14756
01.12.15;WA76;Aluminium und Waren daraus;909629;1004410;-94781
01.12.15;WA78;Blei und Waren daraus;22123;27509;-5386
01.12.15;WA79;Zink und Waren daraus;38839;75526;-36687
01.12.15;WA80;Zinn und Waren daraus;5996;23107;-17111
01.12.15;WA81;Andere unedle Metalle, Cermets usw.;102479;109576;-7097
01.12.15;WA82;Werkzeuge, Schneidwaren, Essbestecke;558112;361979;196133
01.12.15;WA83;Verschiedene Waren aus unedlen Metallen;473287;307322;165965
01.12.15;WA84;Maschinen, Apparate, mechanische Geräte;16711214;9796244;6914970
01.12.15;WA85;Elektrotechnische Erzeugnisse;9338229;8837544;500685
01.12.15;WA86;Schienenfahrzeuge;218876;202945;15931
01.12.15;WA87;Kraftfahrzeuge, Landfahrzeuge;15357378;6880202;8477176
01.12.15;WA88;Luftfahrzeuge, Raumfahrzeuge;3789130;1624087;2165043
01.12.15;WA89;Wasserfahrzeuge;258909;34705;224204
01.12.15;WA90;Optische, photografische usw. Erzeugnisse;4847736;2704191;2143545
01.12.15;WA91;Uhrmacherwaren;181386;194472;-13086
01.12.15;WA92;Musikinstrumente;51781;54755;-2974
01.12.15;WA93;Waffen und Munition;40668;17183;23485
01.12.15;WA94;Möbel, Beleuchtungskörper usw.;1121267;1350901;-229634
01.12.15;WA95;Spielzeug, Spiele usw., Sportgeräte;378859;533865;-155006
01.12.15;WA96;Verschiedene Waren;295779;208732;87047
01.12.15;WA97;Kunstgegenstände, Sammlungsstücke;192060;78186;113874
01.12.15;WA98;Vollständige Fabrikationsanlagen;235666;2184;233482
01.12.15;WA99;Zusammenstellungen verschiedener Waren;1806418;1109661;696757
01.12.16;WA01;Lebende Tiere;106216;190704;-84488
01.12.16;WA02;Fleisch;676556;584966;91590
01.12.16;WA03;Fische, Krebs- und Weichtiere;165195;386278;-221083
01.12.16;WA04;Milch, Milcherzeugnisse, Eier, Honig;674910;671108;3802
01.12.16;WA05;Andere Waren tierischen Ursprungs;63285;76249;-12964
01.12.16;WA06;Pflanzen, Waren des Blumenhandels;59159;220669;-161510
01.12.16;WA07;Gemüse, Pflanzen für Ernährung;88910;530334;-441424
01.12.16;WA08;Geniessbare Früchte und Nüsse;165300;787788;-622488
01.12.16;WA09;Kaffee, Tee, Mate, Gewürze;233374;394275;-160901
01.12.16;WA10;Getreide;216864;209421;7443
01.12.16;WA11;Müllereierzeugnisse, Malz usw.;115022;43264;71758
01.12.16;WA12;Ölsamen usw., Heilpflanzen usw.;98526;413268;-314742
01.12.16;WA13;Schellack, Gummen, Harz, Pflanzensaft;49238;41165;8073
01.12.16;WA14;Flechtstoffe usw. pflanzlichen Ursprungs;378;2768;-2390
01.12.16;WA15;Tierische und pflanzliche Fette, Öle, Wachs;229117;303489;-74372
01.12.16;WA16;Zubereitungen von Fleisch, Fisch usw.;229931;224466;5465
01.12.16;WA17;Zucker und Zuckerwaren;160117;120544;39573
01.12.16;WA18;Kakao und Zubereitungen aus Kakao;403868;367234;36634
01.12.16;WA19;Zubereitungen aus Getreide usw., Backwaren;472959;336040;136919
01.12.16;WA20;Zubereitungen von Gemüse, Früchten usw.;224290;396016;-171726
01.12.16;WA21;Verschiedene Lebensmittelzubereitungen;412470;249016;163454
01.12.16;WA22;Getränke, alkoholhaltige Flüssigkeiten, Essig;446142;606390;-160248
01.12.16;WA23;Rückstände der Lebensmittelindustrie, Futter;339719;340278;-559
01.12.16;WA24;Tabak;297832;148744;149088
01.12.16;WA25;Salz, Schwefel, Steine, Erden usw.;139140;134888;4252
01.12.16;WA26;Erze, Schlacken, Aschen;39839;491197;-451358
01.12.16;WA27;Mineralische Brennstoffe usw.;2014574;6870430;-4855856
01.12.16;WA28;Anorganische chemische Erzeugnisse;640991;465267;175724
01.12.16;WA29;Organische chemische Erzeugnisse;1830672;2322624;-491952
01.12.16;WA30;Pharmazeutische Erzeugnisse;5456601;3593271;1863330
01.12.16;WA31;Düngemittel;163000;102998;60002
01.12.16;WA32;Gerb- und Farbstoffe, Farben, Lacke usw.;759491;427923;331568
01.12.16;WA33;Etherische Öle, Riech-, Schönheitsmittel;701638;568994;132644
01.12.16;WA34;Seifen, Waschmittel usw.;528864;321495;207369
01.12.16;WA35;Eiweissstoffe, Klebstoffe, Enzyme;240013;148488;91525
01.12.16;WA36;Sprengstoffe, pyrotechnische Artikel usw.;24724;19567;5157
01.12.16;WA37;Photochemische Erzeugnisse;105043;65813;39230
01.12.16;WA38;Verschiedene Erzeugnisse der Chemischen Industrie;1666274;1018126;648148
01.12.16;WA39;Kunststoffe und Waren daraus;3899600;2641748;1257852
01.12.16;WA40;Kautschuk und Waren daraus;992287;855999;136288
01.12.16;WA41;Häute, Felle, Leder;69264;58772;10492
01.12.16;WA42;Lederwaren, Sattlerwaren;168801;342795;-173994
01.12.16;WA43;Pelzfelle, künstliches Pelzwerk;8974;10093;-1119
01.12.16;WA44;Holz, Holzwaren, Holzkohle;529245;526031;3214
01.12.16;WA45;Kork, Korkwaren;2086;6257;-4171
01.12.16;WA46;Flechtwaren, Korbmacherwaren;2542;11219;-8677
01.12.16;WA47;Halbstoffe aus Holz usw., Papierabfall;94813;301778;-206965
01.12.16;WA48;Papier, Pappe und Waren daraus;1339644;936423;403221
01.12.16;WA49;Bücher, Zeitungen, Bilddrucke usw.;364076;256938;107138
01.12.16;WA50;Seide;3428;3824;-396
01.12.16;WA51;Wolle, feine und grobe Tierhaare;34898;45336;-10438
01.12.16;WA52;Baumwolle;70094;67397;2697
01.12.16;WA53;Andere pflanzliche Spinnstoffe, Papiergarn;3629;6956;-3327
01.12.16;WA54;Synthetisches oder künstliches Filament;131563;100618;30945
01.12.16;WA55;Synthetische oder künstliche Spinnfaser;131102;97404;33698
01.12.16;WA56;Watte, Filz, Vliesstoff usw., Tauwerk;160137;93528;66609
01.12.16;WA57;Teppiche, Fussbodenbelag aus Spinnstoff;40714;99905;-59191
01.12.16;WA58;Spezialgewebe, Spitzen, Tapisserien;36181;20387;15794
01.12.16;WA59;Getränkte, bestrichene usw. Gewebe;166123;84040;82083
01.12.16;WA60;Gewirke und Gestricke;57128;33493;23635
01.12.16;WA61;Bekleidung usw. aus Gewirken, Gestricken;552961;1244479;-691518
01.12.16;WA62;Andere Bekleidung, Bekleidungszubehör;524798;1179206;-654408
01.12.16;WA63;Andere Konfektion, Spinnstoffwaren usw.;189565;287898;-98333
01.12.16;WA64;Schuhe, Gamaschen, ähnliche Waren;353125;765028;-411903
01.12.16;WA65;Kopfbedeckungen und Teile davon;26819;45202;-18383
01.12.16;WA66;Schirme, Gehstöcke usw., Peitschen;5776;13023;-7247
01.12.16;WA67;Zugerichtete Federn, Daunen, künstliche Blumen;8253;19768;-11515
01.12.16;WA68;Waren aus Steinen, Gips, Zement usw.;314812;217360;97452
01.12.16;WA69;Keramische Waren;266042;198606;67436
01.12.16;WA70;Glas und Glaswaren;423110;367493;55617
01.12.16;WA71;Perlen, Edelsteine, Edelmetalle;967053;1584587;-617534
01.12.16;WA72;Eisen und Stahl;1528751;1604902;-76151
01.12.16;WA73;Waren aus Eisen oder Stahl;1822208;1394348;427860
01.12.16;WA74;Kupfer und Waren daraus;704629;665545;39084
01.12.16;WA75;Nickel und Waren daraus;72543;87032;-14489
01.12.16;WA76;Aluminium und Waren daraus;967047;1091098;-124051
01.12.16;WA78;Blei und Waren daraus;24110;32765;-8655
01.12.16;WA79;Zink und Waren daraus;50690;115654;-64964
01.12.16;WA80;Zinn und Waren daraus;9248;33865;-24617
01.12.16;WA81;Andere unedle Metalle, Cermets usw.;105174;121735;-16561
01.12.16;WA82;Werkzeuge, Schneidwaren, Essbestecke;655255;384789;270466
01.12.16;WA83;Verschiedene Waren aus unedlen Metallen;499575;327386;172189
01.12.16;WA84;Maschinen, Apparate, mechanische Geräte;17595543;10403742;7191801
01.12.16;WA85;Elektrotechnische Erzeugnisse;10060891;9853497;207394
01.12.16;WA86;Schienenfahrzeuge;314683;195560;119123
01.12.16;WA87;Kraftfahrzeuge, Landfahrzeuge;15592577;7717587;7874990
01.12.16;WA88;Luftfahrzeuge, Raumfahrzeuge;5128424;1352431;3775993
01.12.16;WA89;Wasserfahrzeuge;507149;344732;162417
01.12.16;WA90;Optische, photografische usw. Erzeugnisse;5319861;2887480;2432381
01.12.16;WA91;Uhrmacherwaren;179212;181115;-1903
01.12.16;WA92;Musikinstrumente;52071;58561;-6490
01.12.16;WA93;Waffen und Munition;39273;14923;24350
01.12.16;WA94;Möbel, Beleuchtungskörper usw.;1203121;1430658;-227537
01.12.16;WA95;Spielzeug, Spiele usw., Sportgeräte;343018;561844;-218826
01.12.16;WA96;Verschiedene Waren;306684;216305;90379
01.12.16;WA97;Kunstgegenstände, Sammlungsstücke;49357;35741;13616
01.12.16;WA98;Vollständige Fabrikationsanlagen;222125;23;222102
01.12.16;WA99;Zusammenstellungen verschiedener Waren;1583575;944173;639402
01.12.17;WA01;Lebende Tiere;131288;135370;-4082
01.12.17;WA02;Fleisch;664869;617870;46999
01.12.17;WA03;Fische, Krebs- und Weichtiere;150967;352406;-201439
01.12.17;WA04;Milch, Milcherzeugnisse, Eier, Honig;724044;787032;-62988
01.12.17;WA05;Andere Waren tierischen Ursprungs;70528;88740;-18212
01.12.17;WA06;Pflanzen, Waren des Blumenhandels;48711;201360;-152649
01.12.17;WA07;Gemüse, Pflanzen für Ernährung;81525;542991;-461466
01.12.17;WA08;Geniessbare Früchte und Nüsse;156066;876897;-720831
01.12.17;WA09;Kaffee, Tee, Mate, Gewürze;225870;295940;-70070
01.12.17;WA10;Getreide;131321;203996;-72675
01.12.17;WA11;Müllereierzeugnisse, Malz usw.;131988;47489;84499
01.12.17;WA12;Ölsamen usw., Heilpflanzen usw.;98076;320937;-222861
01.12.17;WA13;Schellack, Gummen, Harz, Pflanzensaft;45916;34860;11056
01.12.17;WA14;Flechtstoffe usw. pflanzlichen Ursprungs;407;3258;-2851
01.12.17;WA15;Tierische und pflanzliche Fette, Öle, Wachs;206623;293264;-86641
01.12.17;WA16;Zubereitungen von Fleisch, Fisch usw.;234464;252890;-18426
01.12.17;WA17;Zucker und Zuckerwaren;208086;119919;88167
01.12.17;WA18;Kakao und Zubereitungen aus Kakao;415555;369175;46380
01.12.17;WA19;Zubereitungen aus Getreide usw., Backwaren;495237;350619;144618
01.12.17;WA20;Zubereitungen von Gemüse, Früchten usw.;225255;419763;-194508
01.12.17;WA21;Verschiedene Lebensmittelzubereitungen;406271;249189;157082
01.12.17;WA22;Getränke, alkoholhaltige Flüssigkeiten, Essig;427934;607937;-180003
01.12.17;WA23;Rückstände der Lebensmittelindustrie, Futter;370560;335041;35519
01.12.17;WA24;Tabak;253385;154299;99086
01.12.17;WA25;Salz, Schwefel, Steine, Erden usw.;137508;133426;4082
01.12.17;WA26;Erze, Schlacken, Aschen;38180;557183;-519003
01.12.17;WA27;Mineralische Brennstoffe usw.;2354177;7972261;-5618084
01.12.17;WA28;Anorganische chemische Erzeugnisse;680502;454548;225954
01.12.17;WA29;Organische chemische Erzeugnisse;1972055;2806933;-834878
01.12.17;WA30;Pharmazeutische Erzeugnisse;6122065;3704327;2417738
01.12.17;WA31;Düngemittel;179288;90448;88840
01.12.17;WA32;Gerb- und Farbstoffe, Farben, Lacke usw.;806716;439228;367488
01.12.17;WA33;Etherische Öle, Riech-, Schönheitsmittel;708050;617483;90567
01.12.17;WA34;Seifen, Waschmittel usw.;525610;330457;195153
01.12.17;WA35;Eiweissstoffe, Klebstoffe, Enzyme;253271;151281;101990
01.12.17;WA36;Sprengstoffe, pyrotechnische Artikel usw.;35548;32389;3159
01.12.17;WA37;Photochemische Erzeugnisse;90855;78933;11922
01.12.17;WA38;Verschiedene Erzeugnisse der Chemischen Industrie;1688840;1063148;625692
01.12.17;WA39;Kunststoffe und Waren daraus;4095042;2857493;1237549
01.12.17;WA40;Kautschuk und Waren daraus;1020265;902742;117523
01.12.17;WA41;Häute, Felle, Leder;64526;54761;9765
01.12.17;WA42;Lederwaren, Sattlerwaren;177424;330338;-152914
01.12.17;WA43;Pelzfelle, künstliches Pelzwerk;7140;8067;-927
01.12.17;WA44;Holz, Holzwaren, Holzkohle;565493;529781;35712
01.12.17;WA45;Kork, Korkwaren;2061;7251;-5190
01.12.17;WA46;Flechtwaren, Korbmacherwaren;2599;8897;-6298
01.12.17;WA47;Halbstoffe aus Holz usw., Papierabfall;95872;324551;-228679
01.12.17;WA48;Papier, Pappe und Waren daraus;1312031;944454;367577
01.12.17;WA49;Bücher, Zeitungen, Bilddrucke usw.;376719;252647;124072
01.12.17;WA50;Seide;2982;3787;-805
01.12.17;WA51;Wolle, feine und grobe Tierhaare;36138;57107;-20969
01.12.17;WA52;Baumwolle;62760;65580;-2820
01.12.17;WA53;Andere pflanzliche Spinnstoffe, Papiergarn;3600;5613;-2013
01.12.17;WA54;Synthetisches oder künstliches Filament;125021;101060;23961
01.12.17;WA55;Synthetische oder künstliche Spinnfaser;131115;100948;30167
01.12.17;WA56;Watte, Filz, Vliesstoff usw., Tauwerk;161204;96789;64415
01.12.17;WA57;Teppiche, Fussbodenbelag aus Spinnstoff;38088;96270;-58182
01.12.17;WA58;Spezialgewebe, Spitzen, Tapisserien;36423;18461;17962
01.12.17;WA59;Getränkte, bestrichene usw. Gewebe;174399;78810;95589
01.12.17;WA60;Gewirke und Gestricke;52439;33289;19150
01.12.17;WA61;Bekleidung usw. aus Gewirken, Gestricken;672781;1290961;-618180
01.12.17;WA62;Andere Bekleidung, Bekleidungszubehör;634109;1137549;-503440
01.12.17;WA63;Andere Konfektion, Spinnstoffwaren usw.;189068;277552;-88484
01.12.17;WA64;Schuhe, Gamaschen, ähnliche Waren;439014;830285;-391271
01.12.17;WA65;Kopfbedeckungen und Teile davon;35935;45474;-9539
01.12.17;WA66;Schirme, Gehstöcke usw., Peitschen;5583;14138;-8555
01.12.17;WA67;Zugerichtete Federn, Daunen, künstliche Blumen;7844;19604;-11760
01.12.17;WA68;Waren aus Steinen, Gips, Zement usw.;322387;228035;94352
01.12.17;WA69;Keramische Waren;253598;197461;56137
01.12.17;WA70;Glas und Glaswaren;430129;362863;67266
01.12.17;WA71;Perlen, Edelsteine, Edelmetalle;945517;1515480;-569963
01.12.17;WA72;Eisen und Stahl;1685079;1875546;-190467
01.12.17;WA73;Waren aus Eisen oder Stahl;2069350;1480124;589226
01.12.17;WA74;Kupfer und Waren daraus;690174;610551;79623
01.12.17;WA75;Nickel und Waren daraus;90743;100956;-10213
01.12.17;WA76;Aluminium und Waren daraus;1122598;1102673;19925
01.12.17;WA78;Blei und Waren daraus;38758;44517;-5759
01.12.17;WA79;Zink und Waren daraus;53071;119143;-66072
01.12.17;WA80;Zinn und Waren daraus;8193;27675;-19482
01.12.17;WA81;Andere unedle Metalle, Cermets usw.;99599;145287;-45688
01.12.17;WA82;Werkzeuge, Schneidwaren, Essbestecke;651655;404570;247085
01.12.17;WA83;Verschiedene Waren aus unedlen Metallen;492184;328997;163187
01.12.17;WA84;Maschinen, Apparate, mechanische Geräte;18739309;10746169;7993140
01.12.17;WA85;Elektrotechnische Erzeugnisse;10436656;10583296;-146640
01.12.17;WA86;Schienenfahrzeuge;322394;232940;89454
01.12.17;WA87;Kraftfahrzeuge, Landfahrzeuge;16427021;8003406;8423615
01.12.17;WA88;Luftfahrzeuge, Raumfahrzeuge;3834984;841280;2993704
01.12.17;WA89;Wasserfahrzeuge;490628;123382;367246
01.12.17;WA90;Optische, photografische usw. Erzeugnisse;5595287;2957435;2637852
01.12.17;WA91;Uhrmacherwaren;151789;160103;-8314
01.12.17;WA92;Musikinstrumente;60170;58567;1603
01.12.17;WA93;Waffen und Munition;35288;14929;20359
01.12.17;WA94;Möbel, Beleuchtungskörper usw.;1155105;1388007;-232902
01.12.17;WA95;Spielzeug, Spiele usw., Sportgeräte;439710;635223;-195513
01.12.17;WA96;Verschiedene Waren;306222;207579;98643
01.12.17;WA97;Kunstgegenstände, Sammlungsstücke;56260;31465;24795
01.12.17;WA98;Vollständige Fabrikationsanlagen;113789;10495;103294
01.12.17;WA99;Zusammenstellungen verschiedener Waren;1391699;983943;407756
01.12.18;WA01;Lebende Tiere;123649;134001;-10352
01.12.18;WA02;Fleisch;585061;565723;19338
01.12.18;WA03;Fische, Krebs- und Weichtiere;136167;326762;-190595
01.12.18;WA04;Milch, Milcherzeugnisse, Eier, Honig;691827;662105;29722
01.12.18;WA05;Andere Waren tierischen Ursprungs;65848;72434;-6586
01.12.18;WA06;Pflanzen, Waren des Blumenhandels;54321;184258;-129937
01.12.18;WA07;Gemüse, Pflanzen für Ernährung;82099;519971;-437872
01.12.18;WA08;Geniessbare Früchte und Nüsse;145961;731486;-585525
01.12.18;WA09;Kaffee, Tee, Mate, Gewürze;202657;286696;-84039
01.12.18;WA10;Getreide;133572;270411;-136839
01.12.18;WA11;Müllereierzeugnisse, Malz usw.;116675;52273;64402
01.12.18;WA12;Ölsamen usw., Heilpflanzen usw.;107545;389156;-281611
01.12.18;WA13;Schellack, Gummen, Harz, Pflanzensaft;43227;50257;-7030
01.12.18;WA14;Flechtstoffe usw. pflanzlichen Ursprungs;573;3177;-2604
01.12.18;WA15;Tierische und pflanzliche Fette, Öle, Wachs;184171;278602;-94431
01.12.18;WA16;Zubereitungen von Fleisch, Fisch usw.;250282;246205;4077
01.12.18;WA17;Zucker und Zuckerwaren;172042;118002;54040
01.12.18;WA18;Kakao und Zubereitungen aus Kakao;384842;354543;30299
01.12.18;WA19;Zubereitungen aus Getreide usw., Backwaren;467604;330844;136760
01.12.18;WA20;Zubereitungen von Gemüse, Früchten usw.;222049;376764;-154715
01.12.18;WA21;Verschiedene Lebensmittelzubereitungen;403919;252499;151420
01.12.18;WA22;Getränke, alkoholhaltige Flüssigkeiten, Essig;399649;577171;-177522
01.12.18;WA23;Rückstände der Lebensmittelindustrie, Futter;333277;333449;-172
01.12.18;WA24;Tabak;212052;158296;53756
01.12.18;WA25;Salz, Schwefel, Steine, Erden usw.;132310;145149;-12839
01.12.18;WA26;Erze, Schlacken, Aschen;42454;623179;-580725
01.12.18;WA27;Mineralische Brennstoffe usw.;2322315;8486910;-6164595
01.12.18;WA28;Anorganische chemische Erzeugnisse;675285;509558;165727
01.12.18;WA29;Organische chemische Erzeugnisse;1792578;2862035;-1069457
01.12.18;WA30;Pharmazeutische Erzeugnisse;5429943;3847530;1582413
01.12.18;WA31;Düngemittel;190316;76298;114018
01.12.18;WA32;Gerb- und Farbstoffe, Farben, Lacke usw.;717894;425041;292853
01.12.18;WA33;Etherische Öle, Riech-, Schönheitsmittel;698615;550821;147794
01.12.18;WA34;Seifen, Waschmittel usw.;512183;307926;204257
01.12.18;WA35;Eiweissstoffe, Klebstoffe, Enzyme;226367;149415;76952
01.12.18;WA36;Sprengstoffe, pyrotechnische Artikel usw.;31451;26484;4967
01.12.18;WA37;Photochemische Erzeugnisse;110599;70270;40329
01.12.18;WA38;Verschiedene Erzeugnisse der Chemischen Industrie;1630606;1029388;601218
01.12.18;WA39;Kunststoffe und Waren daraus;3784829;2776126;1008703
01.12.18;WA40;Kautschuk und Waren daraus;969228;845672;123556
01.12.18;WA41;Häute, Felle, Leder;56272;46730;9542
01.12.18;WA42;Lederwaren, Sattlerwaren;177715;313665;-135950
01.12.18;WA43;Pelzfelle, künstliches Pelzwerk;7248;10185;-2937
01.12.18;WA44;Holz, Holzwaren, Holzkohle;520961;537203;-16242
01.12.18;WA45;Kork, Korkwaren;2110;8598;-6488
01.12.18;WA46;Flechtwaren, Korbmacherwaren;2764;7110;-4346
01.12.18;WA47;Halbstoffe aus Holz usw., Papierabfall;98924;339639;-240715
01.12.18;WA48;Papier, Pappe und Waren daraus;1303679;938452;365227
01.12.18;WA49;Bücher, Zeitungen, Bilddrucke usw.;364786;273310;91476
01.12.18;WA50;Seide;1426;2875;-1449
01.12.18;WA51;Wolle, feine und grobe Tierhaare;24962;35475;-10513
01.12.18;WA52;Baumwolle;53023;58699;-5676
01.12.18;WA53;Andere pflanzliche Spinnstoffe, Papiergarn;4632;5897;-1265
01.12.18;WA54;Synthetisches oder künstliches Filament;122775;93571;29204
01.12.18;WA55;Synthetische oder künstliche Spinnfaser;116128;92687;23441
01.12.18;WA56;Watte, Filz, Vliesstoff usw., Tauwerk;149480;99013;50467
01.12.18;WA57;Teppiche, Fussbodenbelag aus Spinnstoff;36684;84299;-47615
01.12.18;WA58;Spezialgewebe, Spitzen, Tapisserien;32286;16841;15445
01.12.18;WA59;Getränkte, bestrichene usw. Gewebe;158348;76126;82222
01.12.18;WA60;Gewirke und Gestricke;45702;26215;19487
01.12.18;WA61;Bekleidung usw. aus Gewirken, Gestricken;697031;1192378;-495347
01.12.18;WA62;Andere Bekleidung, Bekleidungszubehör;691679;1076773;-385094
01.12.18;WA63;Andere Konfektion, Spinnstoffwaren usw.;195870;271306;-75436
01.12.18;WA64;Schuhe, Gamaschen, ähnliche Waren;460318;742591;-282273
01.12.18;WA65;Kopfbedeckungen und Teile davon;30450;46528;-16078
01.12.18;WA66;Schirme, Gehstöcke usw., Peitschen;4606;16714;-12108
01.12.18;WA67;Zugerichtete Federn, Daunen, künstliche Blumen;8867;20888;-12021
01.12.18;WA68;Waren aus Steinen, Gips, Zement usw.;300659;221521;79138
01.12.18;WA69;Keramische Waren;267600;197489;70111
01.12.18;WA70;Glas und Glaswaren;439711;346540;93171
01.12.18;WA71;Perlen, Edelsteine, Edelmetalle;878003;1272777;-394774
01.12.18;WA72;Eisen und Stahl;1618202;1694577;-76375
01.12.18;WA73;Waren aus Eisen oder Stahl;1939784;1463660;476124
01.12.18;WA74;Kupfer und Waren daraus;627638;557032;70606
01.12.18;WA75;Nickel und Waren daraus;83215;110928;-27713
01.12.18;WA76;Aluminium und Waren daraus;930926;1053398;-122472
01.12.18;WA78;Blei und Waren daraus;23602;33037;-9435
01.12.18;WA79;Zink und Waren daraus;44623;103567;-58944
01.12.18;WA80;Zinn und Waren daraus;7030;25337;-18307
01.12.18;WA81;Andere unedle Metalle, Cermets usw.;110362;146699;-36337
01.12.18;WA82;Werkzeuge, Schneidwaren, Essbestecke;604513;392433;212080
01.12.18;WA83;Verschiedene Waren aus unedlen Metallen;471545;308841;162704
01.12.18;WA84;Maschinen, Apparate, mechanische Geräte;18451835;10865040;7586795
01.12.18;WA85;Elektrotechnische Erzeugnisse;10347825;10193139;154686
01.12.18;WA86;Schienenfahrzeuge;252867;285916;-33049
01.12.18;WA87;Kraftfahrzeuge, Landfahrzeuge;14704357;8121966;6582391
01.12.18;WA88;Luftfahrzeuge, Raumfahrzeuge;4550119;1418474;3131645
01.12.18;WA89;Wasserfahrzeuge;129455;90445;39010
01.12.18;WA90;Optische, photografische usw. Erzeugnisse;5541018;2970674;2570344
01.12.18;WA91;Uhrmacherwaren;143200;153281;-10081
01.12.18;WA92;Musikinstrumente;59389;53827;5562
01.12.18;WA93;Waffen und Munition;33084;13631;19453
01.12.18;WA94;Möbel, Beleuchtungskörper usw.;1143115;1345996;-202881
01.12.18;WA95;Spielzeug, Spiele usw., Sportgeräte;362477;651342;-288865
01.12.18;WA96;Verschiedene Waren;277820;206849;70971
01.12.18;WA97;Kunstgegenstände, Sammlungsstücke;52688;40637;12051
01.12.18;WA98;Vollständige Fabrikationsanlagen;99265;1563;97702
01.12.18;WA99;Zusammenstellungen verschiedener Waren;1155577;970125;185452
01.12.19;WA01;Lebende Tiere;132214;160989;-28775
01.12.19;WA02;Fleisch;785718;625482;160236
01.12.19;WA03;Fische, Krebs- und Weichtiere;131989;321349;-189360
01.12.19;WA04;Milch, Milcherzeugnisse, Eier, Honig;723890;690361;33529
01.12.19;WA05;Andere Waren tierischen Ursprungs;63814;71787;-7973
01.12.19;WA06;Pflanzen, Waren des Blumenhandels;57898;205784;-147886
01.12.19;WA07;Gemüse, Pflanzen für Ernährung;71918;541958;-470040
01.12.19;WA08;Geniessbare Früchte und Nüsse;171650;787847;-616197
01.12.19;WA09;Kaffee, Tee, Mate, Gewürze;218865;259250;-40385
01.12.19;WA10;Getreide;112118;222346;-110228
01.12.19;WA11;Müllereierzeugnisse, Malz usw.;129138;50262;78876
01.12.19;WA12;Ölsamen usw., Heilpflanzen usw.;90449;482766;-392317
01.12.19;WA13;Schellack, Gummen, Harz, Pflanzensaft;46000;37459;8541
01.12.19;WA14;Flechtstoffe usw. pflanzlichen Ursprungs;457;3549;-3092
01.12.19;WA15;Tierische und pflanzliche Fette, Öle, Wachs;178923;262221;-83298
01.12.19;WA16;Zubereitungen von Fleisch, Fisch usw.;249486;252321;-2835
01.12.19;WA17;Zucker und Zuckerwaren;199717;114539;85178
01.12.19;WA18;Kakao und Zubereitungen aus Kakao;425237;333317;91920
01.12.19;WA19;Zubereitungen aus Getreide usw., Backwaren;503783;351242;152541
01.12.19;WA20;Zubereitungen von Gemüse, Früchten usw.;232457;410399;-177942
01.12.19;WA21;Verschiedene Lebensmittelzubereitungen;438219;265618;172601
01.12.19;WA22;Getränke, alkoholhaltige Flüssigkeiten, Essig;430560;632951;-202391
01.12.19;WA23;Rückstände der Lebensmittelindustrie, Futter;371749;331981;39768
01.12.19;WA24;Tabak;214259;188171;26088
01.12.19;WA25;Salz, Schwefel, Steine, Erden usw.;135670;129940;5730
01.12.19;WA26;Erze, Schlacken, Aschen;33754;624196;-590442
01.12.19;WA27;Mineralische Brennstoffe usw.;2363559;8265390;-5901831
01.12.19;WA28;Anorganische chemische Erzeugnisse;778801;446477;332324
01.12.19;WA29;Organische chemische Erzeugnisse;1763617;2420681;-657064
01.12.19;WA30;Pharmazeutische Erzeugnisse;5825231;4332214;1493017
01.12.19;WA31;Düngemittel;172052;71597;100455
01.12.19;WA32;Gerb- und Farbstoffe, Farben, Lacke usw.;703694;362539;341155
01.12.19;WA33;Etherische Öle, Riech-, Schönheitsmittel;738880;543967;194913
01.12.19;WA34;Seifen, Waschmittel usw.;527266;326047;201219
01.12.19;WA35;Eiweissstoffe, Klebstoffe, Enzyme;247328;158339;88989
01.12.19;WA36;Sprengstoffe, pyrotechnische Artikel usw.;27885;13762;14123
01.12.19;WA37;Photochemische Erzeugnisse;83540;71444;12096
01.12.19;WA38;Verschiedene Erzeugnisse der Chemischen Industrie;1654323;1053053;601270
01.12.19;WA39;Kunststoffe und Waren daraus;3839920;2559493;1280427
01.12.19;WA40;Kautschuk und Waren daraus;938495;796512;141983
01.12.19;WA41;Häute, Felle, Leder;52197;42921;9276
01.12.19;WA42;Lederwaren, Sattlerwaren;196702;357698;-160996
01.12.19;WA43;Pelzfelle, künstliches Pelzwerk;6319;6615;-296
01.12.19;WA44;Holz, Holzwaren, Holzkohle;540607;501799;38808
01.12.19;WA45;Kork, Korkwaren;2056;7407;-5351
01.12.19;WA46;Flechtwaren, Korbmacherwaren;3309;9489;-6180
01.12.19;WA47;Halbstoffe aus Holz usw., Papierabfall;75342;267618;-192276
01.12.19;WA48;Papier, Pappe und Waren daraus;1257649;897796;359853
01.12.19;WA49;Bücher, Zeitungen, Bilddrucke usw.;331109;256694;74415
01.12.19;WA50;Seide;1666;1811;-145
01.12.19;WA51;Wolle, feine und grobe Tierhaare;35979;42658;-6679
01.12.19;WA52;Baumwolle;51465;50221;1244
01.12.19;WA53;Andere pflanzliche Spinnstoffe, Papiergarn;4763;6415;-1652
01.12.19;WA54;Synthetisches oder künstliches Filament;106989;85333;21656
01.12.19;WA55;Synthetische oder künstliche Spinnfaser;117187;81545;35642
01.12.19;WA56;Watte, Filz, Vliesstoff usw., Tauwerk;157038;93451;63587
01.12.19;WA57;Teppiche, Fussbodenbelag aus Spinnstoff;36241;83341;-47100
01.12.19;WA58;Spezialgewebe, Spitzen, Tapisserien;30046;15146;14900
01.12.19;WA59;Getränkte, bestrichene usw. Gewebe;149630;71854;77776
01.12.19;WA60;Gewirke und Gestricke;46626;28249;18377
01.12.19;WA61;Bekleidung usw. aus Gewirken, Gestricken;790906;1317556;-526650
01.12.19;WA62;Andere Bekleidung, Bekleidungszubehör;777663;1209578;-431915
01.12.19;WA63;Andere Konfektion, Spinnstoffwaren usw.;199379;294742;-95363
01.12.19;WA64;Schuhe, Gamaschen, ähnliche Waren;577872;849180;-271308
01.12.19;WA65;Kopfbedeckungen und Teile davon;38064;54778;-16714
01.12.19;WA66;Schirme, Gehstöcke usw., Peitschen;5399;14492;-9093
01.12.19;WA67;Zugerichtete Federn, Daunen, künstliche Blumen;9449;21734;-12285
01.12.19;WA68;Waren aus Steinen, Gips, Zement usw.;302413;206987;95426
01.12.19;WA69;Keramische Waren;261179;198643;62536
01.12.19;WA70;Glas und Glaswaren;420361;329426;90935
01.12.19;WA71;Perlen, Edelsteine, Edelmetalle;1148658;2058064;-909406
01.12.19;WA72;Eisen und Stahl;1303982;1386428;-82446
01.12.19;WA73;Waren aus Eisen oder Stahl;1798957;1369043;429914
01.12.19;WA74;Kupfer und Waren daraus;717595;562551;155044
01.12.19;WA75;Nickel und Waren daraus;94492;122711;-28219
01.12.19;WA76;Aluminium und Waren daraus;897290;911854;-14564
01.12.19;WA78;Blei und Waren daraus;24214;40881;-16667
01.12.19;WA79;Zink und Waren daraus;45492;88569;-43077
01.12.19;WA80;Zinn und Waren daraus;5048;24196;-19148
01.12.19;WA81;Andere unedle Metalle, Cermets usw.;96980;128714;-31734
01.12.19;WA82;Werkzeuge, Schneidwaren, Essbestecke;589693;362527;227166
01.12.19;WA83;Verschiedene Waren aus unedlen Metallen;491454;322230;169224
01.12.19;WA84;Maschinen, Apparate, mechanische Geräte;18468051;10993943;7474108
01.12.19;WA85;Elektrotechnische Erzeugnisse;10489298;10338916;150382
01.12.19;WA86;Schienenfahrzeuge;270143;290606;-20463
01.12.19;WA87;Kraftfahrzeuge, Landfahrzeuge;14635581;8752921;5882660
01.12.19;WA88;Luftfahrzeuge, Raumfahrzeuge;5133166;1088160;4045006
01.12.19;WA89;Wasserfahrzeuge;205127;222345;-17218
01.12.19;WA90;Optische, photografische usw. Erzeugnisse;5734071;3135280;2598791
01.12.19;WA91;Uhrmacherwaren;144450;184903;-40453
01.12.19;WA92;Musikinstrumente;68077;62284;5793
01.12.19;WA93;Waffen und Munition;34233;13894;20339
01.12.19;WA94;Möbel, Beleuchtungskörper usw.;1174055;1377555;-203500
01.12.19;WA95;Spielzeug, Spiele usw., Sportgeräte;426628;655326;-228698
01.12.19;WA96;Verschiedene Waren;298838;220210;78628
01.12.19;WA97;Kunstgegenstände, Sammlungsstücke;62089;48790;13299
01.12.19;WA98;Vollständige Fabrikationsanlagen;65695;NULL;#WERT!
01.12.19;WA99;Zusammenstellungen verschiedener Waren;1239076;985272;253804
01.12.20;WA01;Lebende Tiere;99537;91238;8299
01.12.20;WA02;Fleisch;520419;514210;6209
01.12.20;WA03;Fische, Krebs- und Weichtiere;122966;336201;-213235
01.12.20;WA04;Milch, Milcherzeugnisse, Eier, Honig;744786;733491;11295
01.12.20;WA05;Andere Waren tierischen Ursprungs;57236;80710;-23474
01.12.20;WA06;Pflanzen, Waren des Blumenhandels;59346;188253;-128907
01.12.20;WA07;Gemüse, Pflanzen für Ernährung;75730;552642;-476912
01.12.20;WA08;Geniessbare Früchte und Nüsse;156513;842647;-686134
01.12.20;WA09;Kaffee, Tee, Mate, Gewürze;270360;291107;-20747
01.12.20;WA10;Getreide;297620;242594;55026
01.12.20;WA11;Müllereierzeugnisse, Malz usw.;123308;56071;67237
01.12.20;WA12;Ölsamen usw., Heilpflanzen usw.;100484;541992;-441508
01.12.20;WA13;Schellack, Gummen, Harz, Pflanzensaft;43873;44198;-325
01.12.20;WA14;Flechtstoffe usw. pflanzlichen Ursprungs;579;2866;-2287
01.12.20;WA15;Tierische und pflanzliche Fette, Öle, Wachs;240490;286631;-46141
01.12.20;WA16;Zubereitungen von Fleisch, Fisch usw.;237916;260562;-22646
01.12.20;WA17;Zucker und Zuckerwaren;191377;114531;76846
01.12.20;WA18;Kakao und Zubereitungen aus Kakao;429076;299105;129971
01.12.20;WA19;Zubereitungen aus Getreide usw., Backwaren;507432;351854;155578
01.12.20;WA20;Zubereitungen von Gemüse, Früchten usw.;238607;394929;-156322
01.12.20;WA21;Verschiedene Lebensmittelzubereitungen;489151;282804;206347
01.12.20;WA22;Getränke, alkoholhaltige Flüssigkeiten, Essig;394593;619746;-225153
01.12.20;WA23;Rückstände der Lebensmittelindustrie, Futter;444736;338583;106153
01.12.20;WA24;Tabak;163436;201152;-37716
01.12.20;WA25;Salz, Schwefel, Steine, Erden usw.;128922;119596;9326
01.12.20;WA26;Erze, Schlacken, Aschen;46073;874694;-828621
01.12.20;WA27;Mineralische Brennstoffe usw.;2163770;5791896;-3628126
01.12.20;WA28;Anorganische chemische Erzeugnisse;844789;446670;398119
01.12.20;WA29;Organische chemische Erzeugnisse;1878834;2787827;-908993
01.12.20;WA30;Pharmazeutische Erzeugnisse;6404997;4167036;2237961
01.12.20;WA31;Düngemittel;158142;73190;84952
01.12.20;WA32;Gerb- und Farbstoffe, Farben, Lacke usw.;785317;434112;351205
01.12.20;WA33;Etherische Öle, Riech-, Schönheitsmittel;675085;529329;145756
01.12.20;WA34;Seifen, Waschmittel usw.;570524;337551;232973
01.12.20;WA35;Eiweissstoffe, Klebstoffe, Enzyme;270903;164546;106357
01.12.20;WA36;Sprengstoffe, pyrotechnische Artikel usw.;24897;12785;12112
01.12.20;WA37;Photochemische Erzeugnisse;87219;62473;24746
01.12.20;WA38;Verschiedene Erzeugnisse der Chemischen Industrie;2061439;1602329;459110
01.12.20;WA39;Kunststoffe und Waren daraus;4128755;2747999;1380756
01.12.20;WA40;Kautschuk und Waren daraus;1023043;923757;99286
01.12.20;WA41;Häute, Felle, Leder;39184;31833;7351
01.12.20;WA42;Lederwaren, Sattlerwaren;180782;312322;-131540
01.12.20;WA43;Pelzfelle, künstliches Pelzwerk;5131;7613;-2482
01.12.20;WA44;Holz, Holzwaren, Holzkohle;643975;542787;101188
01.12.20;WA45;Kork, Korkwaren;2306;8103;-5797
01.12.20;WA46;Flechtwaren, Korbmacherwaren;3638;10926;-7288
01.12.20;WA47;Halbstoffe aus Holz usw., Papierabfall;67687;246321;-178634
01.12.20;WA48;Papier, Pappe und Waren daraus;1268457;885739;382718
01.12.20;WA49;Bücher, Zeitungen, Bilddrucke usw.;340143;290222;49921
01.12.20;WA50;Seide;1154;1940;-786
01.12.20;WA51;Wolle, feine und grobe Tierhaare;26605;25943;662
01.12.20;WA52;Baumwolle;45182;48081;-2899
01.12.20;WA53;Andere pflanzliche Spinnstoffe, Papiergarn;3100;5819;-2719
01.12.20;WA54;Synthetisches oder künstliches Filament;100066;83763;16303
01.12.20;WA55;Synthetische oder künstliche Spinnfaser;112204;79770;32434
01.12.20;WA56;Watte, Filz, Vliesstoff usw., Tauwerk;168133;112029;56104
01.12.20;WA57;Teppiche, Fussbodenbelag aus Spinnstoff;39504;97033;-57529
01.12.20;WA58;Spezialgewebe, Spitzen, Tapisserien;33575;16511;17064
01.12.20;WA59;Getränkte, bestrichene usw. Gewebe;159463;76981;82482
01.12.20;WA60;Gewirke und Gestricke;44490;29552;14938
01.12.20;WA61;Bekleidung usw. aus Gewirken, Gestricken;830308;1314806;-484498
01.12.20;WA62;Andere Bekleidung, Bekleidungszubehör;727662;1084742;-357080
01.12.20;WA63;Andere Konfektion, Spinnstoffwaren usw.;275095;598963;-323868
01.12.20;WA64;Schuhe, Gamaschen, ähnliche Waren;507982;767443;-259461
01.12.20;WA65;Kopfbedeckungen und Teile davon;37800;53535;-15735
01.12.20;WA66;Schirme, Gehstöcke usw., Peitschen;5142;15576;-10434
01.12.20;WA67;Zugerichtete Federn, Daunen, künstliche Blumen;10472;19748;-9276
01.12.20;WA68;Waren aus Steinen, Gips, Zement usw.;318847;218403;100444
01.12.20;WA69;Keramische Waren;260853;211994;48859
01.12.20;WA70;Glas und Glaswaren;433200;360404;72796
01.12.20;WA71;Perlen, Edelsteine, Edelmetalle;1699321;2377665;-678344
01.12.20;WA72;Eisen und Stahl;1491427;1306736;184691
01.12.20;WA73;Waren aus Eisen oder Stahl;1790424;1520978;269446
01.12.20;WA74;Kupfer und Waren daraus;706746;655284;51462
01.12.20;WA75;Nickel und Waren daraus;81341;88981;-7640
01.12.20;WA76;Aluminium und Waren daraus;961231;975576;-14345
01.12.20;WA78;Blei und Waren daraus;27549;36196;-8647
01.12.20;WA79;Zink und Waren daraus;50158;86332;-36174
01.12.20;WA80;Zinn und Waren daraus;6318;24229;-17911
01.12.20;WA81;Andere unedle Metalle, Cermets usw.;78502;99146;-20644
01.12.20;WA82;Werkzeuge, Schneidwaren, Essbestecke;613795;401743;212052
01.12.20;WA83;Verschiedene Waren aus unedlen Metallen;502064;365092;136972
01.12.20;WA84;Maschinen, Apparate, mechanische Geräte;17819740;11532956;6286784
01.12.20;WA85;Elektrotechnische Erzeugnisse;11396238;11892534;-496296
01.12.20;WA86;Schienenfahrzeuge;338481;370812;-32331
01.12.20;WA87;Kraftfahrzeuge, Landfahrzeuge;16370591;9315664;7054927
01.12.20;WA88;Luftfahrzeuge, Raumfahrzeuge;3982521;783413;3199108
01.12.20;WA89;Wasserfahrzeuge;309168;656724;-347556
01.12.20;WA90;Optische, photografische usw. Erzeugnisse;5573453;3220043;2353410
01.12.20;WA91;Uhrmacherwaren;162784;207381;-44597
01.12.20;WA92;Musikinstrumente;62028;62450;-422
01.12.20;WA93;Waffen und Munition;57007;20150;36857
01.12.20;WA94;Möbel, Beleuchtungskörper usw.;1121257;1601240;-479983
01.12.20;WA95;Spielzeug, Spiele usw., Sportgeräte;450848;789744;-338896
01.12.20;WA96;Verschiedene Waren;300827;259308;41519
01.12.20;WA97;Kunstgegenstände, Sammlungsstücke;63436;74247;-10811
01.12.20;WA98;Vollständige Fabrikationsanlagen;70953;6511;64442
01.12.20;WA99;Zusammenstellungen verschiedener Waren;1169062;1062088;106974
01.12.21;WA01;Lebende Tiere;119142;94506;24636
01.12.21;WA02;Fleisch;542361;618002;-75641
01.12.21;WA03;Fische, Krebs- und Weichtiere;151064;405055;-253991
01.12.21;WA04;Milch, Milcherzeugnisse, Eier, Honig;913578;876122;37456
01.12.21;WA05;Andere Waren tierischen Ursprungs;70036;89965;-19929
01.12.21;WA06;Pflanzen, Waren des Blumenhandels;65191;250694;-185503
01.12.21;WA07;Gemüse, Pflanzen für Ernährung;94242;660899;-566657
01.12.21;WA08;Geniessbare Früchte und Nüsse;161368;929281;-767913
01.12.21;WA09;Kaffee, Tee, Mate, Gewürze;300183;433710;-133527
01.12.21;WA10;Getreide;289253;277821;11432
01.12.21;WA11;Müllereierzeugnisse, Malz usw.;163645;68865;94780
01.12.21;WA12;Ölsamen usw., Heilpflanzen usw.;135937;740133;-604196
01.12.21;WA13;Schellack, Gummen, Harz, Pflanzensaft;55126;51841;3285
01.12.21;WA14;Flechtstoffe usw. pflanzlichen Ursprungs;878;5009;-4131
01.12.21;WA15;Tierische und pflanzliche Fette, Öle, Wachs;323115;480148;-157033
01.12.21;WA16;Zubereitungen von Fleisch, Fisch usw.;277271;317304;-40033
01.12.21;WA17;Zucker und Zuckerwaren;237237;134110;103127
01.12.21;WA18;Kakao und Zubereitungen aus Kakao;476894;343314;133580
01.12.21;WA19;Zubereitungen aus Getreide usw., Backwaren;552214;430239;121975
01.12.21;WA20;Zubereitungen von Gemüse, Früchten usw.;236730;446998;-210268
01.12.21;WA21;Verschiedene Lebensmittelzubereitungen;544576;347287;197289
01.12.21;WA22;Getränke, alkoholhaltige Flüssigkeiten, Essig;467120;739985;-272865
01.12.21;WA23;Rückstände der Lebensmittelindustrie, Futter;530432;442228;88204
01.12.21;WA24;Tabak;183000;309455;-126455
01.12.21;WA25;Salz, Schwefel, Steine, Erden usw.;185165;155698;29467
01.12.21;WA26;Erze, Schlacken, Aschen;79382;1176341;-1096959
01.12.21;WA27;Mineralische Brennstoffe usw.;4014087;13695716;-9681629
01.12.21;WA28;Anorganische chemische Erzeugnisse;1123037;647427;475610
01.12.21;WA29;Organische chemische Erzeugnisse;2585087;3038881;-453794
01.12.21;WA30;Pharmazeutische Erzeugnisse;8548665;5518851;3029814
01.12.21;WA31;Düngemittel;349088;137827;211261
01.12.21;WA32;Gerb- und Farbstoffe, Farben, Lacke usw.;872409;460638;411771
01.12.21;WA33;Etherische Öle, Riech-, Schönheitsmittel;840569;650059;190510
01.12.21;WA34;Seifen, Waschmittel usw.;649865;378150;271715
01.12.21;WA35;Eiweissstoffe, Klebstoffe, Enzyme;327467;214750;112717
01.12.21;WA36;Sprengstoffe, pyrotechnische Artikel usw.;24964;14136;10828
01.12.21;WA37;Photochemische Erzeugnisse;93630;54381;39249
01.12.21;WA38;Verschiedene Erzeugnisse der Chemischen Industrie;2408748;1931591;477157
01.12.21;WA39;Kunststoffe und Waren daraus;5242022;3744033;1497989
01.12.21;WA40;Kautschuk und Waren daraus;1114444;1036230;78214
01.12.21;WA41;Häute, Felle, Leder;54734;41792;12942
01.12.21;WA42;Lederwaren, Sattlerwaren;212710;376798;-164088
01.12.21;WA43;Pelzfelle, künstliches Pelzwerk;5873;11128;-5255
01.12.21;WA44;Holz, Holzwaren, Holzkohle;821894;730320;91574
01.12.21;WA45;Kork, Korkwaren;2457;9844;-7387
01.12.21;WA46;Flechtwaren, Korbmacherwaren;3861;16362;-12501
01.12.21;WA47;Halbstoffe aus Holz usw., Papierabfall;116920;419224;-302304
01.12.21;WA48;Papier, Pappe und Waren daraus;1694307;1117060;577247
01.12.21;WA49;Bücher, Zeitungen, Bilddrucke usw.;355319;324927;30392
01.12.21;WA50;Seide;1002;1729;-727
01.12.21;WA51;Wolle, feine und grobe Tierhaare;36412;35279;1133
01.12.21;WA52;Baumwolle;54972;61991;-7019
01.12.21;WA53;Andere pflanzliche Spinnstoffe, Papiergarn;4550;7714;-3164
01.12.21;WA54;Synthetisches oder künstliches Filament;110726;99367;11359
01.12.21;WA55;Synthetische oder künstliche Spinnfaser;111651;101354;10297
01.12.21;WA56;Watte, Filz, Vliesstoff usw., Tauwerk;175812;131351;44461
01.12.21;WA57;Teppiche, Fussbodenbelag aus Spinnstoff;40944;108584;-67640
01.12.21;WA58;Spezialgewebe, Spitzen, Tapisserien;33371;21754;11617
01.12.21;WA59;Getränkte, bestrichene usw. Gewebe;172100;89884;82216
01.12.21;WA60;Gewirke und Gestricke;50186;36388;13798
01.12.21;WA61;Bekleidung usw. aus Gewirken, Gestricken;1001495;1775301;-773806
01.12.21;WA62;Andere Bekleidung, Bekleidungszubehör;833925;1318378;-484453
01.12.21;WA63;Andere Konfektion, Spinnstoffwaren usw.;271535;453221;-181686
01.12.21;WA64;Schuhe, Gamaschen, ähnliche Waren;585701;912354;-326653
01.12.21;WA65;Kopfbedeckungen und Teile davon;50810;74672;-23862
01.12.21;WA66;Schirme, Gehstöcke usw., Peitschen;5821;31058;-25237
01.12.21;WA67;Zugerichtete Federn, Daunen, künstliche Blumen;12261;27939;-15678
01.12.21;WA68;Waren aus Steinen, Gips, Zement usw.;354483;281072;73411
01.12.21;WA69;Keramische Waren;290329;273471;16858
01.12.21;WA70;Glas und Glaswaren;509160;415911;93249
01.12.21;WA71;Perlen, Edelsteine, Edelmetalle;1434291;2578342;-1144051
01.12.21;WA72;Eisen und Stahl;2212119;2412506;-200387
01.12.21;WA73;Waren aus Eisen oder Stahl;2474957;2008601;466356
01.12.21;WA74;Kupfer und Waren daraus;1034071;947749;86322
01.12.21;WA75;Nickel und Waren daraus;102838;134950;-32112
01.12.21;WA76;Aluminium und Waren daraus;1256599;1526924;-270325
01.12.21;WA78;Blei und Waren daraus;29272;52558;-23286
01.12.21;WA79;Zink und Waren daraus;66268;125075;-58807
01.12.21;WA80;Zinn und Waren daraus;11720;48722;-37002
01.12.21;WA81;Andere unedle Metalle, Cermets usw.;100682;149165;-48483
01.12.21;WA82;Werkzeuge, Schneidwaren, Essbestecke;645197;479856;165341
01.12.21;WA83;Verschiedene Waren aus unedlen Metallen;537015;424070;112945
01.12.21;WA84;Maschinen, Apparate, mechanische Geräte;19554032;13319307;6234725
01.12.21;WA85;Elektrotechnische Erzeugnisse;12426951;14331716;-1904765
01.12.21;WA86;Schienenfahrzeuge;268979;262978;6001
01.12.21;WA87;Kraftfahrzeuge, Landfahrzeuge;16681321;9759061;6922260
01.12.21;WA88;Luftfahrzeuge, Raumfahrzeuge;3351733;893266;2458467
01.12.21;WA89;Wasserfahrzeuge;102358;228268;-125910
01.12.21;WA90;Optische, photografische usw. Erzeugnisse;6327121;3615572;2711549
01.12.21;WA91;Uhrmacherwaren;167349;251190;-83841
01.12.21;WA92;Musikinstrumente;64853;76097;-11244
01.12.21;WA93;Waffen und Munition;45173;23518;21655
01.12.21;WA94;Möbel, Beleuchtungskörper usw.;1337854;1894173;-556319
01.12.21;WA95;Spielzeug, Spiele usw., Sportgeräte;571688;1024014;-452326
01.12.21;WA96;Verschiedene Waren;342501;296234;46267
01.12.21;WA97;Kunstgegenstände, Sammlungsstücke;61707;75169;-13462
01.12.21;WA98;Vollständige Fabrikationsanlagen;38530;645;37885
01.12.21;WA99;Zusammenstellungen verschiedener Waren;1300010;1045593;254417
01.12.22;WA01;Lebende Tiere;128041;122975;5066
01.12.22;WA02;Fleisch;655636;690718;-35082
01.12.22;WA03;Fische, Krebs- und Weichtiere;157101;445507;-288406
01.12.22;WA04;Milch, Milcherzeugnisse, Eier, Honig;1086763;1028730;58033
01.12.22;WA05;Andere Waren tierischen Ursprungs;79739;110408;-30669
01.12.22;WA06;Pflanzen, Waren des Blumenhandels;54632;210833;-156201
01.12.22;WA07;Gemüse, Pflanzen für Ernährung;107652;648405;-540753
01.12.22;WA08;Geniessbare Früchte und Nüsse;165505;859709;-694204
01.12.22;WA09;Kaffee, Tee, Mate, Gewürze;322398;467261;-144863
01.12.22;WA10;Getreide;230464;341833;-111369
01.12.22;WA11;Müllereierzeugnisse, Malz usw.;190892;84530;106362
01.12.22;WA12;Ölsamen usw., Heilpflanzen usw.;136146;700312;-564166
01.12.22;WA13;Schellack, Gummen, Harz, Pflanzensaft;60019;53369;6650
01.12.22;WA14;Flechtstoffe usw. pflanzlichen Ursprungs;683;4395;-3712
01.12.22;WA15;Tierische und pflanzliche Fette, Öle, Wachs;377439;494271;-116832
01.12.22;WA16;Zubereitungen von Fleisch, Fisch usw.;306724;333688;-26964
01.12.22;WA17;Zucker und Zuckerwaren;288329;171747;116582
01.12.22;WA18;Kakao und Zubereitungen aus Kakao;545382;411739;133643
01.12.22;WA19;Zubereitungen aus Getreide usw., Backwaren;690980;510023;180957
01.12.22;WA20;Zubereitungen von Gemüse, Früchten usw.;275253;529411;-254158
01.12.22;WA21;Verschiedene Lebensmittelzubereitungen;603338;390753;212585
01.12.22;WA22;Getränke, alkoholhaltige Flüssigkeiten, Essig;514209;749521;-235312
01.12.22;WA23;Rückstände der Lebensmittelindustrie, Futter;603010;545754;57256
01.12.22;WA24;Tabak;215159;360731;-145572
01.12.22;WA25;Salz, Schwefel, Steine, Erden usw.;172382;168050;4332
01.12.22;WA26;Erze, Schlacken, Aschen;88187;801742;-713555
01.12.22;WA27;Mineralische Brennstoffe usw.;4862223;14890409;-10028186
01.12.22;WA28;Anorganische chemische Erzeugnisse;1205784;884379;321405
01.12.22;WA29;Organische chemische Erzeugnisse;2238958;3577875;-1338917
01.12.22;WA30;Pharmazeutische Erzeugnisse;8938201;6015824;2922377
01.12.22;WA31;Düngemittel;410924;183327;227597
01.12.22;WA32;Gerb- und Farbstoffe, Farben, Lacke usw.;778827;415441;363386
01.12.22;WA33;Etherische Öle, Riech-, Schönheitsmittel;920067;690199;229868
01.12.22;WA34;Seifen, Waschmittel usw.;668586;427572;241014
01.12.22;WA35;Eiweissstoffe, Klebstoffe, Enzyme;342143;245228;96915
01.12.22;WA36;Sprengstoffe, pyrotechnische Artikel usw.;53781;15530;38251
01.12.22;WA37;Photochemische Erzeugnisse;91693;54422;37271
01.12.22;WA38;Verschiedene Erzeugnisse der Chemischen Industrie;2711082;1753256;957826
01.12.22;WA39;Kunststoffe und Waren daraus;4752311;3452858;1299453
01.12.22;WA40;Kautschuk und Waren daraus;1173800;1004171;169629
01.12.22;WA41;Häute, Felle, Leder;51545;37638;13907
01.12.22;WA42;Lederwaren, Sattlerwaren;227177;405339;-178162
01.12.22;WA43;Pelzfelle, künstliches Pelzwerk;7259;7502;-243
01.12.22;WA44;Holz, Holzwaren, Holzkohle;812176;648617;163559
01.12.22;WA45;Kork, Korkwaren;2044;7328;-5284
01.12.22;WA46;Flechtwaren, Korbmacherwaren;4793;12512;-7719
01.12.22;WA47;Halbstoffe aus Holz usw., Papierabfall;109481;329722;-220241
01.12.22;WA48;Papier, Pappe und Waren daraus;1697061;1132623;564438
01.12.22;WA49;Bücher, Zeitungen, Bilddrucke usw.;319107;287878;31229
01.12.22;WA50;Seide;2056;2458;-402
01.12.22;WA51;Wolle, feine und grobe Tierhaare;33912;40200;-6288
01.12.22;WA52;Baumwolle;53796;53533;263
01.12.22;WA53;Andere pflanzliche Spinnstoffe, Papiergarn;5373;6588;-1215
01.12.22;WA54;Synthetisches oder künstliches Filament;115214;88765;26449
01.12.22;WA55;Synthetische oder künstliche Spinnfaser;116424;100951;15473
01.12.22;WA56;Watte, Filz, Vliesstoff usw., Tauwerk;188515;126468;62047
01.12.22;WA57;Teppiche, Fussbodenbelag aus Spinnstoff;50950;97875;-46925
01.12.22;WA58;Spezialgewebe, Spitzen, Tapisserien;36559;19068;17491
01.12.22;WA59;Getränkte, bestrichene usw. Gewebe;179983;88511;91472
01.12.22;WA60;Gewirke und Gestricke;47036;31834;15202
01.12.22;WA61;Bekleidung usw. aus Gewirken, Gestricken;1074731;1877025;-802294
01.12.22;WA62;Andere Bekleidung, Bekleidungszubehör;935049;1568294;-633245
01.12.22;WA63;Andere Konfektion, Spinnstoffwaren usw.;258658;396805;-138147
01.12.22;WA64;Schuhe, Gamaschen, ähnliche Waren;792242;1163773;-371531
01.12.22;WA65;Kopfbedeckungen und Teile davon;61068;86900;-25832
01.12.22;WA66;Schirme, Gehstöcke usw., Peitschen;7818;15550;-7732
01.12.22;WA67;Zugerichtete Federn, Daunen, künstliche Blumen;12383;25054;-12671
01.12.22;WA68;Waren aus Steinen, Gips, Zement usw.;373607;256121;117486
01.12.22;WA69;Keramische Waren;320607;268887;51720
01.12.22;WA70;Glas und Glaswaren;574662;404718;169944
01.12.22;WA71;Perlen, Edelsteine, Edelmetalle;1588277;2229094;-640817
01.12.22;WA72;Eisen und Stahl;2103446;1969397;134049
01.12.22;WA73;Waren aus Eisen oder Stahl;2194957;2044855;150102
01.12.22;WA74;Kupfer und Waren daraus;917518;992661;-75143
01.12.22;WA75;Nickel und Waren daraus;136780;177179;-40399
01.12.22;WA76;Aluminium und Waren daraus;1253844;1375706;-121862
01.12.22;WA78;Blei und Waren daraus;27051;53807;-26756
01.12.22;WA79;Zink und Waren daraus;55217;115828;-60611
01.12.22;WA80;Zinn und Waren daraus;8759;35095;-26336
01.12.22;WA81;Andere unedle Metalle, Cermets usw.;138766;172345;-33579
01.12.22;WA82;Werkzeuge, Schneidwaren, Essbestecke;669196;469270;199926
01.12.22;WA83;Verschiedene Waren aus unedlen Metallen;538083;390983;147100
01.12.22;WA84;Maschinen, Apparate, mechanische Geräte;21026661;13240264;7786397
01.12.22;WA85;Elektrotechnische Erzeugnisse;14070611;16485210;-2414599
01.12.22;WA86;Schienenfahrzeuge;311773;270064;41709
01.12.22;WA87;Kraftfahrzeuge, Landfahrzeuge;19964981;11108656;8856325
01.12.22;WA88;Luftfahrzeuge, Raumfahrzeuge;4121664;1044676;3076988
01.12.22;WA89;Wasserfahrzeuge;96902;280773;-183871
01.12.22;WA90;Optische, photografische usw. Erzeugnisse;6525722;3798903;2726819
01.12.22;WA91;Uhrmacherwaren;148613;221181;-72568
01.12.22;WA92;Musikinstrumente;104186;74343;29843
01.12.22;WA93;Waffen und Munition;60290;28491;31799
01.12.22;WA94;Möbel, Beleuchtungskörper usw.;1344703;1697029;-352326
01.12.22;WA95;Spielzeug, Spiele usw., Sportgeräte;433411;770098;-336687
01.12.22;WA96;Verschiedene Waren;342672;303588;39084
01.12.22;WA97;Kunstgegenstände, Sammlungsstücke;77690;66315;11375
01.12.22;WA98;Vollständige Fabrikationsanlagen;33647;NULL;#WERT!
01.12.22;WA99;Zusammenstellungen verschiedener Waren;1421459;1021156;400303
01.12.23;WA01;Lebende Tiere;127121;129484;-2363
01.12.23;WA02;Fleisch;589048;656900;-67852
01.12.23;WA03;Fische, Krebs- und Weichtiere;134162;468188;-334026
01.12.23;WA04;Milch, Milcherzeugnisse, Eier, Honig;937225;889682;47543
01.12.23;WA05;Andere Waren tierischen Ursprungs;59671;87183;-27512
01.12.23;WA06;Pflanzen, Waren des Blumenhandels;51157;196411;-145254
01.12.23;WA07;Gemüse, Pflanzen für Ernährung;117884;733833;-615949
01.12.23;WA08;Geniessbare Früchte und Nüsse;171757;942613;-770856
01.12.23;WA09;Kaffee, Tee, Mate, Gewürze;296389;360773;-64384
01.12.23;WA10;Getreide;252720;339897;-87177
01.12.23;WA11;Müllereierzeugnisse, Malz usw.;182490;76460;106030
01.12.23;WA12;Ölsamen usw., Heilpflanzen usw.;130519;599820;-469301
01.12.23;WA13;Schellack, Gummen, Harz, Pflanzensaft;50472;44272;6200
01.12.23;WA14;Flechtstoffe usw. pflanzlichen Ursprungs;662;2275;-1613
01.12.23;WA15;Tierische und pflanzliche Fette, Öle, Wachs;261247;381367;-120120
01.12.23;WA16;Zubereitungen von Fleisch, Fisch usw.;285686;329266;-43580
01.12.23;WA17;Zucker und Zuckerwaren;282740;179801;102939
01.12.23;WA18;Kakao und Zubereitungen aus Kakao;569240;469689;99551
01.12.23;WA19;Zubereitungen aus Getreide usw., Backwaren;709056;549112;159944
01.12.23;WA20;Zubereitungen von Gemüse, Früchten usw.;269478;536986;-267508
01.12.23;WA21;Verschiedene Lebensmittelzubereitungen;615234;450672;164562
01.12.23;WA22;Getränke, alkoholhaltige Flüssigkeiten, Essig;524324;704601;-180277
01.12.23;WA23;Rückstände der Lebensmittelindustrie, Futter;561316;422673;138643
01.12.23;WA24;Tabak;230298;406393;-176095
01.12.23;WA25;Salz, Schwefel, Steine, Erden usw.;163574;144963;18611
01.12.23;WA26;Erze, Schlacken, Aschen;58424;1009488;-951064
01.12.23;WA27;Mineralische Brennstoffe usw.;2563195;10529067;-7965872
01.12.23;WA28;Anorganische chemische Erzeugnisse;872742;795638;77104
01.12.23;WA29;Organische chemische Erzeugnisse;1764350;2342969;-578619
01.12.23;WA30;Pharmazeutische Erzeugnisse;7416189;5033486;2382703
01.12.23;WA31;Düngemittel;205663;121737;83926
01.12.23;WA32;Gerb- und Farbstoffe, Farben, Lacke usw.;734534;353265;381269
01.12.23;WA33;Etherische Öle, Riech-, Schönheitsmittel;888387;672136;216251
01.12.23;WA34;Seifen, Waschmittel usw.;584589;392625;191964
01.12.23;WA35;Eiweissstoffe, Klebstoffe, Enzyme;288664;202943;85721
01.12.23;WA36;Sprengstoffe, pyrotechnische Artikel usw.;40965;32270;8695
01.12.23;WA37;Photochemische Erzeugnisse;74983;45042;29941
01.12.23;WA38;Verschiedene Erzeugnisse der Chemischen Industrie;2314681;1503130;811551
01.12.23;WA39;Kunststoffe und Waren daraus;4206321;2983102;1223219
01.12.23;WA40;Kautschuk und Waren daraus;1104930;924960;179970
01.12.23;WA41;Häute, Felle, Leder;39956;31112;8844
01.12.23;WA42;Lederwaren, Sattlerwaren;222203;358660;-136457
01.12.23;WA43;Pelzfelle, künstliches Pelzwerk;5676;5141;535
01.12.23;WA44;Holz, Holzwaren, Holzkohle;620253;505067;115186
01.12.23;WA45;Kork, Korkwaren;1370;6039;-4669
01.12.23;WA46;Flechtwaren, Korbmacherwaren;4054;12055;-8001
01.12.23;WA47;Halbstoffe aus Holz usw., Papierabfall;89226;276193;-186967
01.12.23;WA48;Papier, Pappe und Waren daraus;1371989;992261;379728
01.12.23;WA49;Bücher, Zeitungen, Bilddrucke usw.;295143;270289;24854
01.12.23;WA50;Seide;1521;2903;-1382
01.12.23;WA51;Wolle, feine und grobe Tierhaare;22801;24757;-1956
01.12.23;WA52;Baumwolle;38589;40258;-1669
01.12.23;WA53;Andere pflanzliche Spinnstoffe, Papiergarn;4205;5474;-1269
01.12.23;WA54;Synthetisches oder künstliches Filament;103928;75639;28289
01.12.23;WA55;Synthetische oder künstliche Spinnfaser;102677;76528;26149
01.12.23;WA56;Watte, Filz, Vliesstoff usw., Tauwerk;160951;103686;57265
01.12.23;WA57;Teppiche, Fussbodenbelag aus Spinnstoff;46799;84608;-37809
01.12.23;WA58;Spezialgewebe, Spitzen, Tapisserien;34747;15714;19033
01.12.23;WA59;Getränkte, bestrichene usw. Gewebe;164749;81088;83661
01.12.23;WA60;Gewirke und Gestricke;39512;24182;15330
01.12.23;WA61;Bekleidung usw. aus Gewirken, Gestricken;972380;1383869;-411489
01.12.23;WA62;Andere Bekleidung, Bekleidungszubehör;876266;1234309;-358043
01.12.23;WA63;Andere Konfektion, Spinnstoffwaren usw.;223710;290594;-66884
01.12.23;WA64;Schuhe, Gamaschen, ähnliche Waren;737475;821388;-83913
01.12.23;WA65;Kopfbedeckungen und Teile davon;62684;67681;-4997
01.12.23;WA66;Schirme, Gehstöcke usw., Peitschen;5632;11676;-6044
01.12.23;WA67;Zugerichtete Federn, Daunen, künstliche Blumen;11309;19985;-8676
01.12.23;WA68;Waren aus Steinen, Gips, Zement usw.;360472;241398;119074
01.12.23;WA69;Keramische Waren;283795;196837;86958
01.12.23;WA70;Glas und Glaswaren;477204;364222;112982
01.12.23;WA71;Perlen, Edelsteine, Edelmetalle;2175330;1368335;806995
01.12.23;WA72;Eisen und Stahl;1767427;1569077;198350
01.12.23;WA73;Waren aus Eisen oder Stahl;2200130;1684178;515952
01.12.23;WA74;Kupfer und Waren daraus;787582;621942;165640
01.12.23;WA75;Nickel und Waren daraus;115743;137952;-22209
01.12.23;WA76;Aluminium und Waren daraus;1009994;1194616;-184622
01.12.23;WA78;Blei und Waren daraus;31219;41583;-10364
01.12.23;WA79;Zink und Waren daraus;43145;119356;-76211
01.12.23;WA80;Zinn und Waren daraus;10117;30407;-20290
01.12.23;WA81;Andere unedle Metalle, Cermets usw.;120485;132127;-11642
01.12.23;WA82;Werkzeuge, Schneidwaren, Essbestecke;649058;409408;239650
01.12.23;WA83;Verschiedene Waren aus unedlen Metallen;497179;375428;121751
01.12.23;WA84;Maschinen, Apparate, mechanische Geräte;19903340;12342203;7561137
01.12.23;WA85;Elektrotechnische Erzeugnisse;12897930;13836377;-938447
01.12.23;WA86;Schienenfahrzeuge;204789;262222;-57433
01.12.23;WA87;Kraftfahrzeuge, Landfahrzeuge;18837906;10034219;8803687
01.12.23;WA88;Luftfahrzeuge, Raumfahrzeuge;4257873;1482245;2775628
01.12.23;WA89;Wasserfahrzeuge;195406;185778;9628
01.12.23;WA90;Optische, photografische usw. Erzeugnisse;6202084;3544146;2657938
01.12.23;WA91;Uhrmacherwaren;164076;209095;-45019
01.12.23;WA92;Musikinstrumente;105898;65485;40413
01.12.23;WA93;Waffen und Munition;55644;22594;33050
01.12.23;WA94;Möbel, Beleuchtungskörper usw.;1220285;1540570;-320285
01.12.23;WA95;Spielzeug, Spiele usw., Sportgeräte;434031;732809;-298778
01.12.23;WA96;Verschiedene Waren;308726;270601;38125
01.12.23;WA97;Kunstgegenstände, Sammlungsstücke;58282;70921;-12639
01.12.23;WA98;Vollständige Fabrikationsanlagen;70088;NULL;#WERT!
01.12.23;WA99;Zusammenstellungen verschiedener Waren;1759493;1151998;607495
01.12.24;WA01;Lebende Tiere;141730;127596;14134
01.12.24;WA02;Fleisch;631704;692479;-60775
01.12.24;WA03;Fische, Krebs- und Weichtiere;124980;370315;-245335
01.12.24;WA04;Milch, Milcherzeugnisse, Eier, Honig;1004425;1056389;-51964
01.12.24;WA05;Andere Waren tierischen Ursprungs;62351;80630;-18279
01.12.24;WA06;Pflanzen, Waren des Blumenhandels;49801;195393;-145592
01.12.24;WA07;Gemüse, Pflanzen für Ernährung;134207;743479;-609272
01.12.24;WA08;Geniessbare Früchte und Nüsse;183648;1083729;-900081
01.12.24;WA09;Kaffee, Tee, Mate, Gewürze;360721;594721;-234000
01.12.24;WA10;Getreide;191514;288424;-96910
01.12.24;WA11;Müllereierzeugnisse, Malz usw.;174470;80365;94105
01.12.24;WA12;Ölsamen usw., Heilpflanzen usw.;159467;576530;-417063
01.12.24;WA13;Schellack, Gummen, Harz, Pflanzensaft;56361;49685;6676
01.12.24;WA14;Flechtstoffe usw. pflanzlichen Ursprungs;682;2689;-2007
01.12.24;WA15;Tierische und pflanzliche Fette, Öle, Wachs;280937;417733;-136796
01.12.24;WA16;Zubereitungen von Fleisch, Fisch usw.;291327;334118;-42791
01.12.24;WA17;Zucker und Zuckerwaren;274498;174316;100182
01.12.24;WA18;Kakao und Zubereitungen aus Kakao;733993;778244;-44251
01.12.24;WA19;Zubereitungen aus Getreide usw., Backwaren;755826;579345;176481
01.12.24;WA20;Zubereitungen von Gemüse, Früchten usw.;295506;570390;-274884
01.12.24;WA21;Verschiedene Lebensmittelzubereitungen;659309;451030;208279
01.12.24;WA22;Getränke, alkoholhaltige Flüssigkeiten, Essig;559872;662403;-102531
01.12.24;WA23;Rückstände der Lebensmittelindustrie, Futter;555220;453979;101241
01.12.24;WA24;Tabak;240104;437581;-197477
01.12.24;WA25;Salz, Schwefel, Steine, Erden usw.;165331;139072;26259
01.12.24;WA26;Erze, Schlacken, Aschen;58485;841709;-783224
01.12.24;WA27;Mineralische Brennstoffe usw.;2724715;9689194;-6964479
01.12.24;WA28;Anorganische chemische Erzeugnisse;838952;655958;182994
01.12.24;WA29;Organische chemische Erzeugnisse;1775334;2369592;-594258
01.12.24;WA30;Pharmazeutische Erzeugnisse;7798575;4954849;2843726
01.12.24;WA31;Düngemittel;210783;121886;88897
01.12.24;WA32;Gerb- und Farbstoffe, Farben, Lacke usw.;733166;381202;351964
01.12.24;WA33;Etherische Öle, Riech-, Schönheitsmittel;855021;669180;185841
01.12.24;WA34;Seifen, Waschmittel usw.;621015;427806;193209
01.12.24;WA35;Eiweissstoffe, Klebstoffe, Enzyme;330631;205416;125215
01.12.24;WA36;Sprengstoffe, pyrotechnische Artikel usw.;45858;30723;15135
01.12.24;WA37;Photochemische Erzeugnisse;76534;47196;29338
01.12.24;WA38;Verschiedene Erzeugnisse der Chemischen Industrie;2222620;1300543;922077
01.12.24;WA39;Kunststoffe und Waren daraus;4268179;2945304;1322875
01.12.24;WA40;Kautschuk und Waren daraus;997345;945711;51634
01.12.24;WA41;Häute, Felle, Leder;37783;33288;4495
01.12.24;WA42;Lederwaren, Sattlerwaren;245023;374256;-129233
01.12.24;WA43;Pelzfelle, künstliches Pelzwerk;4427;5688;-1261
01.12.24;WA44;Holz, Holzwaren, Holzkohle;614163;513141;101022
01.12.24;WA45;Kork, Korkwaren;1610;6323;-4713
01.12.24;WA46;Flechtwaren, Korbmacherwaren;3681;12725;-9044
01.12.24;WA47;Halbstoffe aus Holz usw., Papierabfall;118042;323731;-205689
01.12.24;WA48;Papier, Pappe und Waren daraus;1401293;973512;427781
01.12.24;WA49;Bücher, Zeitungen, Bilddrucke usw.;285655;257400;28255
01.12.24;WA50;Seide;766;2119;-1353
01.12.24;WA51;Wolle, feine und grobe Tierhaare;24478;23982;496
01.12.24;WA52;Baumwolle;36711;39422;-2711
01.12.24;WA53;Andere pflanzliche Spinnstoffe, Papiergarn;5194;6112;-918
01.12.24;WA54;Synthetisches oder künstliches Filament;94278;75163;19115
01.12.24;WA55;Synthetische oder künstliche Spinnfaser;112049;87426;24623
01.12.24;WA56;Watte, Filz, Vliesstoff usw., Tauwerk;169158;111765;57393
01.12.24;WA57;Teppiche, Fussbodenbelag aus Spinnstoff;44665;89645;-44980
01.12.24;WA58;Spezialgewebe, Spitzen, Tapisserien;31542;16057;15485
01.12.24;WA59;Getränkte, bestrichene usw. Gewebe;166281;81052;85229
01.12.24;WA60;Gewirke und Gestricke;37580;22464;15116
01.12.24;WA61;Bekleidung usw. aus Gewirken, Gestricken;1049833;1626692;-576859
01.12.24;WA62;Andere Bekleidung, Bekleidungszubehör;921905;1322415;-400510
01.12.24;WA63;Andere Konfektion, Spinnstoffwaren usw.;232500;351612;-119112
01.12.24;WA64;Schuhe, Gamaschen, ähnliche Waren;771887;927045;-155158
01.12.24;WA65;Kopfbedeckungen und Teile davon;55783;74019;-18236
01.12.24;WA66;Schirme, Gehstöcke usw., Peitschen;5096;14469;-9373
01.12.24;WA67;Zugerichtete Federn, Daunen, künstliche Blumen;12195;27693;-15498
01.12.24;WA68;Waren aus Steinen, Gips, Zement usw.;359832;224431;135401
01.12.24;WA69;Keramische Waren;281734;206897;74837
01.12.24;WA70;Glas und Glaswaren;477559;352266;125293
01.12.24;WA71;Perlen, Edelsteine, Edelmetalle;1938640;1816240;122400
01.12.24;WA72;Eisen und Stahl;1663100;1420644;242456
01.12.24;WA73;Waren aus Eisen oder Stahl;2109923;1660123;449800
01.12.24;WA74;Kupfer und Waren daraus;853243;751325;101918
01.12.24;WA75;Nickel und Waren daraus;120774;128045;-7271
01.12.24;WA76;Aluminium und Waren daraus;1117677;1266653;-148976
01.12.24;WA78;Blei und Waren daraus;29236;50351;-21115
01.12.24;WA79;Zink und Waren daraus;56858;102309;-45451
01.12.24;WA80;Zinn und Waren daraus;10974;31097;-20123
01.12.24;WA81;Andere unedle Metalle, Cermets usw.;124798;141282;-16484
01.12.24;WA82;Werkzeuge, Schneidwaren, Essbestecke;619175;431042;188133
01.12.24;WA83;Verschiedene Waren aus unedlen Metallen;503236;376516;126720
01.12.24;WA84;Maschinen, Apparate, mechanische Geräte;19167050;12039523;7127527
01.12.24;WA85;Elektrotechnische Erzeugnisse;12257561;13801352;-1543791
01.12.24;WA86;Schienenfahrzeuge;270886;261302;9584
01.12.24;WA87;Kraftfahrzeuge, Landfahrzeuge;16280078;8964292;7315786
01.12.24;WA88;Luftfahrzeuge, Raumfahrzeuge;4450936;955333;3495603
01.12.24;WA89;Wasserfahrzeuge;558943;201032;357911
01.12.24;WA90;Optische, photografische usw. Erzeugnisse;6338115;3643881;2694234
01.12.24;WA91;Uhrmacherwaren;168576;201150;-32574
01.12.24;WA92;Musikinstrumente;104615;75479;29136
01.12.24;WA93;Waffen und Munition;53652;20468;33184
01.12.24;WA94;Möbel, Beleuchtungskörper usw.;1212164;1556350;-344186
01.12.24;WA95;Spielzeug, Spiele usw., Sportgeräte;438814;766267;-327453
01.12.24;WA96;Verschiedene Waren;289578;276804;12774
01.12.24;WA97;Kunstgegenstände, Sammlungsstücke;89825;62113;27712
01.12.24;WA98;Vollständige Fabrikationsanlagen;44255;NULL;#WERT!
01.12.24;WA99;Zusammenstellungen verschiedener Waren;1729415;1249230;480185